"","county","date","hospitalized_covid_patients","all_hospital_beds","icu_available_beds","icu_combined","hospital_capactity","icu_capacity"
"1","mendocino","2020-03-29","   0","    0","   1","  0","    0","   1"
"2","siskiyou","2020-03-29","   0","    0","   2","  0","    0","   2"
"3","santa clara","2020-03-29","   0","    0","  70"," 80","    0"," -10"
"4","kern","2020-03-29","   0","    0","  39"," 16","    0","  23"
"5","los angeles","2020-03-29","   0","    0"," 345","373","    0"," -28"
"6","san joaquin","2020-03-29","   0","    0","   7","  7","    0","   0"
"7","modoc","2020-03-29","   0","    0","   0","  0","    0","   0"
"8","butte","2020-03-29","   0","    0","   0","  0","    0","   0"
"9","san diego","2020-03-29","   0","    0"," 205","116","    0","  89"
"10","sacramento","2020-03-29","   0","    0","  50"," 30","    0","  20"
"11","kings","2020-03-29","   0","    0","   2","  1","    0","   1"
"12","santa barbara","2020-03-29","   0","    0","  47"," 12","    0","  35"
"13","stanislaus","2020-03-29","   0","    0","  25"," 17","    0","   8"
"14","lassen","2020-03-29","   0","    0","   0","  0","    0","   0"
"15","san luis obispo","2020-03-29","   0","    0"," 948","  7","    0"," 941"
"16","san bernardino","2020-03-29","   0","    0","  65"," 39","    0","  26"
"17","santa cruz","2020-03-29","   0","    0","   0","  0","    0","   0"
"18","san mateo","2020-03-29","   0","    0","  28"," 26","    0","   2"
"19","tehama","2020-03-29","   0","    0","   2","  0","    0","   2"
"20","yolo","2020-03-29","   0","    0","   0","  2","    0","  -2"
"21","solano","2020-03-29","   0","    0","  28","  5","    0","  23"
"22","humboldt","2020-03-29","   0","    0","  18","  0","    0","  18"
"23","nevada","2020-03-29","   0","    0","   3","  1","    0","   2"
"24","sonoma","2020-03-29","   0","    0","  12","  7","    0","   5"
"25","sutter","2020-03-29","   0","    0","   0","  0","    0","   0"
"26","yuba","2020-03-29","   0","    0","   2","  6","    0","  -4"
"27","glenn","2020-03-29","   0","    0","   0","  0","    0","   0"
"28","san francisco","2020-03-29","   0","    0","  61"," 34","    0","  27"
"29","mono","2020-03-29","   0","    0","   2","  0","    0","   2"
"30","el dorado","2020-03-29","   0","    0","   3","  3","    0","   0"
"31","orange","2020-03-29","   0","    0"," 131"," 71","    0","  60"
"32","alameda","2020-03-29","   0","    0"," 119"," 36","    0","  83"
"33","calaveras","2020-03-29","   0","    0","   0","  0","    0","   0"
"34","inyo","2020-03-29","   0","    0","   0","  0","    0","   0"
"35","tuolumne","2020-03-29","   0","    0","   0","  0","    0","   0"
"36","del norte","2020-03-29","   0","    0","   3","  0","    0","   3"
"37","ventura","2020-03-29","   0","    0","  14"," 24","    0"," -10"
"38","placer","2020-03-29","   0","    0","  10","  5","    0","   5"
"39","shasta","2020-03-29","   0","    0","   0","  0","    0","   0"
"40","colusa","2020-03-29","   0","    0","   0","  0","    0","   0"
"41","riverside","2020-03-29","   0","    0","  46"," 33","    0","  13"
"42","tulare","2020-03-29","   0","    0","   7","  8","    0","  -1"
"43","lake","2020-03-29","   0","    0","   2","  1","    0","   1"
"44","amador","2020-03-29","   0","    0","   2","  0","    0","   2"
"45","contra costa","2020-03-29","   0","    0","  62"," 23","    0","  39"
"46","imperial","2020-03-29","   0","    0","   2","  3","    0","  -1"
"47","madera","2020-03-29","   0","    0","   8","  2","    0","   6"
"48","napa","2020-03-29","   0","    0","   5","  0","    0","   5"
"49","monterey","2020-03-29","   0","    0","  10","  3","    0","   7"
"50","merced","2020-03-29","   0","    0","   3","  0","    0","   3"
"51","san benito","2020-03-29","   0","    0","   1","  1","    0","   0"
"52","marin","2020-03-29","   0","    0","  11","  8","    0","   3"
"53","fresno","2020-03-29","   0","    0","  22"," 17","    0","   5"
"54","plumas","2020-03-29","   0","    0","   0","  1","    0","  -1"
"55","trinity","2020-03-29","   0","    0","   0","  0","    0","   0"
"56","mono","2020-03-30","   0","    0","   2","  0","    0","   2"
"57","amador","2020-03-30","   0","    0","   4","  0","    0","   4"
"58","imperial","2020-03-30","   0","    0","   4","  6","    0","  -2"
"59","trinity","2020-03-30","   0","    0","   0","  0","    0","   0"
"60","sutter","2020-03-30","   0","    0","   0","  0","    0","   0"
"61","san mateo","2020-03-30","   0","    0","  47"," 29","    0","  18"
"62","butte","2020-03-30","   0","    0","   5","  3","    0","   2"
"63","nevada","2020-03-30","   0","    0","   3","  7","    0","  -4"
"64","santa barbara","2020-03-30","   0","    0","  48"," 18","    0","  30"
"65","el dorado","2020-03-30","   0","    0","   9","  6","    0","   3"
"66","orange","2020-03-30","   0","    0"," 131","100","    0","  31"
"67","tulare","2020-03-30","   0","    0","   7"," 10","    0","  -3"
"68","lake","2020-03-30","   0","    0","   3","  1","    0","   2"
"69","san joaquin","2020-03-30","   0","    0","  53"," 12","    0","  41"
"70","kern","2020-03-30","   0","    0","  51"," 14","    0","  37"
"71","madera","2020-03-30","   0","    0","   4","  4","    0","   0"
"72","glenn","2020-03-30","   0","    0","   0","  0","    0","   0"
"73","colusa","2020-03-30","   0","    0","   5","  1","    0","   4"
"74","tuolumne","2020-03-30","   0","    0","   3","  0","    0","   3"
"75","mendocino","2020-03-30","   0","    0","   8","  1","    0","   7"
"76","riverside","2020-03-30","   0","    0","  77"," 55","    0","  22"
"77","humboldt","2020-03-30","   0","    0","  10","  0","    0","  10"
"78","solano","2020-03-30","   0","    0","  47","  6","    0","  41"
"79","modoc","2020-03-30","   0","    0","   0","  0","    0","   0"
"80","inyo","2020-03-30","   0","    0","   0","  0","    0","   0"
"81","san francisco","2020-03-30","   0","    0","  90"," 25","    0","  65"
"82","kings","2020-03-30","   0","    0","   0","  3","    0","  -3"
"83","los angeles","2020-03-30","   0","    0"," 456","489","    0"," -33"
"84","sonoma","2020-03-30","   0","    0","  29","  7","    0","  22"
"85","san luis obispo","2020-03-30","   0","    0"," 957","  7","    0"," 950"
"86","yolo","2020-03-30","   0","    0","   0","  3","    0","  -3"
"87","marin","2020-03-30","   0","    0","  16","  6","    0","  10"
"88","placer","2020-03-30","   0","    0","  29","  6","    0","  23"
"89","del norte","2020-03-30","   0","    0","   5","  0","    0","   5"
"90","siskiyou","2020-03-30","   0","    0","   3","  0","    0","   3"
"91","monterey","2020-03-30","   0","    0","  17","  4","    0","  13"
"92","sacramento","2020-03-30","   0","    0","  58"," 44","    0","  14"
"93","santa cruz","2020-03-30","   0","    0","   4","  0","    0","   4"
"94","stanislaus","2020-03-30","   0","    0","  29"," 14","    0","  15"
"95","contra costa","2020-03-30","   0","    0","  90"," 17","    0","  73"
"96","lassen","2020-03-30","   0","    0","   0","  0","    0","   0"
"97","san diego","2020-03-30","   0","    0"," 228"," 95","    0"," 133"
"98","alameda","2020-03-30","   0","    0"," 146"," 45","    0"," 101"
"99","fresno","2020-03-30","   0","    0","  24"," 17","    0","   7"
"100","san bernardino","2020-03-30","   0","    0","  66"," 60","    0","   6"
"101","ventura","2020-03-30","   0","    0","  15"," 33","    0"," -18"
"102","san benito","2020-03-30","   0","    0","   1","  1","    0","   0"
"103","calaveras","2020-03-30","   0","    0","   5","  1","    0","   4"
"104","tehama","2020-03-30","   0","    0","   2","  0","    0","   2"
"105","napa","2020-03-30","   0","    0","   9","  1","    0","   8"
"106","santa clara","2020-03-30","   0","    0"," 103"," 97","    0","   6"
"107","merced","2020-03-30","   0","    0","  11","  2","    0","   9"
"108","yuba","2020-03-30","   0","    0","  10","  6","    0","   4"
"109","plumas","2020-03-30","   0","    0","   0","  0","    0","   0"
"110","shasta","2020-03-30","   0","    0","  13","  0","    0","  13"
"111","yuba","2020-03-31","   0","    0","   6","  6","    0","   0"
"112","contra costa","2020-03-31","   0","    0","  68"," 21","    0","  47"
"113","amador","2020-03-31","   0","    0","   4","  0","    0","   4"
"114","san joaquin","2020-03-31","   0","    0","  28"," 19","    0","   9"
"115","orange","2020-03-31","   0","    0"," 131"," 89","    0","  42"
"116","santa barbara","2020-03-31","   0","    0","  48"," 21","    0","  27"
"117","monterey","2020-03-31","   0","    0","  17","  6","    0","  11"
"118","tehama","2020-03-31","   0","    0","   4","  0","    0","   4"
"119","plumas","2020-03-31","   0","    0","   0","  0","    0","   0"
"120","mendocino","2020-03-31","   0","    0","   7","  0","    0","   7"
"121","santa clara","2020-03-31","   0","    0","  92"," 90","    0","   2"
"122","kings","2020-03-31","   0","    0","   4","  3","    0","   1"
"123","tuolumne","2020-03-31","   0","    0","   4","  0","    0","   4"
"124","napa","2020-03-31","   0","    0","  12","  2","    0","  10"
"125","colusa","2020-03-31","   0","    0","   5","  1","    0","   4"
"126","san francisco","2020-03-31","   0","    0","  77"," 44","    0","  33"
"127","butte","2020-03-31","   0","    0","   2","  5","    0","  -3"
"128","san bernardino","2020-03-31","   0","    0","  63"," 81","    0"," -18"
"129","imperial","2020-03-31","   0","    0","   4","  7","    0","  -3"
"130","humboldt","2020-03-31","   0","    0","   8","  4","    0","   4"
"131","sonoma","2020-03-31","   0","    0","  21","  6","    0","  15"
"132","stanislaus","2020-03-31","   0","    0","  34"," 10","    0","  24"
"133","lake","2020-03-31","   0","    0","   3","  2","    0","   1"
"134","kern","2020-03-31","   0","    0","  46"," 12","    0","  34"
"135","placer","2020-03-31","   0","    0","  28","  6","    0","  22"
"136","del norte","2020-03-31","   0","    0","   3","  0","    0","   3"
"137","marin","2020-03-31","   0","    0","  15","  6","    0","   9"
"138","solano","2020-03-31","   0","    0","  42"," 11","    0","  31"
"139","alameda","2020-03-31","   0","    0","  77"," 44","    0","  33"
"140","san diego","2020-03-31","   0","    0"," 208","114","    0","  94"
"141","shasta","2020-03-31","   0","    0","   4","  1","    0","   3"
"142","san mateo","2020-03-31","   0","    0","  37"," 23","    0","  14"
"143","fresno","2020-03-31","   0","    0","  23"," 23","    0","   0"
"144","san luis obispo","2020-03-31","   0","    0"," 955","  9","    0"," 946"
"145","santa cruz","2020-03-31","   0","    0","   7","  3","    0","   4"
"146","ventura","2020-03-31","   0","    0","  12"," 29","    0"," -17"
"147","trinity","2020-03-31","   0","    0","   0","  0","    0","   0"
"148","sutter","2020-03-31","   0","    0","   0","  0","    0","   0"
"149","sacramento","2020-03-31","   0","    0","  66"," 51","    0","  15"
"150","calaveras","2020-03-31","   0","    0","   4","  0","    0","   4"
"151","riverside","2020-03-31","   0","    0","  75"," 87","    0"," -12"
"152","tulare","2020-03-31","   0","    0","   9","  9","    0","   0"
"153","lassen","2020-03-31","   0","    0","   0","  0","    0","   0"
"154","el dorado","2020-03-31","   0","    0","  12","  6","    0","   6"
"155","merced","2020-03-31","   0","    0","  10","  2","    0","   8"
"156","nevada","2020-03-31","   0","    0","   6","  3","    0","   3"
"157","san benito","2020-03-31","   0","    0","   1","  1","    0","   0"
"158","los angeles","2020-03-31","   0","    0"," 445","554","    0","-109"
"159","yolo","2020-03-31","   0","    0","   1","  4","    0","  -3"
"160","madera","2020-03-31","   0","    0","   5","  1","    0","   4"
"161","modoc","2020-03-31","   0","    0","   0","  0","    0","   0"
"162","mono","2020-03-31","   0","    0","   2","  0","    0","   2"
"163","glenn","2020-03-31","   0","    0","   0","  0","    0","   0"
"164","siskiyou","2020-03-31","   0","    0","   4","  0","    0","   4"
"165","inyo","2020-03-31","   0","    0","   6","  0","    0","   6"
"166","sutter","2020-04-01","   0","    0","   0","  0","    0","   0"
"167","shasta","2020-04-01","   0","    0","  13","  1","    0","  12"
"168","merced","2020-04-01","   0","    0","   9","  3","    0","   6"
"169","nevada","2020-04-01","   0","    0","   3","  4","    0","  -1"
"170","del norte","2020-04-01","   0","    0","   3","  0","    0","   3"
"171","orange","2020-04-01","   0","    0"," 118"," 98","    0","  20"
"172","el dorado","2020-04-01","   0","    0","   9","  4","    0","   5"
"173","san francisco","2020-04-01","   0","    0","  64"," 38","    0","  26"
"174","placer","2020-04-01","   0","    0","   7","  8","    0","  -1"
"175","calaveras","2020-04-01","   0","    0","   5","  0","    0","   5"
"176","modoc","2020-04-01","   0","    0","   0","  0","    0","   0"
"177","yolo","2020-04-01","   0","    0","   2","  2","    0","   0"
"178","trinity","2020-04-01","   0","    0","   0","  0","    0","   0"
"179","contra costa","2020-04-01","   0","    0","  61"," 24","    0","  37"
"180","alameda","2020-04-01","   0","    0"," 106"," 42","    0","  64"
"181","santa barbara","2020-04-01","   0","    0","  51"," 21","    0","  30"
"182","tuolumne","2020-04-01","   0","    0","   2","  0","    0","   2"
"183","santa cruz","2020-04-01","   0","    0","   3","  4","    0","  -1"
"184","siskiyou","2020-04-01","   0","    0","   3","  2","    0","   1"
"185","solano","2020-04-01","   0","    0","  31","  7","    0","  24"
"186","madera","2020-04-01","   0","    0","   4","  1","    0","   3"
"187","inyo","2020-04-01","   0","    0","   6","  0","    0","   6"
"188","tehama","2020-04-01","   0","    0","   4","  1","    0","   3"
"189","amador","2020-04-01","   0","    0","   2","  0","    0","   2"
"190","mono","2020-04-01","   0","    0","   2","  0","    0","   2"
"191","glenn","2020-04-01","   0","    0","   0","  0","    0","   0"
"192","sonoma","2020-04-01","   0","    0","  22","  3","    0","  19"
"193","fresno","2020-04-01","   0","    0","  53"," 18","    0","  35"
"194","mendocino","2020-04-01","   0","    0","   8","  0","    0","   8"
"195","yuba","2020-04-01","   0","    0","   6","  6","    0","   0"
"196","kings","2020-04-01","   0","    0","   1","  3","    0","  -2"
"197","kern","2020-04-01","   0","    0","  32"," 16","    0","  16"
"198","lake","2020-04-01","   0","    0","   2","  0","    0","   2"
"199","lassen","2020-04-01","   0","    0","   0","  0","    0","   0"
"200","imperial","2020-04-01","   0","    0","   7","  7","    0","   0"
"201","san luis obispo","2020-04-01","   0","    0"," 968"," 11","    0"," 957"
"202","san diego","2020-04-01","   0","    0"," 215","103","    0"," 112"
"203","san benito","2020-04-01","   0","    0","   0","  2","    0","  -2"
"204","santa clara","2020-04-01","   0","    0","  91"," 92","    0","  -1"
"205","monterey","2020-04-01","   0","    0","  15","  8","    0","   7"
"206","colusa","2020-04-01","   0","    0","   5","  1","    0","   4"
"207","napa","2020-04-01","   0","    0","   9","  1","    0","   8"
"208","ventura","2020-04-01","   0","    0","  27"," 28","    0","  -1"
"209","san joaquin","2020-04-01","   0","    0","  21"," 27","    0","  -6"
"210","mariposa","2020-04-01","   0","    0","   0","  0","    0","   0"
"211","san mateo","2020-04-01","   0","    0","  36"," 28","    0","   8"
"212","sacramento","2020-04-01","   0","    0","  74"," 53","    0","  21"
"213","marin","2020-04-01","   0","    0","  14","  6","    0","   8"
"214","los angeles","2020-04-01","   0","    0"," 492","555","    0"," -63"
"215","humboldt","2020-04-01","   0","    0","   7","  3","    0","   4"
"216","tulare","2020-04-01","   0","    0","   9","  7","    0","   2"
"217","butte","2020-04-01","   0","    0","   9","  6","    0","   3"
"218","plumas","2020-04-01","   0","    0","   0","  0","    0","   0"
"219","riverside","2020-04-01","   0","    0","  76"," 76","    0","   0"
"220","stanislaus","2020-04-01","   0","    0","  31"," 16","    0","  15"
"221","san bernardino","2020-04-01","   0","    0","  34"," 91","    0"," -57"
"222","santa clara","2020-04-02","   0","    0","  95"," 88","    0","   7"
"223","san diego","2020-04-02","   0","    0"," 206","104","    0"," 102"
"224","sonoma","2020-04-02","   0","    0","  10","  1","    0","   9"
"225","lassen","2020-04-02","   0","    0","   0","  0","    0","   0"
"226","lake","2020-04-02","   0","    0","   2","  0","    0","   2"
"227","shasta","2020-04-02","   0","    0","  10","  1","    0","   9"
"228","orange","2020-04-02","   0","    0","  96","114","    0"," -18"
"229","humboldt","2020-04-02","   0","    0","   8","  2","    0","   6"
"230","tulare","2020-04-02","   0","    0","   3","  9","    0","  -6"
"231","trinity","2020-04-02","   0","    0","   0","  0","    0","   0"
"232","yolo","2020-04-02","   0","    0","   0","  5","    0","  -5"
"233","butte","2020-04-02","   0","    0","  12","  4","    0","   8"
"234","monterey","2020-04-02","   0","    0","  12","  6","    0","   6"
"235","los angeles","2020-04-02","   0","    0"," 488","539","    0"," -51"
"236","san bernardino","2020-04-02","   0","    0","  37"," 95","    0"," -58"
"237","riverside","2020-04-02","   0","    0"," 104"," 94","    0","  10"
"238","sacramento","2020-04-02","   0","    0","  80"," 43","    0","  37"
"239","tehama","2020-04-02","   0","    0","   4","  1","    0","   3"
"240","mariposa","2020-04-02","   0","    0","   0","  0","    0","   0"
"241","kern","2020-04-02","   0","    0","  36"," 35","    0","   1"
"242","colusa","2020-04-02","   0","    0","   5","  1","    0","   4"
"243","sutter","2020-04-02","   0","    0","   0","  0","    0","   0"
"244","fresno","2020-04-02","   0","    0","  33"," 19","    0","  14"
"245","del norte","2020-04-02","   0","    0","   2","  0","    0","   2"
"246","amador","2020-04-02","   0","    0","   2","  0","    0","   2"
"247","siskiyou","2020-04-02","   0","    0","   4","  2","    0","   2"
"248","napa","2020-04-02","   0","    0","  12","  2","    0","  10"
"249","san mateo","2020-04-02","   0","    0","  26"," 30","    0","  -4"
"250","merced","2020-04-02","   0","    0","   3","  1","    0","   2"
"251","tuolumne","2020-04-02","   0","    0","   2","  0","    0","   2"
"252","inyo","2020-04-02","   0","    0","   3","  1","    0","   2"
"253","santa barbara","2020-04-02","   0","    0","  47"," 28","    0","  19"
"254","san joaquin","2020-04-02","   0","    0","  17"," 27","    0"," -10"
"255","imperial","2020-04-02","   0","    0","   6","  8","    0","  -2"
"256","ventura","2020-04-02","   0","    0","  15"," 31","    0"," -16"
"257","santa cruz","2020-04-02","   0","    0","   7","  3","    0","   4"
"258","stanislaus","2020-04-02","   0","    0","  22"," 18","    0","   4"
"259","el dorado","2020-04-02","   0","    0","  10","  6","    0","   4"
"260","mono","2020-04-02","   0","    0","   2","  0","    0","   2"
"261","marin","2020-04-02","   0","    0","  16","  4","    0","  12"
"262","san francisco","2020-04-02","   0","    0","  58"," 43","    0","  15"
"263","yuba","2020-04-02","   0","    0","   4","  8","    0","  -4"
"264","calaveras","2020-04-02","   0","    0","   5","  0","    0","   5"
"265","plumas","2020-04-02","   0","    0","   0","  0","    0","   0"
"266","placer","2020-04-02","   0","    0","  11","  9","    0","   2"
"267","glenn","2020-04-02","   0","    0","   0","  0","    0","   0"
"268","nevada","2020-04-02","   0","    0","   6","  3","    0","   3"
"269","mendocino","2020-04-02","   0","    0","   8","  0","    0","   8"
"270","alameda","2020-04-02","   0","    0"," 112"," 46","    0","  66"
"271","contra costa","2020-04-02","   0","    0","  73"," 23","    0","  50"
"272","kings","2020-04-02","   0","    0","   7","  2","    0","   5"
"273","modoc","2020-04-02","   0","    0","   0","  0","    0","   0"
"274","san luis obispo","2020-04-02","   0","    0"," 966","  8","    0"," 958"
"275","san benito","2020-04-02","   0","    0","   0","  2","    0","  -2"
"276","solano","2020-04-02","   0","    0","  27","  8","    0","  19"
"277","madera","2020-04-02","   0","    0","   6","  4","    0","   2"
"278","placer","2020-04-03","   0","    0","   7"," 11","    0","  -4"
"279","san diego","2020-04-03","   0","    0"," 216","112","    0"," 104"
"280","lake","2020-04-03","   0","    0","   2","  1","    0","   1"
"281","imperial","2020-04-03","   0","    0","   5","  7","    0","  -2"
"282","sutter","2020-04-03","   0","    0","   0","  0","    0","   0"
"283","solano","2020-04-03","   0","    0","  23"," 12","    0","  11"
"284","modoc","2020-04-03","   0","    0","   0","  0","    0","   0"
"285","yuba","2020-04-03","   0","    0","   5","  4","    0","   1"
"286","tulare","2020-04-03","   0","    0","   3","  7","    0","  -4"
"287","inyo","2020-04-03","   0","    0","   1","  3","    0","  -2"
"288","mendocino","2020-04-03","   0","    0","   6","  1","    0","   5"
"289","contra costa","2020-04-03","   0","    0","  75"," 25","    0","  50"
"290","riverside","2020-04-03","   0","    0"," 127","103","    0","  24"
"291","tehama","2020-04-03","   0","    0","   8","  0","    0","   8"
"292","calaveras","2020-04-03","   0","    0","   5","  0","    0","   5"
"293","del norte","2020-04-03","   0","    0","   2","  0","    0","   2"
"294","santa cruz","2020-04-03","   0","    0","   2","  3","    0","  -1"
"295","el dorado","2020-04-03","   0","    0","  14","  4","    0","  10"
"296","colusa","2020-04-03","   0","    0","   5","  1","    0","   4"
"297","tuolumne","2020-04-03","   0","    0","   1","  0","    0","   1"
"298","plumas","2020-04-03","   0","    0","   0","  0","    0","   0"
"299","madera","2020-04-03","   0","    0","   7","  1","    0","   6"
"300","humboldt","2020-04-03","   0","    0","  10","  0","    0","  10"
"301","kings","2020-04-03","   0","    0","   3","  1","    0","   2"
"302","ventura","2020-04-03","   0","    0","  56"," 34","    0","  22"
"303","napa","2020-04-03","   0","    0","   9","  1","    0","   8"
"304","mono","2020-04-03","   0","    0","   2","  0","    0","   2"
"305","butte","2020-04-03","   0","    0","   9","  8","    0","   1"
"306","marin","2020-04-03","   0","    0","  17","  8","    0","   9"
"307","san francisco","2020-04-03","   0","    0","  74"," 47","    0","  27"
"308","siskiyou","2020-04-03","   0","    0","   4","  1","    0","   3"
"309","santa clara","2020-04-03","   0","    0","  97"," 88","    0","   9"
"310","monterey","2020-04-03","   0","    0","  17","  4","    0","  13"
"311","yolo","2020-04-03","   0","    0","   4","  9","    0","  -5"
"312","nevada","2020-04-03","   0","    0","   5","  3","    0","   2"
"313","san benito","2020-04-03","   0","    0","   0","  2","    0","  -2"
"314","mariposa","2020-04-03","   0","    0","   0","  0","    0","   0"
"315","stanislaus","2020-04-03","   0","    0","  22"," 20","    0","   2"
"316","sonoma","2020-04-03","   0","    0","  15","  5","    0","  10"
"317","san mateo","2020-04-03","   0","    0","  38"," 30","    0","   8"
"318","san joaquin","2020-04-03","   0","    0","  22"," 26","    0","  -4"
"319","fresno","2020-04-03","   0","    0","  35"," 23","    0","  12"
"320","los angeles","2020-04-03","   0","    0"," 473","631","    0","-158"
"321","orange","2020-04-03","   0","    0"," 151","102","    0","  49"
"322","san bernardino","2020-04-03","   0","    0","  57"," 97","    0"," -40"
"323","sacramento","2020-04-03","   0","    0","  76"," 45","    0","  31"
"324","santa barbara","2020-04-03","   0","    0","  50"," 22","    0","  28"
"325","shasta","2020-04-03","   0","    0","  14","  4","    0","  10"
"326","san luis obispo","2020-04-03","   0","    0"," 967","  5","    0"," 962"
"327","merced","2020-04-03","   0","    0","   4","  2","    0","   2"
"328","kern","2020-04-03","   0","    0","  47"," 28","    0","  19"
"329","amador","2020-04-03","   0","    0","   1","  0","    0","   1"
"330","trinity","2020-04-03","   0","    0","   0","  0","    0","   0"
"331","glenn","2020-04-03","   0","    0","   0","  0","    0","   0"
"332","lassen","2020-04-03","   0","    0","   0","  0","    0","   0"
"333","alameda","2020-04-03","   0","    0"," 117"," 45","    0","  72"
"334","amador","2020-04-04","   0","    0","   2","  0","    0","   2"
"335","humboldt","2020-04-04","   0","    0","   7","  0","    0","   7"
"336","alameda","2020-04-04","   0","    0"," 120"," 53","    0","  67"
"337","orange","2020-04-04","   0","    0"," 153","115","    0","  38"
"338","san benito","2020-04-04","   0","    0","   0","  2","    0","  -2"
"339","san bernardino","2020-04-04","   0","    0","  67","117","    0"," -50"
"340","sutter","2020-04-04","   0","    0","   0","  0","    0","   0"
"341","tuolumne","2020-04-04","   0","    0","   2","  1","    0","   1"
"342","calaveras","2020-04-04","   0","    0","   5","  0","    0","   5"
"343","kings","2020-04-04","   0","    0","   0","  1","    0","  -1"
"344","el dorado","2020-04-04","   0","    0","  12","  3","    0","   9"
"345","napa","2020-04-04","   0","    0","   6","  1","    0","   5"
"346","mariposa","2020-04-04","   0","    0","   0","  0","    0","   0"
"347","placer","2020-04-04","   0","    0","  12"," 11","    0","   1"
"348","san mateo","2020-04-04","   0","    0","  40"," 31","    0","   9"
"349","sacramento","2020-04-04","   0","    0","  82"," 43","    0","  39"
"350","yolo","2020-04-04","   0","    0","   4","  6","    0","  -2"
"351","lassen","2020-04-04","   0","    0","   0","  0","    0","   0"
"352","merced","2020-04-04","   0","    0","   6","  2","    0","   4"
"353","riverside","2020-04-04","   0","    0"," 125"," 95","    0","  30"
"354","san diego","2020-04-04","   0","    0"," 222","105","    0"," 117"
"355","shasta","2020-04-04","   0","    0","  13","  4","    0","   9"
"356","colusa","2020-04-04","   0","    0","   5","  1","    0","   4"
"357","santa clara","2020-04-04","   0","    0","  91"," 91","    0","   0"
"358","tehama","2020-04-04","   0","    0","   8","  0","    0","   8"
"359","trinity","2020-04-04","   0","    0","   0","  0","    0","   0"
"360","nevada","2020-04-04","   0","    0","   5","  4","    0","   1"
"361","santa barbara","2020-04-04","   0","    0","  53"," 20","    0","  33"
"362","mono","2020-04-04","   0","    0","   2","  0","    0","   2"
"363","solano","2020-04-04","   0","    0","  23","  9","    0","  14"
"364","del norte","2020-04-04","   0","    0","   1","  0","    0","   1"
"365","mendocino","2020-04-04","   0","    0","   7","  1","    0","   6"
"366","san luis obispo","2020-04-04","   0","    0"," 954","  6","    0"," 948"
"367","ventura","2020-04-04","   0","    0","  10"," 32","    0"," -22"
"368","yuba","2020-04-04","   0","    0","   7","  4","    0","   3"
"369","fresno","2020-04-04","   0","    0","  36"," 27","    0","   9"
"370","modoc","2020-04-04","   0","    0","   0","  0","    0","   0"
"371","inyo","2020-04-04","   0","    0","   2","  2","    0","   0"
"372","lake","2020-04-04","   0","    0","   4","  1","    0","   3"
"373","stanislaus","2020-04-04","   0","    0","  26"," 21","    0","   5"
"374","sonoma","2020-04-04","   0","    0","  15","  8","    0","   7"
"375","san joaquin","2020-04-04","   0","    0","  24"," 23","    0","   1"
"376","plumas","2020-04-04","   0","    0","   0","  0","    0","   0"
"377","butte","2020-04-04","   0","    0","   7","  5","    0","   2"
"378","siskiyou","2020-04-04","   0","    0","   5","  1","    0","   4"
"379","imperial","2020-04-04","   0","    0","   5","  7","    0","  -2"
"380","kern","2020-04-04","   0","    0","  29"," 25","    0","   4"
"381","santa cruz","2020-04-04","   0","    0","   7","  3","    0","   4"
"382","madera","2020-04-04","   0","    0","   8","  0","    0","   8"
"383","marin","2020-04-04","   0","    0","  12","  8","    0","   4"
"384","glenn","2020-04-04","   0","    0","   0","  0","    0","   0"
"385","tulare","2020-04-04","   0","    0","   6","  6","    0","   0"
"386","los angeles","2020-04-04","   0","    0"," 537","630","    0"," -93"
"387","monterey","2020-04-04","   0","    0","  18","  6","    0","  12"
"388","san francisco","2020-04-04","   0","    0","  79"," 44","    0","  35"
"389","contra costa","2020-04-04","   0","    0","  87"," 19","    0","  68"
"390","santa barbara","2020-04-05","   0","    0","  59"," 20","    0","  39"
"391","inyo","2020-04-05","   0","    0","   3","  1","    0","   2"
"392","yolo","2020-04-05","   0","    0","   4","  6","    0","  -2"
"393","mendocino","2020-04-05","   0","    0","   4","  2","    0","   2"
"394","amador","2020-04-05","   0","    0","   2","  0","    0","   2"
"395","san luis obispo","2020-04-05","   0","    0","  28"," 11","    0","  17"
"396","santa clara","2020-04-05","   0","    0","  90"," 86","    0","   4"
"397","glenn","2020-04-05","   0","    0","   0","  0","    0","   0"
"398","san joaquin","2020-04-05","   0","    0","  19"," 21","    0","  -2"
"399","napa","2020-04-05","   0","    0","  11","  1","    0","  10"
"400","los angeles","2020-04-05","   0","    0"," 554","639","    0"," -85"
"401","ventura","2020-04-05","   0","    0","  12"," 35","    0"," -23"
"402","kings","2020-04-05","   0","    0","   0","  2","    0","  -2"
"403","san diego","2020-04-05","   0","    0"," 247","120","    0"," 127"
"404","el dorado","2020-04-05","   0","    0","   7","  3","    0","   4"
"405","calaveras","2020-04-05","   0","    0","   6","  0","    0","   6"
"406","madera","2020-04-05","   0","    0","   8","  0","    0","   8"
"407","lake","2020-04-05","   0","    0","   3","  2","    0","   1"
"408","monterey","2020-04-05","   0","    0","  23","  4","    0","  19"
"409","plumas","2020-04-05","   0","    0","   0","  0","    0","   0"
"410","imperial","2020-04-05","   0","    0","   3","  9","    0","  -6"
"411","san benito","2020-04-05","   0","    0","   0","  2","    0","  -2"
"412","marin","2020-04-05","   0","    0","  13","  8","    0","   5"
"413","san francisco","2020-04-05","   0","    0","  74"," 48","    0","  26"
"414","merced","2020-04-05","   0","    0","   8","  4","    0","   4"
"415","modoc","2020-04-05","   0","    0","   0","  0","    0","   0"
"416","siskiyou","2020-04-05","   0","    0","   3","  2","    0","   1"
"417","san mateo","2020-04-05","   0","    0","  36"," 30","    0","   6"
"418","placer","2020-04-05","   0","    0","  10"," 11","    0","  -1"
"419","butte","2020-04-05","   0","    0","  10","  7","    0","   3"
"420","nevada","2020-04-05","   0","    0","   3","  3","    0","   0"
"421","santa cruz","2020-04-05","   0","    0","  10","  8","    0","   2"
"422","mariposa","2020-04-05","   0","    0","   0","  0","    0","   0"
"423","san bernardino","2020-04-05","   0","    0","  70","113","    0"," -43"
"424","solano","2020-04-05","   0","    0","   3"," 30","    0"," -27"
"425","humboldt","2020-04-05","   0","    0","   8","  0","    0","   8"
"426","del norte","2020-04-05","   0","    0","   1","  0","    0","   1"
"427","contra costa","2020-04-05","   0","    0","  74"," 25","    0","  49"
"428","lassen","2020-04-05","   0","    0","   0","  0","    0","   0"
"429","kern","2020-04-05","   0","    0","  40"," 16","    0","  24"
"430","colusa","2020-04-05","   0","    0","   5","  1","    0","   4"
"431","stanislaus","2020-04-05","   0","    0","  30"," 19","    0","  11"
"432","tulare","2020-04-05","   0","    0","   3"," 10","    0","  -7"
"433","trinity","2020-04-05","   0","    0","   0","  0","    0","   0"
"434","yuba","2020-04-05","   0","    0","  10","  2","    0","   8"
"435","sacramento","2020-04-05","   0","    0","  82"," 49","    0","  33"
"436","orange","2020-04-05","   0","    0"," 156","116","    0","  40"
"437","riverside","2020-04-05","   0","    0"," 130","107","    0","  23"
"438","sonoma","2020-04-05","   0","    0","  16","  8","    0","   8"
"439","mono","2020-04-05","   0","    0","   2","  0","    0","   2"
"440","sutter","2020-04-05","   0","    0","   0","  0","    0","   0"
"441","alameda","2020-04-05","   0","    0"," 113"," 52","    0","  61"
"442","fresno","2020-04-05","   0","    0","  39"," 23","    0","  16"
"443","tehama","2020-04-05","   0","    0","   5","  0","    0","   5"
"444","tuolumne","2020-04-05","   0","    0","   4","  0","    0","   4"
"445","shasta","2020-04-05","   0","    0","  13","  4","    0","   9"
"446","trinity","2020-04-06","   0","    0","   0","  0","    0","   0"
"447","del norte","2020-04-06","   0","    0","   0","  0","    0","   0"
"448","san luis obispo","2020-04-06","   0","    0","  42","  4","    0","  38"
"449","madera","2020-04-06","   0","    0","   8","  1","    0","   7"
"450","mendocino","2020-04-06","   0","    0","  10","  2","    0","   8"
"451","santa barbara","2020-04-06","   0","    0","  54"," 24","    0","  30"
"452","kern","2020-04-06","   0","    0","  39"," 17","    0","  22"
"453","siskiyou","2020-04-06","   0","    0","   5","  0","    0","   5"
"454","fresno","2020-04-06","   0","    0","  45"," 31","    0","  14"
"455","san francisco","2020-04-06","   0","    0","  71"," 43","    0","  28"
"456","san diego","2020-04-06","   0","    0"," 270","108","    0"," 162"
"457","tuolumne","2020-04-06","   0","    0","   0","  0","    0","   0"
"458","los angeles","2020-04-06","   0","    0"," 587","661","    0"," -74"
"459","riverside","2020-04-06","   0","    0"," 152","111","    0","  41"
"460","glenn","2020-04-06","   0","    0","   0","  0","    0","   0"
"461","calaveras","2020-04-06","   0","    0","   6","  0","    0","   6"
"462","lake","2020-04-06","   0","    0","   1","  2","    0","  -1"
"463","yuba","2020-04-06","   0","    0","   7","  4","    0","   3"
"464","butte","2020-04-06","   0","    0","   9","  6","    0","   3"
"465","marin","2020-04-06","   0","    0","  13","  8","    0","   5"
"466","orange","2020-04-06","   0","    0"," 134","106","    0","  28"
"467","nevada","2020-04-06","   0","    0","   4","  3","    0","   1"
"468","stanislaus","2020-04-06","   0","    0","  37"," 16","    0","  21"
"469","colusa","2020-04-06","   0","    0","   6","  0","    0","   6"
"470","mono","2020-04-06","   0","    0","   2","  0","    0","   2"
"471","tulare","2020-04-06","   0","    0","  16"," 11","    0","   5"
"472","san bernardino","2020-04-06","   0","    0"," 102","103","    0","  -1"
"473","monterey","2020-04-06","   0","    0","  18","  6","    0","  12"
"474","yolo","2020-04-06","   0","    0","  -3","  7","    0"," -10"
"475","san mateo","2020-04-06","   0","    0","  36"," 30","    0","   6"
"476","contra costa","2020-04-06","   0","    0","  78"," 26","    0","  52"
"477","merced","2020-04-06","   0","    0","   4","  2","    0","   2"
"478","san joaquin","2020-04-06","   0","    0","  20"," 17","    0","   3"
"479","shasta","2020-04-06","   0","    0","  28","  4","    0","  24"
"480","plumas","2020-04-06","   0","    0","   0","  0","    0","   0"
"481","el dorado","2020-04-06","   0","    0","  10","  0","    0","  10"
"482","lassen","2020-04-06","   0","    0","   0","  0","    0","   0"
"483","sonoma","2020-04-06","   0","    0","  20","  6","    0","  14"
"484","santa clara","2020-04-06","   0","    0"," 100"," 89","    0","  11"
"485","ventura","2020-04-06","   0","    0","  32"," 29","    0","   3"
"486","modoc","2020-04-06","   0","    0","   0","  0","    0","   0"
"487","sacramento","2020-04-06","   0","    0","  75"," 45","    0","  30"
"488","imperial","2020-04-06","   0","    0","   3","  9","    0","  -6"
"489","amador","2020-04-06","   0","    0","   2","  0","    0","   2"
"490","napa","2020-04-06","   0","    0","  15","  0","    0","  15"
"491","humboldt","2020-04-06","   0","    0","   2","  3","    0","  -1"
"492","santa cruz","2020-04-06","   0","    0","   5","  6","    0","  -1"
"493","tehama","2020-04-06","   0","    0","   4","  0","    0","   4"
"494","mariposa","2020-04-06","   0","    0","   0","  0","    0","   0"
"495","alameda","2020-04-06","   0","    0","  92"," 62","    0","  30"
"496","inyo","2020-04-06","   0","    0","   3","  1","    0","   2"
"497","placer","2020-04-06","   0","    0","  24"," 11","    0","  13"
"498","solano","2020-04-06","   0","    0","  28"," 12","    0","  16"
"499","sutter","2020-04-06","   0","    0","   0","  0","    0","   0"
"500","san benito","2020-04-06","   0","    0","   0","  2","    0","  -2"
"501","kings","2020-04-06","   0","    0","   3","  2","    0","   1"
"502","madera","2020-04-07","   0","    0","   7","  1","    0","   6"
"503","santa clara","2020-04-07","   0","    0"," 105"," 84","    0","  21"
"504","san diego","2020-04-07","   0","    0"," 189","116","    0","  73"
"505","lassen","2020-04-07","   0","    0","   0","  0","    0","   0"
"506","shasta","2020-04-07","   0","    0","   6","  5","    0","   1"
"507","amador","2020-04-07","   0","    0","   3","  0","    0","   3"
"508","trinity","2020-04-07","   0","    0","   0","  0","    0","   0"
"509","inyo","2020-04-07","   0","    0","   3","  1","    0","   2"
"510","fresno","2020-04-07","   0","    0","  50"," 24","    0","  26"
"511","tulare","2020-04-07","   0","    0","  10"," 11","    0","  -1"
"512","glenn","2020-04-07","   0","    0","   0","  0","    0","   0"
"513","sonoma","2020-04-07","   0","    0","  21","  8","    0","  13"
"514","mendocino","2020-04-07","   0","    0","   9","  0","    0","   9"
"515","los angeles","2020-04-07","   0","    0"," 603","679","    0"," -76"
"516","san francisco","2020-04-07","   0","    0","  57"," 45","    0","  12"
"517","san bernardino","2020-04-07","   0","    0"," 126","103","    0","  23"
"518","ventura","2020-04-07","   0","    0","  31"," 29","    0","   2"
"519","riverside","2020-04-07","   0","    0"," 129","114","    0","  15"
"520","sutter","2020-04-07","   0","    0","   0","  0","    0","   0"
"521","plumas","2020-04-07","   0","    0","   0","  0","    0","   0"
"522","tehama","2020-04-07","   0","    0","   2","  0","    0","   2"
"523","contra costa","2020-04-07","   0","    0","  82"," 26","    0","  56"
"524","stanislaus","2020-04-07","   0","    0","  32"," 22","    0","  10"
"525","orange","2020-04-07","   0","    0"," 136","100","    0","  36"
"526","monterey","2020-04-07","   0","    0","  21","  9","    0","  12"
"527","calaveras","2020-04-07","   0","    0","   8","  0","    0","   8"
"528","humboldt","2020-04-07","   0","    0","   7","  0","    0","   7"
"529","imperial","2020-04-07","   0","    0","   3","  9","    0","  -6"
"530","santa barbara","2020-04-07","   0","    0","  48"," 24","    0","  24"
"531","kings","2020-04-07","   0","    0","   3","  2","    0","   1"
"532","alameda","2020-04-07","   0","    0","  90"," 68","    0","  22"
"533","san joaquin","2020-04-07","   0","    0","  20"," 18","    0","   2"
"534","san benito","2020-04-07","   0","    0","   0","  2","    0","  -2"
"535","del norte","2020-04-07","   0","    0","   2","  1","    0","   1"
"536","marin","2020-04-07","   0","    0","  12","  8","    0","   4"
"537","placer","2020-04-07","   0","    0","  20"," 12","    0","   8"
"538","mariposa","2020-04-07","   0","    0","   0","  0","    0","   0"
"539","butte","2020-04-07","   0","    0","   6","  6","    0","   0"
"540","santa cruz","2020-04-07","   0","    0","   4","  7","    0","  -3"
"541","merced","2020-04-07","   0","    0","   3","  3","    0","   0"
"542","siskiyou","2020-04-07","   0","    0","   5","  1","    0","   4"
"543","nevada","2020-04-07","   0","    0","   3","  3","    0","   0"
"544","yolo","2020-04-07","   0","    0","   4","  3","    0","   1"
"545","lake","2020-04-07","   0","    0","   1","  0","    0","   1"
"546","solano","2020-04-07","   0","    0","  31"," 13","    0","  18"
"547","modoc","2020-04-07","   0","    0","   0","  0","    0","   0"
"548","san luis obispo","2020-04-07","   0","    0","  30","  6","    0","  24"
"549","yuba","2020-04-07","   0","    0","   6","  6","    0","   0"
"550","sacramento","2020-04-07","   0","    0","  72"," 46","    0","  26"
"551","el dorado","2020-04-07","   0","    0","  10","  3","    0","   7"
"552","mono","2020-04-07","   0","    0","   2","  0","    0","   2"
"553","colusa","2020-04-07","   0","    0","   6","  0","    0","   6"
"554","kern","2020-04-07","   0","    0","  50"," 27","    0","  23"
"555","tuolumne","2020-04-07","   0","    0","   0","  0","    0","   0"
"556","napa","2020-04-07","   0","    0","   7","  3","    0","   4"
"557","san mateo","2020-04-07","   0","    0","  35"," 28","    0","   7"
"558","lassen","2020-04-08","   0","    0","   0","  0","    0","   0"
"559","san francisco","2020-04-08","   0","    0","  55"," 53","    0","   2"
"560","el dorado","2020-04-08","   0","    0","  10","  1","    0","   9"
"561","plumas","2020-04-08","   0","    0","   0","  0","    0","   0"
"562","napa","2020-04-08","   0","    0","   5","  1","    0","   4"
"563","san benito","2020-04-08","   0","    0","   1","  1","    0","   0"
"564","san luis obispo","2020-04-08","   0","    0","  22"," 13","    0","   9"
"565","yuba","2020-04-08","   0","    0","   5","  4","    0","   1"
"566","del norte","2020-04-08","   0","    0","   4","  1","    0","   3"
"567","san mateo","2020-04-08","   0","    0","  32"," 27","    0","   5"
"568","stanislaus","2020-04-08","   0","    0","  58"," 16","    0","  42"
"569","mono","2020-04-08","   0","    0","   2","  0","    0","   2"
"570","shasta","2020-04-08","   0","    0","  10","  4","    0","   6"
"571","los angeles","2020-04-08","   0","    0"," 582","743","    0","-161"
"572","sutter","2020-04-08","   0","    0","   0","  0","    0","   0"
"573","inyo","2020-04-08","   0","    0","   2","  2","    0","   0"
"574","humboldt","2020-04-08","   0","    0","   6","  0","    0","   6"
"575","orange","2020-04-08","   0","    0"," 201"," 83","    0"," 118"
"576","kern","2020-04-08","   0","    0","  32"," 19","    0","  13"
"577","merced","2020-04-08","   0","    0","   5","  2","    0","   3"
"578","calaveras","2020-04-08","   0","    0","   8","  0","    0","   8"
"579","madera","2020-04-08","   0","    0","   7","  1","    0","   6"
"580","nevada","2020-04-08","   0","    0","   6","  4","    0","   2"
"581","tuolumne","2020-04-08","   0","    0","   1","  0","    0","   1"
"582","yolo","2020-04-08","   0","    0","   6","  3","    0","   3"
"583","ventura","2020-04-08","   0","    0","  31"," 23","    0","   8"
"584","san joaquin","2020-04-08","   0","    0","  18"," 19","    0","  -1"
"585","mendocino","2020-04-08","   0","    0","   7","  0","    0","   7"
"586","lake","2020-04-08","   0","    0","   1","  1","    0","   0"
"587","monterey","2020-04-08","   0","    0","  24","  5","    0","  19"
"588","imperial","2020-04-08","   0","    0","   3"," 11","    0","  -8"
"589","marin","2020-04-08","   0","    0","  17","  6","    0","  11"
"590","siskiyou","2020-04-08","   0","    0","   5","  1","    0","   4"
"591","butte","2020-04-08","   0","    0","   4","  8","    0","  -4"
"592","tulare","2020-04-08","   0","    0","  22","  7","    0","  15"
"593","kings","2020-04-08","   0","    0","   1","  2","    0","  -1"
"594","tehama","2020-04-08","   0","    0","   4","  0","    0","   4"
"595","santa barbara","2020-04-08","   0","    0","  51"," 20","    0","  31"
"596","modoc","2020-04-08","   0","    0","   0","  0","    0","   0"
"597","sacramento","2020-04-08","   0","    0","  73"," 40","    0","  33"
"598","contra costa","2020-04-08","   0","    0","  78"," 31","    0","  47"
"599","glenn","2020-04-08","   0","    0","   0","  0","    0","   0"
"600","sonoma","2020-04-08","   0","    0","  18","  7","    0","  11"
"601","placer","2020-04-08","   0","    0","  19"," 12","    0","   7"
"602","amador","2020-04-08","   0","    0","   1","  0","    0","   1"
"603","trinity","2020-04-08","   0","    0","   0","  0","    0","   0"
"604","riverside","2020-04-08","   0","    0"," 154"," 97","    0","  57"
"605","santa cruz","2020-04-08","   0","    0","   8","  7","    0","   1"
"606","san bernardino","2020-04-08","   0","    0"," 144","104","    0","  40"
"607","colusa","2020-04-08","   0","    0","   6","  0","    0","   6"
"608","san diego","2020-04-08","   0","    0"," 183","116","    0","  67"
"609","solano","2020-04-08","   0","    0","  27"," 10","    0","  17"
"610","mariposa","2020-04-08","   0","    0","   0","  0","    0","   0"
"611","alameda","2020-04-08","   0","    0"," 111"," 63","    0","  48"
"612","fresno","2020-04-08","   0","    0","  64"," 18","    0","  46"
"613","santa clara","2020-04-08","   0","    0"," 104"," 76","    0","  28"
"614","plumas","2020-04-09","   0","    0","   0","  0","    0","   0"
"615","siskiyou","2020-04-09","   0","    0","   5","  0","    0","   5"
"616","santa clara","2020-04-09","   0","    0","  87"," 87","    0","   0"
"617","santa cruz","2020-04-09","   0","    0","   7","  7","    0","   0"
"618","lake","2020-04-09","   0","    0","   2","  1","    0","   1"
"619","riverside","2020-04-09","   0","    0"," 133"," 93","    0","  40"
"620","san francisco","2020-04-09","   0","    0","  45"," 46","    0","  -1"
"621","imperial","2020-04-09","   0","    0","   1"," 10","    0","  -9"
"622","contra costa","2020-04-09","   0","    0","  73"," 30","    0","  43"
"623","monterey","2020-04-09","   0","    0","  22","  5","    0","  17"
"624","lassen","2020-04-09","   0","    0","   0","  0","    0","   0"
"625","yuba","2020-04-09","   0","    0","   6","  6","    0","   0"
"626","calaveras","2020-04-09","   0","    0","  11","  0","    0","  11"
"627","nevada","2020-04-09","   0","    0","   4","  3","    0","   1"
"628","san joaquin","2020-04-09","   0","    0","  16"," 19","    0","  -3"
"629","stanislaus","2020-04-09","   0","    0","  45"," 18","    0","  27"
"630","amador","2020-04-09","   0","    0","   3","  0","    0","   3"
"631","placer","2020-04-09","   0","    0","  16"," 10","    0","   6"
"632","modoc","2020-04-09","   0","    0","   0","  0","    0","   0"
"633","tulare","2020-04-09","   0","    0","  19","  9","    0","  10"
"634","kings","2020-04-09","   0","    0","   2","  3","    0","  -1"
"635","san luis obispo","2020-04-09","   0","    0","  21"," 10","    0","  11"
"636","colusa","2020-04-09","   0","    0","   5","  1","    0","   4"
"637","butte","2020-04-09","   0","    0","   5","  5","    0","   0"
"638","sacramento","2020-04-09","   0","    0","  63"," 42","    0","  21"
"639","orange","2020-04-09","   0","    0"," 206"," 74","    0"," 132"
"640","el dorado","2020-04-09","   0","    0","  10","  1","    0","   9"
"641","inyo","2020-04-09","   0","    0","   3","  1","    0","   2"
"642","alameda","2020-04-09","   0","    0"," 107"," 62","    0","  45"
"643","sutter","2020-04-09","   0","    0","   0","  0","    0","   0"
"644","sonoma","2020-04-09","   0","    0","  24","  6","    0","  18"
"645","del norte","2020-04-09","   0","    0","   5","  0","    0","   5"
"646","humboldt","2020-04-09","   0","    0","   6","  2","    0","   4"
"647","fresno","2020-04-09","   0","    0","  59"," 19","    0","  40"
"648","san benito","2020-04-09","   0","    0","   1","  1","    0","   0"
"649","los angeles","2020-04-09","   0","    0"," 569","697","    0","-128"
"650","tuolumne","2020-04-09","   0","    0","   5","  0","    0","   5"
"651","napa","2020-04-09","   0","    0","  10","  0","    0","  10"
"652","mono","2020-04-09","   0","    0","   2","  0","    0","   2"
"653","trinity","2020-04-09","   0","    0","   0","  0","    0","   0"
"654","mariposa","2020-04-09","   0","    0","   0","  0","    0","   0"
"655","glenn","2020-04-09","   0","    0","   0","  0","    0","   0"
"656","marin","2020-04-09","   0","    0","  21","  3","    0","  18"
"657","shasta","2020-04-09","   0","    0","   5","  3","    0","   2"
"658","yolo","2020-04-09","   0","    0","  11","  3","    0","   8"
"659","mendocino","2020-04-09","   0","    0","   8","  0","    0","   8"
"660","solano","2020-04-09","   0","    0","  33","  8","    0","  25"
"661","kern","2020-04-09","   0","    0","  25"," 25","    0","   0"
"662","san mateo","2020-04-09","   0","    0","  39"," 20","    0","  19"
"663","ventura","2020-04-09","   0","    0","  29"," 21","    0","   8"
"664","santa barbara","2020-04-09","   0","    0","  45"," 22","    0","  23"
"665","san diego","2020-04-09","   0","    0"," 163","116","    0","  47"
"666","merced","2020-04-09","   0","    0","   5","  2","    0","   3"
"667","tehama","2020-04-09","   0","    0","   5","  1","    0","   4"
"668","madera","2020-04-09","   0","    0","   5","  2","    0","   3"
"669","san bernardino","2020-04-09","   0","    0"," 143"," 97","    0","  46"
"670","san joaquin","2020-04-10","   0","    0","  20"," 19","    0","   1"
"671","santa clara","2020-04-10","   0","    0","  99"," 72","    0","  27"
"672","ventura","2020-04-10","   0","    0","  30"," 21","    0","   9"
"673","marin","2020-04-10","   0","    0","  17","  2","    0","  15"
"674","tuolumne","2020-04-10","   0","    0","   0","  1","    0","  -1"
"675","nevada","2020-04-10","   0","    0","   6","  3","    0","   3"
"676","merced","2020-04-10","   0","    0","   4","  1","    0","   3"
"677","lake","2020-04-10","   0","    0","   2","  0","    0","   2"
"678","mariposa","2020-04-10","   0","    0","   0","  0","    0","   0"
"679","fresno","2020-04-10","   0","    0","  57"," 20","    0","  37"
"680","amador","2020-04-10","   0","    0","   4","  0","    0","   4"
"681","monterey","2020-04-10","   0","    0","  25","  6","    0","  19"
"682","shasta","2020-04-10","   0","    0","  12","  3","    0","   9"
"683","sacramento","2020-04-10","   0","    0","  69"," 43","    0","  26"
"684","el dorado","2020-04-10","   0","    0","  10","  1","    0","   9"
"685","napa","2020-04-10","   0","    0","   7","  4","    0","   3"
"686","san diego","2020-04-10","   0","    0"," 153","110","    0","  43"
"687","sutter","2020-04-10","   0","    0","   0","  0","    0","   0"
"688","san luis obispo","2020-04-10","   0","    0","  24","  5","    0","  19"
"689","yolo","2020-04-10","   0","    0","   7","  2","    0","   5"
"690","san francisco","2020-04-10","   0","    0"," 125"," 44","    0","  81"
"691","humboldt","2020-04-10","   0","    0","   0","  3","    0","  -3"
"692","santa barbara","2020-04-10","   0","    0","  43"," 20","    0","  23"
"693","inyo","2020-04-10","   0","    0","   3","  1","    0","   2"
"694","stanislaus","2020-04-10","   0","    0","  44"," 14","    0","  30"
"695","santa cruz","2020-04-10","   0","    0","   4","  8","    0","  -4"
"696","placer","2020-04-10","   0","    0","   9"," 12","    0","  -3"
"697","mendocino","2020-04-10","   0","    0","   5","  1","    0","   4"
"698","madera","2020-04-10","   0","    0","   6","  1","    0","   5"
"699","colusa","2020-04-10","   0","    0","   6","  0","    0","   6"
"700","lassen","2020-04-10","   0","    0","   0","  0","    0","   0"
"701","san mateo","2020-04-10","   0","    0","  41"," 21","    0","  20"
"702","san bernardino","2020-04-10","   0","    0"," 134","124","    0","  10"
"703","imperial","2020-04-10","   0","    0","   1"," 11","    0"," -10"
"704","los angeles","2020-04-10","   0","    0"," 663","656","    0","   7"
"705","plumas","2020-04-10","   0","    0","   0","  0","    0","   0"
"706","butte","2020-04-10","   0","    0","   5","  6","    0","  -1"
"707","sonoma","2020-04-10","   0","    0","  32","  7","    0","  25"
"708","solano","2020-04-10","   0","    0","  31"," 12","    0","  19"
"709","glenn","2020-04-10","   0","    0","   0","  0","    0","   0"
"710","modoc","2020-04-10","   0","    0","   0","  0","    0","   0"
"711","del norte","2020-04-10","   0","    0","   4","  0","    0","   4"
"712","yuba","2020-04-10","   0","    0","   7","  1","    0","   6"
"713","tehama","2020-04-10","   0","    0","   8","  0","    0","   8"
"714","orange","2020-04-10","   0","    0"," 187"," 94","    0","  93"
"715","calaveras","2020-04-10","   0","    0","  11","  0","    0","  11"
"716","san benito","2020-04-10","   0","    0","   1","  1","    0","   0"
"717","mono","2020-04-10","   0","    0","   2","  0","    0","   2"
"718","contra costa","2020-04-10","   0","    0","  75"," 23","    0","  52"
"719","trinity","2020-04-10","   0","    0","   0","  0","    0","   0"
"720","alameda","2020-04-10","   0","    0"," 128"," 71","    0","  57"
"721","kern","2020-04-10","   0","    0","  45"," 20","    0","  25"
"722","siskiyou","2020-04-10","   0","    0","   4","  0","    0","   4"
"723","kings","2020-04-10","   0","    0","   1","  3","    0","  -2"
"724","riverside","2020-04-10","   0","    0"," 140"," 91","    0","  49"
"725","tulare","2020-04-10","   0","    0","  16","  7","    0","   9"
"726","fresno","2020-04-11","   0","    0","  52"," 19","    0","  33"
"727","humboldt","2020-04-11","   0","    0","   3","  3","    0","   0"
"728","san benito","2020-04-11","   0","    0","   2","  0","    0","   2"
"729","monterey","2020-04-11","   0","    0","  24","  7","    0","  17"
"730","san diego","2020-04-11","   0","    0"," 140","121","    0","  19"
"731","san luis obispo","2020-04-11","   0","    0","  23","  7","    0","  16"
"732","san francisco","2020-04-11","   0","    0"," 132"," 41","    0","  91"
"733","stanislaus","2020-04-11","   0","    0","  44"," 12","    0","  32"
"734","napa","2020-04-11","   0","    0","   5","  0","    0","   5"
"735","plumas","2020-04-11","   0","    0","   0","  0","    0","   0"
"736","sacramento","2020-04-11","   0","    0","  80"," 39","    0","  41"
"737","butte","2020-04-11","   0","    0","   5","  2","    0","   3"
"738","marin","2020-04-11","   0","    0","  14","  4","    0","  10"
"739","kings","2020-04-11","   0","    0","   1","  4","    0","  -3"
"740","madera","2020-04-11","   0","    0","   5","  2","    0","   3"
"741","yuba","2020-04-11","   0","    0","   9","  2","    0","   7"
"742","calaveras","2020-04-11","   0","    0","  11","  1","    0","  10"
"743","lassen","2020-04-11","   0","    0","   0","  0","    0","   0"
"744","santa clara","2020-04-11","   0","    0"," 106"," 74","    0","  32"
"745","placer","2020-04-11","   0","    0","  13"," 11","    0","   2"
"746","mono","2020-04-11","   0","    0","   2","  0","    0","   2"
"747","modoc","2020-04-11","   0","    0","   0","  0","    0","   0"
"748","tehama","2020-04-11","   0","    0","   7","  0","    0","   7"
"749","santa cruz","2020-04-11","   0","    0","   6","  9","    0","  -3"
"750","kern","2020-04-11","   0","    0","  41"," 21","    0","  20"
"751","san bernardino","2020-04-11","   0","    0"," 117"," 99","    0","  18"
"752","orange","2020-04-11","   0","    0"," 219"," 64","    0"," 155"
"753","nevada","2020-04-11","   0","    0","   5","  3","    0","   2"
"754","colusa","2020-04-11","   0","    0","   6","  0","    0","   6"
"755","riverside","2020-04-11","   0","    0"," 149"," 83","    0","  66"
"756","glenn","2020-04-11","   0","    0","   0","  0","    0","   0"
"757","del norte","2020-04-11","   0","    0","   5","  1","    0","   4"
"758","trinity","2020-04-11","   0","    0","   0","  0","    0","   0"
"759","merced","2020-04-11","   0","    0","   3","  1","    0","   2"
"760","tulare","2020-04-11","   0","    0","  19","  6","    0","  13"
"761","sonoma","2020-04-11","   0","    0","  30","  5","    0","  25"
"762","solano","2020-04-11","   0","    0","  32"," 13","    0","  19"
"763","imperial","2020-04-11","   0","    0","   1"," 10","    0","  -9"
"764","el dorado","2020-04-11","   0","    0","   9","  1","    0","   8"
"765","contra costa","2020-04-11","   0","    0","  75"," 30","    0","  45"
"766","mariposa","2020-04-11","   0","    0","   0","  0","    0","   0"
"767","yolo","2020-04-11","   0","    0","   7","  1","    0","   6"
"768","amador","2020-04-11","   0","    0","   4","  0","    0","   4"
"769","inyo","2020-04-11","   0","    0","   3","  1","    0","   2"
"770","sutter","2020-04-11","   0","    0","   0","  0","    0","   0"
"771","alameda","2020-04-11","   0","    0"," 121"," 65","    0","  56"
"772","san mateo","2020-04-11","   0","    0","  42"," 20","    0","  22"
"773","ventura","2020-04-11","   0","    0","  33"," 20","    0","  13"
"774","lake","2020-04-11","   0","    0","   0","  0","    0","   0"
"775","siskiyou","2020-04-11","   0","    0","   4","  0","    0","   4"
"776","los angeles","2020-04-11","   0","    0"," 595","690","    0"," -95"
"777","shasta","2020-04-11","   0","    0","  12","  2","    0","  10"
"778","tuolumne","2020-04-11","   0","    0","   3","  0","    0","   3"
"779","santa barbara","2020-04-11","   0","    0","  53"," 25","    0","  28"
"780","mendocino","2020-04-11","   0","    0","   9","  1","    0","   8"
"781","san joaquin","2020-04-11","   0","    0","  28"," 19","    0","   9"
"782","colusa","2020-04-12","   0","    0","   6","  0","    0","   6"
"783","fresno","2020-04-12","   0","    0","  54"," 15","    0","  39"
"784","san francisco","2020-04-12","   0","    0","  71"," 37","    0","  34"
"785","tulare","2020-04-12","   0","    0","  22","  7","    0","  15"
"786","shasta","2020-04-12","   0","    0","  15","  2","    0","  13"
"787","merced","2020-04-12","   0","    0","   2","  2","    0","   0"
"788","sacramento","2020-04-12","   0","    0","  68"," 37","    0","  31"
"789","monterey","2020-04-12","   0","    0","  26","  8","    0","  18"
"790","santa clara","2020-04-12","   0","    0"," 102"," 74","    0","  28"
"791","san bernardino","2020-04-12","   0","    0"," 108"," 99","    0","   9"
"792","stanislaus","2020-04-12","   0","    0","   7"," 11","    0","  -4"
"793","ventura","2020-04-12","   0","    0","  36"," 16","    0","  20"
"794","napa","2020-04-12","   0","    0","   6","  0","    0","   6"
"795","amador","2020-04-12","   0","    0","   3","  0","    0","   3"
"796","glenn","2020-04-12","   0","    0","   0","  0","    0","   0"
"797","lake","2020-04-12","   0","    0","   0","  0","    0","   0"
"798","trinity","2020-04-12","   0","    0","   0","  0","    0","   0"
"799","san diego","2020-04-12","   0","    0"," 170","118","    0","  52"
"800","modoc","2020-04-12","   0","    0","   0","  0","    0","   0"
"801","calaveras","2020-04-12","   0","    0","   9","  2","    0","   7"
"802","santa cruz","2020-04-12","   0","    0","   4","  9","    0","  -5"
"803","tehama","2020-04-12","   0","    0","   6","  0","    0","   6"
"804","plumas","2020-04-12","   0","    0","   0","  0","    0","   0"
"805","mariposa","2020-04-12","   0","    0","   0","  0","    0","   0"
"806","placer","2020-04-12","   0","    0","   6","  9","    0","  -3"
"807","marin","2020-04-12","   0","    0","  13","  2","    0","  11"
"808","mono","2020-04-12","   0","    0","   2","  0","    0","   2"
"809","yolo","2020-04-12","   0","    0","   3","  2","    0","   1"
"810","sutter","2020-04-12","   0","    0","   0","  0","    0","   0"
"811","solano","2020-04-12","   0","    0","  30"," 17","    0","  13"
"812","el dorado","2020-04-12","   0","    0","  11","  0","    0","  11"
"813","madera","2020-04-12","   0","    0","   5","  0","    0","   5"
"814","kings","2020-04-12","   0","    0","   3","  3","    0","   0"
"815","contra costa","2020-04-12","   0","    0","  64"," 19","    0","  45"
"816","santa barbara","2020-04-12","   0","    0","  53"," 22","    0","  31"
"817","humboldt","2020-04-12","   0","    0","   3","  2","    0","   1"
"818","nevada","2020-04-12","   0","    0","   4","  4","    0","   0"
"819","imperial","2020-04-12","   0","    0","   2","  9","    0","  -7"
"820","del norte","2020-04-12","   0","    0","   6","  0","    0","   6"
"821","inyo","2020-04-12","   0","    0","   4","  1","    0","   3"
"822","san benito","2020-04-12","   0","    0","   2","  0","    0","   2"
"823","san mateo","2020-04-12","   0","    0","  23"," 18","    0","   5"
"824","siskiyou","2020-04-12","   0","    0","   6","  0","    0","   6"
"825","san luis obispo","2020-04-12","   0","    0","  24","  6","    0","  18"
"826","lassen","2020-04-12","   0","    0","   0","  0","    0","   0"
"827","butte","2020-04-12","   0","    0","  15","  2","    0","  13"
"828","kern","2020-04-12","   0","    0","  41"," 21","    0","  20"
"829","san joaquin","2020-04-12","   0","    0","  23"," 16","    0","   7"
"830","mendocino","2020-04-12","   0","    0","   6","  0","    0","   6"
"831","tuolumne","2020-04-12","   0","    0","   5","  0","    0","   5"
"832","orange","2020-04-12","   0","    0"," 190"," 96","    0","  94"
"833","alameda","2020-04-12","   0","    0","  52"," 63","    0"," -11"
"834","sonoma","2020-04-12","   0","    0","  25","  4","    0","  21"
"835","los angeles","2020-04-12","   0","    0"," 564","703","    0","-139"
"836","riverside","2020-04-12","   0","    0"," 146"," 95","    0","  51"
"837","yuba","2020-04-12","   0","    0","   6","  1","    0","   5"
"838","humboldt","2020-04-13","   0","    0","  10","  1","    0","   9"
"839","tuolumne","2020-04-13","   0","    0","   6","  0","    0","   6"
"840","yuba","2020-04-13","   0","    0","   8","  0","    0","   8"
"841","san joaquin","2020-04-13","   0","    0","  14"," 20","    0","  -6"
"842","ventura","2020-04-13","   0","    0","  35"," 18","    0","  17"
"843","glenn","2020-04-13","   0","    0","   0","  0","    0","   0"
"844","kings","2020-04-13","   0","    0","   0","  1","    0","  -1"
"845","lassen","2020-04-13","   0","    0","   0","  0","    0","   0"
"846","madera","2020-04-13","   0","    0","   8","  1","    0","   7"
"847","san benito","2020-04-13","   0","    0","   2","  0","    0","   2"
"848","sonoma","2020-04-13","   0","    0","  31","  4","    0","  27"
"849","calaveras","2020-04-13","   0","    0","  10","  1","    0","   9"
"850","plumas","2020-04-13","   0","    0","   0","  0","    0","   0"
"851","siskiyou","2020-04-13","   0","    0","   3","  2","    0","   1"
"852","marin","2020-04-13","   0","    0","  12","  3","    0","   9"
"853","santa cruz","2020-04-13","   0","    0","   1","  5","    0","  -4"
"854","shasta","2020-04-13","   0","    0","   6","  2","    0","   4"
"855","merced","2020-04-13","   0","    0","   5","  1","    0","   4"
"856","san mateo","2020-04-13","   0","    0","  26"," 22","    0","   4"
"857","riverside","2020-04-13","   0","    0"," 132"," 96","    0","  36"
"858","fresno","2020-04-13","   0","    0","  60"," 20","    0","  40"
"859","nevada","2020-04-13","   0","    0","   5","  4","    0","   1"
"860","santa barbara","2020-04-13","   0","    0","  59"," 23","    0","  36"
"861","modoc","2020-04-13","   0","    0","   0","  0","    0","   0"
"862","tehama","2020-04-13","   0","    0","   6","  0","    0","   6"
"863","del norte","2020-04-13","   0","    0","   3","  1","    0","   2"
"864","monterey","2020-04-13","   0","    0","  21","  6","    0","  15"
"865","orange","2020-04-13","   0","    0"," 205"," 71","    0"," 134"
"866","kern","2020-04-13","   0","    0","  49"," 19","    0","  30"
"867","el dorado","2020-04-13","   0","    0","  12","  1","    0","  11"
"868","san bernardino","2020-04-13","   0","    0"," 135"," 84","    0","  51"
"869","san diego","2020-04-13","   0","    0"," 171","125","    0","  46"
"870","amador","2020-04-13","   0","    0","   3","  0","    0","   3"
"871","alameda","2020-04-13","   0","    0","  58"," 61","    0","  -3"
"872","sutter","2020-04-13","   0","    0","   0","  0","    0","   0"
"873","santa clara","2020-04-13","   0","    0","  87"," 76","    0","  11"
"874","mendocino","2020-04-13","   0","    0","   6","  3","    0","   3"
"875","napa","2020-04-13","   0","    0","   9","  0","    0","   9"
"876","solano","2020-04-13","   0","    0","  27"," 12","    0","  15"
"877","placer","2020-04-13","   0","    0","  10","  8","    0","   2"
"878","sacramento","2020-04-13","   0","    0","  65"," 35","    0","  30"
"879","contra costa","2020-04-13","   0","    0","  69"," 21","    0","  48"
"880","mono","2020-04-13","   0","    0","   2","  0","    0","   2"
"881","san luis obispo","2020-04-13","   0","    0","  20","  4","    0","  16"
"882","mariposa","2020-04-13","   0","    0","   0","  0","    0","   0"
"883","yolo","2020-04-13","   0","    0","  14","  2","    0","  12"
"884","los angeles","2020-04-13","   0","    0"," 632","720","    0"," -88"
"885","colusa","2020-04-13","   0","    0","   6","  0","    0","   6"
"886","inyo","2020-04-13","   0","    0","   3","  3","    0","   0"
"887","trinity","2020-04-13","   0","    0","   0","  0","    0","   0"
"888","butte","2020-04-13","   0","    0","   3","  8","    0","  -5"
"889","tulare","2020-04-13","   0","    0","  18","  6","    0","  12"
"890","imperial","2020-04-13","   0","    0","   6","  8","    0","  -2"
"891","stanislaus","2020-04-13","   0","    0","  45"," 14","    0","  31"
"892","lake","2020-04-13","   0","    0","   3","  1","    0","   2"
"893","san francisco","2020-04-13","   0","    0","  61"," 39","    0","  22"
"894","alameda","2020-04-14","   0","    0","  61"," 55","    0","   6"
"895","lake","2020-04-14","   0","    0","   3","  0","    0","   3"
"896","siskiyou","2020-04-14","   0","    0","   2","  0","    0","   2"
"897","imperial","2020-04-14","   0","    0","   3","  9","    0","  -6"
"898","santa clara","2020-04-14","   0","    0"," 104"," 71","    0","  33"
"899","tehama","2020-04-14","   0","    0","   4","  0","    0","   4"
"900","san luis obispo","2020-04-14","   0","    0","  18","  8","    0","  10"
"901","san francisco","2020-04-14","   0","    0","  69"," 33","    0","  36"
"902","del norte","2020-04-14","   0","    0","   4","  4","    0","   0"
"903","mono","2020-04-14","   0","    0","   2","  0","    0","   2"
"904","lassen","2020-04-14","   0","    0","   0","  0","    0","   0"
"905","san bernardino","2020-04-14","   0","    0"," 117","102","    0","  15"
"906","humboldt","2020-04-14","   0","    0","  10","  0","    0","  10"
"907","el dorado","2020-04-14","   0","    0","  12","  0","    0","  12"
"908","san joaquin","2020-04-14","   0","    0","  12"," 13","    0","  -1"
"909","plumas","2020-04-14","   0","    0","   0","  0","    0","   0"
"910","fresno","2020-04-14","   0","    0","  42"," 20","    0","  22"
"911","sutter","2020-04-14","   0","    0","   0","  0","    0","   0"
"912","glenn","2020-04-14","   0","    0","   0","  0","    0","   0"
"913","shasta","2020-04-14","   0","    0","   9","  3","    0","   6"
"914","orange","2020-04-14","   0","    0"," 259"," 88","    0"," 171"
"915","mariposa","2020-04-14","   0","    0","   0","  0","    0","   0"
"916","calaveras","2020-04-14","   0","    0","  12","  0","    0","  12"
"917","napa","2020-04-14","   0","    0","   8","  0","    0","   8"
"918","amador","2020-04-14","   0","    0","   4","  0","    0","   4"
"919","ventura","2020-04-14","   0","    0","  43"," 16","    0","  27"
"920","sacramento","2020-04-14","   0","    0","  59"," 32","    0","  27"
"921","san mateo","2020-04-14","   0","    0","  25"," 23","    0","   2"
"922","nevada","2020-04-14","   0","    0","   7","  3","    0","   4"
"923","yuba","2020-04-14","   0","    0","   7","  1","    0","   6"
"924","sonoma","2020-04-14","   0","    0","  23","  4","    0","  19"
"925","placer","2020-04-14","   0","    0","   9","  9","    0","   0"
"926","riverside","2020-04-14","   0","    0"," 141","100","    0","  41"
"927","trinity","2020-04-14","   0","    0","   0","  0","    0","   0"
"928","colusa","2020-04-14","   0","    0","   6","  0","    0","   6"
"929","san benito","2020-04-14","   0","    0","   2","  0","    0","   2"
"930","stanislaus","2020-04-14","   0","    0","  50"," 16","    0","  34"
"931","butte","2020-04-14","   0","    0","   4","  7","    0","  -3"
"932","kings","2020-04-14","   0","    0","   2","  2","    0","   0"
"933","tulare","2020-04-14","   0","    0","  18","  6","    0","  12"
"934","san diego","2020-04-14","   0","    0"," 162","123","    0","  39"
"935","madera","2020-04-14","   0","    0","   7","  2","    0","   5"
"936","santa cruz","2020-04-14","   0","    0","   3","  3","    0","   0"
"937","contra costa","2020-04-14","   0","    0","  61"," 24","    0","  37"
"938","los angeles","2020-04-14","   0","    0"," 614","703","    0"," -89"
"939","merced","2020-04-14","   0","    0","   4","  2","    0","   2"
"940","santa barbara","2020-04-14","   0","    0","  64"," 20","    0","  44"
"941","marin","2020-04-14","   0","    0","   9","  5","    0","   4"
"942","modoc","2020-04-14","   0","    0","   0","  0","    0","   0"
"943","mendocino","2020-04-14","   0","    0","   6","  0","    0","   6"
"944","yolo","2020-04-14","   0","    0","  12","  2","    0","  10"
"945","tuolumne","2020-04-14","   0","    0","   1","  0","    0","   1"
"946","kern","2020-04-14","   0","    0","  45"," 20","    0","  25"
"947","solano","2020-04-14","   0","    0","  27"," 10","    0","  17"
"948","monterey","2020-04-14","   0","    0","  25","  3","    0","  22"
"949","inyo","2020-04-14","   0","    0","   5","  1","    0","   4"
"950","solano","2020-04-15","   0","    0","  30"," 10","    0","  20"
"951","san francisco","2020-04-15","   0","    0","  76"," 32","    0","  44"
"952","mariposa","2020-04-15","   0","    0","   0","  0","    0","   0"
"953","san benito","2020-04-15","   0","    0","   4","  0","    0","   4"
"954","del norte","2020-04-15","   0","    0","   4","  1","    0","   3"
"955","san mateo","2020-04-15","   0","    0","  27"," 18","    0","   9"
"956","modoc","2020-04-15","   0","    0","   0","  0","    0","   0"
"957","santa cruz","2020-04-15","   0","    0","   5","  5","    0","   0"
"958","yolo","2020-04-15","   0","    0","  14","  2","    0","  12"
"959","alameda","2020-04-15","   0","    0","  70"," 45","    0","  25"
"960","el dorado","2020-04-15","   0","    0","  12","  1","    0","  11"
"961","santa barbara","2020-04-15","   0","    0","  61"," 19","    0","  42"
"962","san diego","2020-04-15","   0","    0"," 148","121","    0","  27"
"963","los angeles","2020-04-15","   0","    0"," 566","739","    0","-173"
"964","shasta","2020-04-15","   0","    0","  13","  1","    0","  12"
"965","inyo","2020-04-15","   0","    0","   6","  0","    0","   6"
"966","sacramento","2020-04-15","   0","    0","  55"," 34","    0","  21"
"967","humboldt","2020-04-15","   0","    0","  11","  0","    0","  11"
"968","butte","2020-04-15","   0","    0","   6","  2","    0","   4"
"969","glenn","2020-04-15","   0","    0","   0","  0","    0","   0"
"970","riverside","2020-04-15","   0","    0"," 112"," 99","    0","  13"
"971","monterey","2020-04-15","   0","    0","  22","  5","    0","  17"
"972","lassen","2020-04-15","   0","    0","   0","  0","    0","   0"
"973","trinity","2020-04-15","   0","    0","   0","  0","    0","   0"
"974","mono","2020-04-15","   0","    0","   2","  0","    0","   2"
"975","ventura","2020-04-15","   0","    0","  37"," 24","    0","  13"
"976","kern","2020-04-15","   0","    0","  47"," 17","    0","  30"
"977","san luis obispo","2020-04-15","   0","    0","  28","  6","    0","  22"
"978","stanislaus","2020-04-15","   0","    0","  33"," 11","    0","  22"
"979","yuba","2020-04-15","   0","    0","   8","  2","    0","   6"
"980","siskiyou","2020-04-15","   0","    0","   3","  2","    0","   1"
"981","tuolumne","2020-04-15","   0","    0","   3","  0","    0","   3"
"982","calaveras","2020-04-15","   0","    0","  10","  0","    0","  10"
"983","madera","2020-04-15","   0","    0","   6","  1","    0","   5"
"984","imperial","2020-04-15","   0","    0","   2"," 11","    0","  -9"
"985","sutter","2020-04-15","   0","    0","   0","  0","    0","   0"
"986","tehama","2020-04-15","   0","    0","   7","  0","    0","   7"
"987","amador","2020-04-15","   0","    0","   2","  0","    0","   2"
"988","merced","2020-04-15","   0","    0","   5","  0","    0","   5"
"989","nevada","2020-04-15","   0","    0","   2","  3","    0","  -1"
"990","napa","2020-04-15","   0","    0","   8","  0","    0","   8"
"991","mendocino","2020-04-15","   0","    0","   8","  0","    0","   8"
"992","placer","2020-04-15","   0","    0","  12","  6","    0","   6"
"993","kings","2020-04-15","   0","    0","   3","  2","    0","   1"
"994","lake","2020-04-15","   0","    0","   1","  2","    0","  -1"
"995","fresno","2020-04-15","   0","    0","  44"," 14","    0","  30"
"996","colusa","2020-04-15","   0","    0","   6","  0","    0","   6"
"997","tulare","2020-04-15","   0","    0","  22","  7","    0","  15"
"998","plumas","2020-04-15","   0","    0","   0","  0","    0","   0"
"999","san bernardino","2020-04-15","   0","    0","  61","104","    0"," -43"
"1000","contra costa","2020-04-15","   0","    0","  76"," 24","    0","  52"
"1001","orange","2020-04-15","   0","    0"," 235","100","    0"," 135"
"1002","santa clara","2020-04-15","   0","    0","  92"," 71","    0","  21"
"1003","sonoma","2020-04-15","   0","    0","  25","  8","    0","  17"
"1004","marin","2020-04-15","   0","    0","  11","  6","    0","   5"
"1005","san joaquin","2020-04-15","   0","    0","  27"," 13","    0","  14"
"1006","alameda","2020-04-16","   0","    0","  66"," 40","    0","  26"
"1007","santa cruz","2020-04-16","   0","    0","   7","  4","    0","   3"
"1008","placer","2020-04-16","   0","    0","  15","  2","    0","  13"
"1009","san bernardino","2020-04-16","   0","    0","  83"," 85","    0","  -2"
"1010","del norte","2020-04-16","   0","    0","   2","  0","    0","   2"
"1011","napa","2020-04-16","   0","    0","   2","  0","    0","   2"
"1012","mendocino","2020-04-16","   0","    0","   8","  0","    0","   8"
"1013","solano","2020-04-16","   0","    0","  28"," 10","    0","  18"
"1014","ventura","2020-04-16","   0","    0","  38"," 17","    0","  21"
"1015","sacramento","2020-04-16","   0","    0","  43"," 38","    0","   5"
"1016","marin","2020-04-16","   0","    0","  15","  3","    0","  12"
"1017","el dorado","2020-04-16","   0","    0","  14","  0","    0","  14"
"1018","monterey","2020-04-16","   0","    0","  23","  4","    0","  19"
"1019","los angeles","2020-04-16","   0","    0"," 608","702","    0"," -94"
"1020","mariposa","2020-04-16","   0","    0","   0","  0","    0","   0"
"1021","imperial","2020-04-16","   0","    0","   3"," 10","    0","  -7"
"1022","humboldt","2020-04-16","   0","    0","  -1","  6","    0","  -7"
"1023","fresno","2020-04-16","   0","    0","  48"," 16","    0","  32"
"1024","stanislaus","2020-04-16","   0","    0","  25","  9","    0","  16"
"1025","contra costa","2020-04-16","   0","    0","  61"," 27","    0","  34"
"1026","amador","2020-04-16","   0","    0","   5","  0","    0","   5"
"1027","tehama","2020-04-16","   0","    0","   5","  0","    0","   5"
"1028","santa barbara","2020-04-16","   0","    0","  62"," 16","    0","  46"
"1029","sonoma","2020-04-16","   0","    0","  28","  4","    0","  24"
"1030","yolo","2020-04-16","   0","    0","  15","  1","    0","  14"
"1031","santa clara","2020-04-16","   0","    0","  89"," 77","    0","  12"
"1032","colusa","2020-04-16","   0","    0","   5","  1","    0","   4"
"1033","yuba","2020-04-16","   0","    0","   6","  2","    0","   4"
"1034","trinity","2020-04-16","   0","    0","   0","  0","    0","   0"
"1035","calaveras","2020-04-16","   0","    0","  10","  1","    0","   9"
"1036","kern","2020-04-16","   0","    0","  57"," 17","    0","  40"
"1037","orange","2020-04-16","   0","    0"," 258"," 80","    0"," 178"
"1038","modoc","2020-04-16","   0","    0","   0","  0","    0","   0"
"1039","san francisco","2020-04-16","   0","    0","  64"," 40","    0","  24"
"1040","kings","2020-04-16","   0","    0","   5","  2","    0","   3"
"1041","inyo","2020-04-16","   0","    0","   5","  1","    0","   4"
"1042","nevada","2020-04-16","   0","    0","   2","  4","    0","  -2"
"1043","san joaquin","2020-04-16","   0","    0","  28"," 13","    0","  15"
"1044","lake","2020-04-16","   0","    0","   1","  0","    0","   1"
"1045","san benito","2020-04-16","   0","    0","   2","  0","    0","   2"
"1046","riverside","2020-04-16","   0","    0"," 123","106","    0","  17"
"1047","lassen","2020-04-16","   0","    0","   0","  0","    0","   0"
"1048","glenn","2020-04-16","   0","    0","   0","  0","    0","   0"
"1049","siskiyou","2020-04-16","   0","    0","   4","  1","    0","   3"
"1050","butte","2020-04-16","   0","    0","   8","  3","    0","   5"
"1051","san diego","2020-04-16","   0","    0"," 151","113","    0","  38"
"1052","sutter","2020-04-16","   0","    0","   0","  0","    0","   0"
"1053","shasta","2020-04-16","   0","    0","  14","  1","    0","  13"
"1054","merced","2020-04-16","   0","    0","   7","  0","    0","   7"
"1055","tuolumne","2020-04-16","   0","    0","   2","  0","    0","   2"
"1056","madera","2020-04-16","   0","    0","   6","  0","    0","   6"
"1057","san mateo","2020-04-16","   0","    0","  26"," 16","    0","  10"
"1058","mono","2020-04-16","   0","    0","   2","  0","    0","   2"
"1059","plumas","2020-04-16","   0","    0","   0","  0","    0","   0"
"1060","tulare","2020-04-16","   0","    0","  17","  9","    0","   8"
"1061","san luis obispo","2020-04-16","   0","    0","  32","  3","    0","  29"
"1062","san francisco","2020-04-17","   0","    0","  66"," 36","    0","  30"
"1063","napa","2020-04-17","   0","    0","  13","  0","    0","  13"
"1064","los angeles","2020-04-17","   0","    0"," 593","699","    0","-106"
"1065","siskiyou","2020-04-17","   0","    0","   4","  0","    0","   4"
"1066","santa clara","2020-04-17","   0","    0","  86"," 82","    0","   4"
"1067","santa cruz","2020-04-17","   0","    0","   6","  3","    0","   3"
"1068","mariposa","2020-04-17","   0","    0","   0","  0","    0","   0"
"1069","alameda","2020-04-17","   0","    0","  55"," 53","    0","   2"
"1070","solano","2020-04-17","   0","    0","  36","  6","    0","  30"
"1071","yuba","2020-04-17","   0","    0","   4","  4","    0","   0"
"1072","santa barbara","2020-04-17","   0","    0","  63"," 16","    0","  47"
"1073","mono","2020-04-17","   0","    0","   2","  0","    0","   2"
"1074","orange","2020-04-17","   0","    0"," 274"," 73","    0"," 201"
"1075","lassen","2020-04-17","   0","    0","   0","  0","    0","   0"
"1076","contra costa","2020-04-17","   0","    0","  59"," 24","    0","  35"
"1077","colusa","2020-04-17","   0","    0","   5","  1","    0","   4"
"1078","placer","2020-04-17","   0","    0","  16","  3","    0","  13"
"1079","madera","2020-04-17","   0","    0","   7","  0","    0","   7"
"1080","del norte","2020-04-17","   0","    0","   3","  1","    0","   2"
"1081","amador","2020-04-17","   0","    0","   3","  0","    0","   3"
"1082","modoc","2020-04-17","   0","    0","   0","  0","    0","   0"
"1083","glenn","2020-04-17","   0","    0","   0","  0","    0","   0"
"1084","tulare","2020-04-17","   0","    0","   6","  8","    0","  -2"
"1085","kern","2020-04-17","   0","    0","  59"," 19","    0","  40"
"1086","marin","2020-04-17","   0","    0","  15","  2","    0","  13"
"1087","sonoma","2020-04-17","   0","    0","  33","  4","    0","  29"
"1088","mendocino","2020-04-17","   0","    0","   7","  0","    0","   7"
"1089","sutter","2020-04-17","   0","    0","   0","  0","    0","   0"
"1090","tuolumne","2020-04-17","   0","    0","   2","  0","    0","   2"
"1091","san diego","2020-04-17","   0","    0"," 157","113","    0","  44"
"1092","kings","2020-04-17","   0","    0","   0","  2","    0","  -2"
"1093","monterey","2020-04-17","   0","    0","  22","  4","    0","  18"
"1094","plumas","2020-04-17","   0","    0","   0","  0","    0","   0"
"1095","fresno","2020-04-17","   0","    0","  52"," 14","    0","  38"
"1096","lake","2020-04-17","   0","    0","   3","  1","    0","   2"
"1097","inyo","2020-04-17","   0","    0","   5","  1","    0","   4"
"1098","riverside","2020-04-17","   0","    0"," 119"," 92","    0","  27"
"1099","butte","2020-04-17","   0","    0","   7","  6","    0","   1"
"1100","sacramento","2020-04-17","   0","    0","  38"," 42","    0","  -4"
"1101","shasta","2020-04-17","   0","    0","  13","  1","    0","  12"
"1102","ventura","2020-04-17","   0","    0","  37"," 19","    0","  18"
"1103","tehama","2020-04-17","   0","    0","   5","  0","    0","   5"
"1104","yolo","2020-04-17","   0","    0","  14","  1","    0","  13"
"1105","san mateo","2020-04-17","   0","    0","  22"," 17","    0","   5"
"1106","el dorado","2020-04-17","   0","    0","  12","  1","    0","  11"
"1107","san bernardino","2020-04-17","   0","    0","  82"," 91","    0","  -9"
"1108","humboldt","2020-04-17","   0","    0","   1","  3","    0","  -2"
"1109","san joaquin","2020-04-17","   0","    0","  26"," 13","    0","  13"
"1110","nevada","2020-04-17","   0","    0","   0","  4","    0","  -4"
"1111","san luis obispo","2020-04-17","   0","    0","  32","  5","    0","  27"
"1112","imperial","2020-04-17","   0","    0","   3"," 12","    0","  -9"
"1113","calaveras","2020-04-17","   0","    0","   9","  2","    0","   7"
"1114","san benito","2020-04-17","   0","    0","   2","  0","    0","   2"
"1115","trinity","2020-04-17","   0","    0","   0","  0","    0","   0"
"1116","merced","2020-04-17","   0","    0","   3","  2","    0","   1"
"1117","stanislaus","2020-04-17","   0","    0","  22","  9","    0","  13"
"1118","fresno","2020-04-18","   0","    0","  51"," 15","    0","  36"
"1119","merced","2020-04-18","   0","    0","   4","  0","    0","   4"
"1120","plumas","2020-04-18","   0","    0","   0","  0","    0","   0"
"1121","placer","2020-04-18","   0","    0","   6","  3","    0","   3"
"1122","mariposa","2020-04-18","   0","    0","   0","  0","    0","   0"
"1123","san joaquin","2020-04-18","   0","    0","  38"," 15","    0","  23"
"1124","ventura","2020-04-18","   0","    0","  35"," 14","    0","  21"
"1125","los angeles","2020-04-18","   0","    0"," 579","696","    0","-117"
"1126","colusa","2020-04-18","   0","    0","   6","  0","    0","   6"
"1127","humboldt","2020-04-18","   0","    0","   5","  0","    0","   5"
"1128","madera","2020-04-18","   0","    0","   7","  0","    0","   7"
"1129","santa cruz","2020-04-18","   0","    0","  12","  2","    0","  10"
"1130","lassen","2020-04-18","   0","    0","   0","  0","    0","   0"
"1131","el dorado","2020-04-18","   0","    0","  11","  2","    0","   9"
"1132","stanislaus","2020-04-18","   0","    0","  31","  6","    0","  25"
"1133","nevada","2020-04-18","   0","    0","   4","  5","    0","  -1"
"1134","glenn","2020-04-18","   0","    0","   0","  0","    0","   0"
"1135","san francisco","2020-04-18","   0","    0","  75"," 34","    0","  41"
"1136","napa","2020-04-18","   0","    0","  13","  0","    0","  13"
"1137","mendocino","2020-04-18","   0","    0","   9","  0","    0","   9"
"1138","sonoma","2020-04-18","   0","    0","  32","  2","    0","  30"
"1139","tuolumne","2020-04-18","   0","    0","   1","  0","    0","   1"
"1140","santa clara","2020-04-18","   0","    0","  84"," 80","    0","   4"
"1141","amador","2020-04-18","   0","    0","   3","  0","    0","   3"
"1142","san diego","2020-04-18","   0","    0"," 164","108","    0","  56"
"1143","del norte","2020-04-18","   0","    0","   6","  1","    0","   5"
"1144","tulare","2020-04-18","   0","    0","  11","  9","    0","   2"
"1145","alameda","2020-04-18","   0","    0","  62"," 52","    0","  10"
"1146","contra costa","2020-04-18","   0","    0","  79"," 21","    0","  58"
"1147","san mateo","2020-04-18","   0","    0","  37"," 16","    0","  21"
"1148","shasta","2020-04-18","   0","    0","  13","  1","    0","  12"
"1149","orange","2020-04-18","   0","    0"," 263"," 87","    0"," 176"
"1150","siskiyou","2020-04-18","   0","    0","   4","  1","    0","   3"
"1151","mono","2020-04-18","   0","    0","   2","  0","    0","   2"
"1152","monterey","2020-04-18","   0","    0","  38","  2","    0","  36"
"1153","calaveras","2020-04-18","   0","    0","  11","  0","    0","  11"
"1154","yolo","2020-04-18","   0","    0","  14","  1","    0","  13"
"1155","inyo","2020-04-18","   0","    0","   4","  1","    0","   3"
"1156","sutter","2020-04-18","   0","    0","   0","  0","    0","   0"
"1157","riverside","2020-04-18","   0","    0"," 133"," 90","    0","  43"
"1158","san bernardino","2020-04-18","   0","    0"," 107"," 83","    0","  24"
"1159","trinity","2020-04-18","   0","    0","   0","  0","    0","   0"
"1160","kings","2020-04-18","   0","    0","   1","  2","    0","  -1"
"1161","butte","2020-04-18","   0","    0","  11","  2","    0","   9"
"1162","kern","2020-04-18","   0","    0","  56"," 20","    0","  36"
"1163","santa barbara","2020-04-18","   0","    0","  60"," 19","    0","  41"
"1164","sacramento","2020-04-18","   0","    0","  58"," 39","    0","  19"
"1165","san benito","2020-04-18","   0","    0","   2","  0","    0","   2"
"1166","solano","2020-04-18","   0","    0","  34","  7","    0","  27"
"1167","lake","2020-04-18","   0","    0","   6","  0","    0","   6"
"1168","marin","2020-04-18","   0","    0","  13","  1","    0","  12"
"1169","tehama","2020-04-18","   0","    0","   4","  0","    0","   4"
"1170","yuba","2020-04-18","   0","    0","   5","  2","    0","   3"
"1171","modoc","2020-04-18","   0","    0","   0","  0","    0","   0"
"1172","imperial","2020-04-18","   0","    0","   2"," 13","    0"," -11"
"1173","san luis obispo","2020-04-18","   0","    0","  23","  5","    0","  18"
"1174","riverside","2020-04-19","   0","    0"," 145"," 98","    0","  47"
"1175","contra costa","2020-04-19","   0","    0","  69"," 21","    0","  48"
"1176","madera","2020-04-19","   0","    0","   7","  0","    0","   7"
"1177","napa","2020-04-19","   0","    0","  14","  0","    0","  14"
"1178","el dorado","2020-04-19","   0","    0","  11","  3","    0","   8"
"1179","solano","2020-04-19","   0","    0","  40","  9","    0","  31"
"1180","placer","2020-04-19","   0","    0","   6","  6","    0","   0"
"1181","glenn","2020-04-19","   0","    0","   0","  0","    0","   0"
"1182","kings","2020-04-19","   0","    0","   0","  3","    0","  -3"
"1183","del norte","2020-04-19","   0","    0","   3","  0","    0","   3"
"1184","sacramento","2020-04-19","   0","    0","  59"," 33","    0","  26"
"1185","sutter","2020-04-19","   0","    0","   0","  0","    0","   0"
"1186","lassen","2020-04-19","   0","    0","   0","  0","    0","   0"
"1187","nevada","2020-04-19","   0","    0","   4","  5","    0","  -1"
"1188","plumas","2020-04-19","   0","    0","   0","  0","    0","   0"
"1189","siskiyou","2020-04-19","   0","    0","   4","  1","    0","   3"
"1190","tehama","2020-04-19","   0","    0","   5","  0","    0","   5"
"1191","calaveras","2020-04-19","   0","    0","  11","  0","    0","  11"
"1192","san joaquin","2020-04-19","   0","    0","  32"," 14","    0","  18"
"1193","tuolumne","2020-04-19","   0","    0","   2","  0","    0","   2"
"1194","santa barbara","2020-04-19","   0","    0","  60"," 17","    0","  43"
"1195","orange","2020-04-19","   0","    0"," 248"," 97","    0"," 151"
"1196","yuba","2020-04-19","   0","    0","   5","  2","    0","   3"
"1197","stanislaus","2020-04-19","   0","    0","  41","  8","    0","  33"
"1198","kern","2020-04-19","   0","    0","  49"," 20","    0","  29"
"1199","san francisco","2020-04-19","   0","    0","  76"," 37","    0","  39"
"1200","alameda","2020-04-19","   0","    0","  61"," 42","    0","  19"
"1201","marin","2020-04-19","   0","    0","  10","  4","    0","   6"
"1202","san bernardino","2020-04-19","   0","    0"," 107"," 79","    0","  28"
"1203","monterey","2020-04-19","   0","    0","  26","  2","    0","  24"
"1204","santa clara","2020-04-19","   0","    0"," 105"," 72","    0","  33"
"1205","modoc","2020-04-19","   0","    0","   0","  0","    0","   0"
"1206","inyo","2020-04-19","   0","    0","   5","  1","    0","   4"
"1207","mariposa","2020-04-19","   0","    0","   0","  0","    0","   0"
"1208","san benito","2020-04-19","   0","    0","   3","  0","    0","   3"
"1209","shasta","2020-04-19","   0","    0","  11","  1","    0","  10"
"1210","fresno","2020-04-19","   0","    0","  59"," 16","    0","  43"
"1211","santa cruz","2020-04-19","   0","    0","  13","  1","    0","  12"
"1212","sonoma","2020-04-19","   0","    0","  27","  2","    0","  25"
"1213","mendocino","2020-04-19","   0","    0","   9","  0","    0","   9"
"1214","san diego","2020-04-19","   0","    0"," 154","118","    0","  36"
"1215","merced","2020-04-19","   0","    0","   4","  1","    0","   3"
"1216","san mateo","2020-04-19","   0","    0","  22"," 18","    0","   4"
"1217","amador","2020-04-19","   0","    0","   2","  0","    0","   2"
"1218","imperial","2020-04-19","   0","    0","   1"," 13","    0"," -12"
"1219","butte","2020-04-19","   0","    0","  11","  1","    0","  10"
"1220","ventura","2020-04-19","   0","    0","  33"," 13","    0","  20"
"1221","los angeles","2020-04-19","   0","    0"," 577","710","    0","-133"
"1222","humboldt","2020-04-19","   0","    0","   7","  0","    0","   7"
"1223","lake","2020-04-19","   0","    0","   5","  0","    0","   5"
"1224","tulare","2020-04-19","   0","    0","  13","  9","    0","   4"
"1225","mono","2020-04-19","   0","    0","   2","  0","    0","   2"
"1226","colusa","2020-04-19","   0","    0","   6","  0","    0","   6"
"1227","san luis obispo","2020-04-19","   0","    0","  27","  3","    0","  24"
"1228","yolo","2020-04-19","   0","    0","  21","  0","    0","  21"
"1229","trinity","2020-04-19","   0","    0","   0","  0","    0","   0"
"1230","yuba","2020-04-20","   0","    0","   7","  1","    0","   6"
"1231","yolo","2020-04-20","   0","    0","  14","  0","    0","  14"
"1232","shasta","2020-04-20","   0","    0","  16","  1","    0","  15"
"1233","santa cruz","2020-04-20","   0","    0","  11","  1","    0","  10"
"1234","riverside","2020-04-20","   0","    0"," 133","101","    0","  32"
"1235","fresno","2020-04-20","   0","    0","  55"," 16","    0","  39"
"1236","amador","2020-04-20","   0","    0","   4","  0","    0","   4"
"1237","kings","2020-04-20","   0","    0","   3","  3","    0","   0"
"1238","madera","2020-04-20","   0","    0","   7","  0","    0","   7"
"1239","tuolumne","2020-04-20","   0","    0","   2","  0","    0","   2"
"1240","inyo","2020-04-20","   0","    0","   4","  1","    0","   3"
"1241","mono","2020-04-20","   0","    0","   2","  0","    0","   2"
"1242","colusa","2020-04-20","   0","    0","   5","  0","    0","   5"
"1243","modoc","2020-04-20","   0","    0","   0","  0","    0","   0"
"1244","glenn","2020-04-20","   0","    0","   0","  0","    0","   0"
"1245","mariposa","2020-04-20","   0","    0","   0","  0","    0","   0"
"1246","kern","2020-04-20","   0","    0","  51"," 14","    0","  37"
"1247","placer","2020-04-20","   0","    0","  15","  3","    0","  12"
"1248","sacramento","2020-04-20","   0","    0","  62"," 41","    0","  21"
"1249","trinity","2020-04-20","   0","    0","   0","  0","    0","   0"
"1250","stanislaus","2020-04-20","   0","    0","  34"," 11","    0","  23"
"1251","orange","2020-04-20","   0","    0"," 184"," 94","    0","  90"
"1252","ventura","2020-04-20","   0","    0","  27"," 10","    0","  17"
"1253","san diego","2020-04-20","   0","    0"," 149","108","    0","  41"
"1254","mendocino","2020-04-20","   0","    0","   7","  0","    0","   7"
"1255","del norte","2020-04-20","   0","    0","   1","  1","    0","   0"
"1256","tulare","2020-04-20","   0","    0","  15","  9","    0","   6"
"1257","contra costa","2020-04-20","   0","    0","  75"," 21","    0","  54"
"1258","san francisco","2020-04-20","   0","    0","  73"," 34","    0","  39"
"1259","plumas","2020-04-20","   0","    0","   0","  0","    0","   0"
"1260","siskiyou","2020-04-20","   0","    0","   5","  1","    0","   4"
"1261","san mateo","2020-04-20","   0","    0","  19"," 22","    0","  -3"
"1262","sutter","2020-04-20","   0","    0","   0","  0","    0","   0"
"1263","el dorado","2020-04-20","   0","    0","  13","  0","    0","  13"
"1264","merced","2020-04-20","   0","    0","   6","  1","    0","   5"
"1265","san luis obispo","2020-04-20","   0","    0","  28","  2","    0","  26"
"1266","marin","2020-04-20","   0","    0","  11","  3","    0","   8"
"1267","monterey","2020-04-20","   0","    0","  23","  3","    0","  20"
"1268","alameda","2020-04-20","   0","    0","  59"," 42","    0","  17"
"1269","san joaquin","2020-04-20","   0","    0","  18"," 20","    0","  -2"
"1270","calaveras","2020-04-20","   0","    0","  11","  0","    0","  11"
"1271","los angeles","2020-04-20","   0","    0"," 607","718","    0","-111"
"1272","santa clara","2020-04-20","   0","    0"," 115"," 76","    0","  39"
"1273","solano","2020-04-20","   0","    0","  36","  9","    0","  27"
"1274","imperial","2020-04-20","   0","    0","   1"," 13","    0"," -12"
"1275","lake","2020-04-20","   0","    0","   0","  1","    0","  -1"
"1276","butte","2020-04-20","   0","    0","   9","  1","    0","   8"
"1277","nevada","2020-04-20","   0","    0","   7","  3","    0","   4"
"1278","san bernardino","2020-04-20","   0","    0"," 150"," 88","    0","  62"
"1279","san benito","2020-04-20","   0","    0","   3","  0","    0","   3"
"1280","humboldt","2020-04-20","   0","    0","   4","  0","    0","   4"
"1281","santa barbara","2020-04-20","   0","    0","  61"," 22","    0","  39"
"1282","lassen","2020-04-20","   0","    0","   0","  0","    0","   0"
"1283","tehama","2020-04-20","   0","    0","   6","  0","    0","   6"
"1284","napa","2020-04-20","   0","    0","   8","  1","    0","   7"
"1285","sonoma","2020-04-20","   0","    0","  29","  6","    0","  23"
"1286","orange","2020-04-21"," 308"," 4213"," 277","104"," 3905"," 173"
"1287","el dorado","2020-04-21","   3","  155","  12","  0","  152","  12"
"1288","sonoma","2020-04-21","  19","  575","  28","  6","  556","  22"
"1289","contra costa","2020-04-21","  77"," 1037","  71"," 24","  960","  47"
"1290","san francisco","2020-04-21"," 121","  738","  79"," 34","  617","  45"
"1291","lassen","2020-04-21","   1","    0","   0","  0","   -1","   0"
"1292","tuolumne","2020-04-21","   0","   90","   3","  0","   90","   3"
"1293","inyo","2020-04-21","   1","   50","   3","  1","   49","   2"
"1294","san diego","2020-04-21"," 305"," 3776"," 161","119"," 3471","  42"
"1295","san joaquin","2020-04-21","  51","  544","  30"," 21","  493","   9"
"1296","tulare","2020-04-21","  27","  276","  15","  9","  249","   6"
"1297","amador","2020-04-21","   0","    0","   2","  0","    0","   2"
"1298","fresno","2020-04-21","  70","  764","  46"," 18","  694","  28"
"1299","yolo","2020-04-21","   7","    0","  15","  1","   -7","  14"
"1300","madera","2020-04-21","   5","    0","  15","  0","   -5","  15"
"1301","napa","2020-04-21","   2","  387","   9","  1","  385","   8"
"1302","colusa","2020-04-21","   1","   80","   4","  1","   79","   3"
"1303","humboldt","2020-04-21","   5","  308","   6","  0","  303","   6"
"1304","monterey","2020-04-21","  11","  875","  68","  3","  864","  65"
"1305","stanislaus","2020-04-21","  31"," 1400","  72"," 11"," 1369","  61"
"1306","los angeles","2020-04-21","2471","13663"," 941","724","11192"," 217"
"1307","nevada","2020-04-21","   5","   58","   7","  3","   53","   4"
"1308","lake","2020-04-21","   2","   58","   6","  0","   56","   6"
"1309","mono","2020-04-21","   0","   17","   2","  0","   17","   2"
"1310","del norte","2020-04-21","   1","    0","   3","  0","   -1","   3"
"1311","sutter","2020-04-21","   0","    0","   0","  0","    0","   0"
"1312","calaveras","2020-04-21","   0","   50","  12","  0","   50","  12"
"1313","placer","2020-04-21","  22","    0","  11","  4","  -22","   7"
"1314","alameda","2020-04-21"," 144","  591","  66"," 50","  447","  16"
"1315","san bernardino","2020-04-21"," 357"," 2714"," 142"," 87"," 2357","  55"
"1316","yuba","2020-04-21","   0","  445","  16","  0","  445","  16"
"1317","tehama","2020-04-21","   0","    0","   3","  0","    0","   3"
"1318","riverside","2020-04-21"," 370"," 2726"," 112","113"," 2356","  -1"
"1319","butte","2020-04-21","   1","  424","  19","  1","  423","  18"
"1320","san mateo","2020-04-21","  67","  395","  33"," 21","  328","  12"
"1321","santa barbara","2020-04-21","  34","  415","  82"," 18","  381","  64"
"1322","merced","2020-04-21","   3","    0","   4","  2","   -3","   2"
"1323","shasta","2020-04-21","   1","  279","  16","  1","  278","  15"
"1324","mariposa","2020-04-21","   1","    0","   0","  0","   -1","   0"
"1325","glenn","2020-04-21","   0","    0","   0","  0","    0","   0"
"1326","siskiyou","2020-04-21","   1","   36","   5","  1","   35","   4"
"1327","imperial","2020-04-21","  35","  161","   1"," 12","  126"," -11"
"1328","santa cruz","2020-04-21","   5","  351","  16","  1","  346","  15"
"1329","santa clara","2020-04-21"," 178"," 2582"," 120"," 86"," 2404","  34"
"1330","ventura","2020-04-21","  56","  976","  25"," 19","  920","   6"
"1331","mendocino","2020-04-21","   1","  151","   9","  0","  150","   9"
"1332","modoc","2020-04-21","   1","   20","   0","  0","   19","   0"
"1333","san luis obispo","2020-04-21","   6","  303","  25","  4","  297","  21"
"1334","plumas","2020-04-21","   0","    9","   0","  0","    9","   0"
"1335","trinity","2020-04-21","   0","   54","   0","  0","   54","   0"
"1336","marin","2020-04-21","   9","  242","  11","  3","  233","   8"
"1337","san benito","2020-04-21","   1","   25","   2","  0","   24","   2"
"1338","kern","2020-04-21","  43"," 1171","  57"," 14"," 1128","  43"
"1339","sacramento","2020-04-21","  93","   50","  72"," 29","  -43","  43"
"1340","solano","2020-04-21","  23","  204","  38","  2","  181","  36"
"1341","kings","2020-04-21","   8","  223","   6","  3","  215","   3"
"1342","san francisco","2020-04-22","  92","  738","  74"," 31","  646","  43"
"1343","tuolumne","2020-04-22","   1","  151","   2","  0","  150","   2"
"1344","santa barbara","2020-04-22","  34","  427","  88"," 16","  393","  72"
"1345","inyo","2020-04-22","   1","   50","   4","  1","   49","   3"
"1346","lake","2020-04-22","   3","   58","   4","  1","   55","   3"
"1347","madera","2020-04-22","   3","  568","  22","  0","  565","  22"
"1348","monterey","2020-04-22","   9","  875","  95","  3","  866","  92"
"1349","san mateo","2020-04-22","  67","  395","  32"," 17","  328","  15"
"1350","san joaquin","2020-04-22","  57","  632","  25"," 18","  575","   7"
"1351","nevada","2020-04-22","   1","   57","   8","  1","   56","   7"
"1352","yuba","2020-04-22","   0","  445","  13","  0","  445","  13"
"1353","merced","2020-04-22","   6","    0","   4","  0","   -6","   4"
"1354","plumas","2020-04-22","   0","    9","   0","  0","    9","   0"
"1355","san bernardino","2020-04-22"," 345"," 3830"," 167"," 86"," 3485","  81"
"1356","sacramento","2020-04-22","  70","   50","  79"," 23","  -20","  56"
"1357","stanislaus","2020-04-22","  33"," 1421","  58"," 11"," 1388","  47"
"1358","kings","2020-04-22","   9","  192","   3","  3","  183","   0"
"1359","imperial","2020-04-22","  34","  161","   1"," 12","  127"," -11"
"1360","shasta","2020-04-22","   1","  279","  14","  1","  278","  13"
"1361","siskiyou","2020-04-22","   1","   65","   4","  1","   64","   3"
"1362","sutter","2020-04-22","   0","    0","   0","  0","    0","   0"
"1363","mariposa","2020-04-22","   0","   30","   0","  0","   30","   0"
"1364","mono","2020-04-22","   0","   17","   2","  0","   17","   2"
"1365","lassen","2020-04-22","   1","   25","   0","  0","   24","   0"
"1366","los angeles","2020-04-22","2448","17405","1215","727","14957"," 488"
"1367","sonoma","2020-04-22","  19","  596","  27","  7","  577","  20"
"1368","yolo","2020-04-22","   4","    0","  14","  1","   -4","  13"
"1369","riverside","2020-04-22"," 333"," 3668"," 176","109"," 3335","  67"
"1370","santa cruz","2020-04-22","   7","  351","  10","  2","  344","   8"
"1371","butte","2020-04-22","   0","  424","  17","  1","  424","  16"
"1372","kern","2020-04-22","  57"," 1167","  58"," 15"," 1110","  43"
"1373","del norte","2020-04-22","   2","    0","   3","  1","   -2","   2"
"1374","san diego","2020-04-22"," 318"," 5467"," 365","125"," 5149"," 240"
"1375","alameda","2020-04-22"," 145"," 1141","  46"," 55","  996","  -9"
"1376","san luis obispo","2020-04-22","   8","  303","  25","  4","  295","  21"
"1377","placer","2020-04-22","  25","    0","  10","  2","  -25","   8"
"1378","marin","2020-04-22","  15","  242","  12","  7","  227","   5"
"1379","el dorado","2020-04-22","   5","  165","  13","  1","  160","  12"
"1380","mendocino","2020-04-22","   0","  151","   7","  0","  151","   7"
"1381","solano","2020-04-22","  28","  204","  32","  4","  176","  28"
"1382","santa clara","2020-04-22"," 176"," 2741"," 157"," 77"," 2565","  80"
"1383","modoc","2020-04-22","   0","   12","   0","  0","   12","   0"
"1384","san benito","2020-04-22","   0","   25","   1","  0","   25","   1"
"1385","tulare","2020-04-22","  27","  226","  25","  9","  199","  16"
"1386","fresno","2020-04-22","  79","  748","  52"," 18","  669","  34"
"1387","trinity","2020-04-22","   0","   54","   0","  0","   54","   0"
"1388","colusa","2020-04-22","   1","   80","   4","  1","   79","   3"
"1389","humboldt","2020-04-22","   8","  310","   8","  1","  302","   7"
"1390","glenn","2020-04-22","   0","    0","   0","  0","    0","   0"
"1391","orange","2020-04-22"," 283"," 4786"," 293"," 94"," 4503"," 199"
"1392","contra costa","2020-04-22","  84"," 1031","  75"," 27","  947","  48"
"1393","tehama","2020-04-22","   0","    0","   4","  0","    0","   4"
"1394","calaveras","2020-04-22","   0","   50","  12","  0","   50","  12"
"1395","ventura","2020-04-22","  57"," 1049","  33"," 17","  992","  16"
"1396","amador","2020-04-22","   1","    0","   3","  0","   -1","   3"
"1397","napa","2020-04-22","   3","  387","  11","  1","  384","  10"
"1398","marin","2020-04-23","  17","  242","  12","  6","  225","   6"
"1399","butte","2020-04-23","   0","  424","  14","  1","  424","  13"
"1400","calaveras","2020-04-23","   1","   50","  11","  1","   49","  10"
"1401","san diego","2020-04-23"," 318"," 5501"," 389","117"," 5183"," 272"
"1402","santa barbara","2020-04-23","  40","  717","  90"," 17","  677","  73"
"1403","plumas","2020-04-23","   0","    9","   0","  0","    9","   0"
"1404","tulare","2020-04-23","  31","  882","  16"," 11","  851","   5"
"1405","amador","2020-04-23","   1","    0","   2","  0","   -1","   2"
"1406","yolo","2020-04-23","   4","  130","  14","  1","  126","  13"
"1407","santa cruz","2020-04-23","   6","  351","   9","  1","  345","   8"
"1408","sacramento","2020-04-23","  88","  737","  80"," 24","  649","  56"
"1409","sutter","2020-04-23","   0","    0","   0","  0","    0","   0"
"1410","san benito","2020-04-23","   0","   25","   1","  0","   25","   1"
"1411","riverside","2020-04-23"," 340"," 3526"," 232","107"," 3186"," 125"
"1412","santa clara","2020-04-23"," 165"," 2741"," 137"," 72"," 2576","  65"
"1413","siskiyou","2020-04-23","   1","   65","   4","  1","   64","   3"
"1414","kern","2020-04-23","  41"," 1429","  63"," 17"," 1388","  46"
"1415","mono","2020-04-23","   0","   17","   2","  0","   17","   2"
"1416","modoc","2020-04-23","   0","   12","   0","  0","   12","   0"
"1417","solano","2020-04-23","  26","  204","  31","  9","  178","  22"
"1418","sonoma","2020-04-23","  20","  615","  48","  5","  595","  43"
"1419","san mateo","2020-04-23","  72","  517","  35"," 17","  445","  18"
"1420","humboldt","2020-04-23","   7","  310","   4","  1","  303","   3"
"1421","colusa","2020-04-23","   1","   80","   4","  1","   79","   3"
"1422","glenn","2020-04-23","   0","    0","   0","  0","    0","   0"
"1423","ventura","2020-04-23","  49"," 1305","  47"," 15"," 1256","  32"
"1424","san francisco","2020-04-23"," 104"," 1173","  70"," 37"," 1069","  33"
"1425","san bernardino","2020-04-23"," 240"," 4516"," 175"," 73"," 4276"," 102"
"1426","nevada","2020-04-23","   4","  116","   6","  1","  112","   5"
"1427","lassen","2020-04-23","   0","   25","   0","  0","   25","   0"
"1428","tehama","2020-04-23","   0","  106","   4","  0","  106","   4"
"1429","alameda","2020-04-23"," 171"," 1129","  95"," 61","  958","  34"
"1430","fresno","2020-04-23","  78","  748","  52"," 20","  670","  32"
"1431","san joaquin","2020-04-23","  65"," 1047","  25"," 21","  982","   4"
"1432","el dorado","2020-04-23","   8","  173","  15","  1","  165","  14"
"1433","mariposa","2020-04-23","   1","   30","   0","  0","   29","   0"
"1434","imperial","2020-04-23","  27","  240","   1","  9","  213","  -8"
"1435","los angeles","2020-04-23","2458","21107","1263","718","18649"," 545"
"1436","monterey","2020-04-23","  12","  875"," 122","  5","  863"," 117"
"1437","lake","2020-04-23","   1","   58","   4","  0","   57","   4"
"1438","del norte","2020-04-23","   6","    0","   3","  3","   -6","   0"
"1439","inyo","2020-04-23","   1","   50","   5","  1","   49","   4"
"1440","mendocino","2020-04-23","   1","  151","   7","  1","  150","   6"
"1441","merced","2020-04-23","   2","  206","   7","  0","  204","   7"
"1442","shasta","2020-04-23","   1","  645","  16","  1","  644","  15"
"1443","placer","2020-04-23","  25","    0","  11","  2","  -25","   9"
"1444","stanislaus","2020-04-23","  31"," 1421","  62","  8"," 1390","  54"
"1445","contra costa","2020-04-23","  82"," 1031","  81"," 26","  949","  55"
"1446","napa","2020-04-23","   2","  387","   2","  1","  385","   1"
"1447","yuba","2020-04-23","   2","  445","   9","  2","  443","   7"
"1448","kings","2020-04-23","   9","  192","   4","  3","  183","   1"
"1449","tuolumne","2020-04-23","   0","  151","   2","  0","  151","   2"
"1450","san luis obispo","2020-04-23","   5","  526","  30","  2","  521","  28"
"1451","madera","2020-04-23","   3","  568","  16","  1","  565","  15"
"1452","orange","2020-04-23"," 313"," 5251"," 293","100"," 4938"," 193"
"1453","trinity","2020-04-23","   0","   54","   0","  0","   54","   0"
"1454","del norte","2020-04-24","   4","    0","   6","  0","   -4","   6"
"1455","shasta","2020-04-24","   1","  645","  16","  1","  644","  15"
"1456","el dorado","2020-04-24","   7","  173","  12","  3","  166","   9"
"1457","napa","2020-04-24","   1","  387","   7","  1","  386","   6"
"1458","siskiyou","2020-04-24","   0","   65","   5","  0","   65","   5"
"1459","modoc","2020-04-24","   0","   12","   0","  0","   12","   0"
"1460","kern","2020-04-24","  47"," 1715","  59"," 17"," 1668","  42"
"1461","marin","2020-04-24","  13","  242","  12","  4","  229","   8"
"1462","butte","2020-04-24","   4","  424","  18","  3","  420","  15"
"1463","san joaquin","2020-04-24","  49"," 1047","  26"," 16","  998","  10"
"1464","ventura","2020-04-24","  87"," 1283","  40","  9"," 1196","  31"
"1465","tuolumne","2020-04-24","   0","  151","   4","  0","  151","   4"
"1466","lassen","2020-04-24","   0","   25","   0","  0","   25","   0"
"1467","nevada","2020-04-24","   5","  116","   6","  2","  111","   4"
"1468","kings","2020-04-24","   9","  192","   4","  2","  183","   2"
"1469","contra costa","2020-04-24","  83"," 1031","  87"," 23","  948","  64"
"1470","san benito","2020-04-24","   0","   25","   2","  0","   25","   2"
"1471","san luis obispo","2020-04-24","   9","  526","  24","  6","  517","  18"
"1472","tehama","2020-04-24","   1","  106","   4","  1","  105","   3"
"1473","yolo","2020-04-24","   4","  130","  17","  1","  126","  16"
"1474","alameda","2020-04-24"," 142"," 1127"," 110"," 49","  985","  61"
"1475","sacramento","2020-04-24","  90","  737"," 121"," 28","  647","  93"
"1476","amador","2020-04-24","   1","    0","   6","  0","   -1","   6"
"1477","calaveras","2020-04-24","   2","   50","  11","  1","   48","  10"
"1478","glenn","2020-04-24","   0","    0","   0","  0","    0","   0"
"1479","tulare","2020-04-24","  33","  882","  19"," 11","  849","   8"
"1480","san francisco","2020-04-24","  94"," 1173"," 108"," 35"," 1079","  73"
"1481","los angeles","2020-04-24","2406","20782","1378","687","18376"," 691"
"1482","fresno","2020-04-24","  78","  748","  47"," 20","  670","  27"
"1483","colusa","2020-04-24","   1","   80","   5","  1","   79","   4"
"1484","mariposa","2020-04-24","   0","   30","   0","  0","   30","   0"
"1485","plumas","2020-04-24","   0","    9","   0","  0","    9","   0"
"1486","mendocino","2020-04-24","   1","  151","   9","  0","  150","   9"
"1487","santa cruz","2020-04-24","   5","  351","  12","  2","  346","  10"
"1488","lake","2020-04-24","   1","   58","   4","  1","   57","   3"
"1489","san bernardino","2020-04-24"," 253"," 4516"," 250"," 73"," 4263"," 177"
"1490","sonoma","2020-04-24","  23","  616","  45","  3","  593","  42"
"1491","riverside","2020-04-24"," 343"," 3524"," 222","108"," 3181"," 114"
"1492","orange","2020-04-24"," 313"," 5374"," 391"," 92"," 5061"," 299"
"1493","placer","2020-04-24","  22","    0","  43","  2","  -22","  41"
"1494","inyo","2020-04-24","   4","   89","   5","  1","   85","   4"
"1495","monterey","2020-04-24","  13","  875"," 112","  5","  862"," 107"
"1496","trinity","2020-04-24","   0","   54","   0","  0","   54","   0"
"1497","madera","2020-04-24","   4","  568","  11","  0","  564","  11"
"1498","yuba","2020-04-24","   2","  445","  10","  2","  443","   8"
"1499","imperial","2020-04-24","  34","  248","   6","  9","  214","  -3"
"1500","santa barbara","2020-04-24","  32","  717","  80"," 17","  685","  63"
"1501","san mateo","2020-04-24","  65","  517","  40"," 20","  452","  20"
"1502","santa clara","2020-04-24"," 163"," 2741"," 134"," 65"," 2578","  69"
"1503","san diego","2020-04-24"," 335"," 5606"," 408","120"," 5271"," 288"
"1504","merced","2020-04-24","   5","  206","   6","  1","  201","   5"
"1505","sutter","2020-04-24","   0","    0","   0","  0","    0","   0"
"1506","humboldt","2020-04-24","   5","  307","   8","  1","  302","   7"
"1507","stanislaus","2020-04-24","  27"," 1421","  58","  8"," 1394","  50"
"1508","mono","2020-04-24","   0","   17","   2","  0","   17","   2"
"1509","solano","2020-04-24","  26","  204","  32","  7","  178","  25"
"1510","yolo","2020-04-25","   5","  130","  18","  1","  125","  17"
"1511","lake","2020-04-25","   2","   58","   3","  0","   56","   3"
"1512","santa cruz","2020-04-25","   8","  354","   4","  5","  346","  -1"
"1513","san mateo","2020-04-25","  74","  790","  43"," 26","  716","  17"
"1514","modoc","2020-04-25","   0","   12","   0","  0","   12","   0"
"1515","plumas","2020-04-25","   0","    9","   0","  0","    9","   0"
"1516","stanislaus","2020-04-25","  44"," 1573","  90","  6"," 1529","  84"
"1517","sacramento","2020-04-25","  99"," 1261"," 184"," 34"," 1162"," 150"
"1518","inyo","2020-04-25","   3","   89","   6","  0","   86","   6"
"1519","marin","2020-04-25","  15","  358","  16","  5","  343","  11"
"1520","amador","2020-04-25","   1","    0","   5","  1","   -1","   4"
"1521","shasta","2020-04-25","   1","  645","  11","  1","  644","  10"
"1522","contra costa","2020-04-25","  78"," 1464"," 154"," 16"," 1386"," 138"
"1523","butte","2020-04-25","   3","  424","  14","  0","  421","  14"
"1524","madera","2020-04-25","   2","  568","  20","  1","  566","  19"
"1525","solano","2020-04-25","  26","  592","  61","  7","  566","  54"
"1526","kern","2020-04-25","  47"," 1715","  56"," 25"," 1668","  31"
"1527","fresno","2020-04-25","  86"," 2014","  86"," 21"," 1928","  65"
"1528","mariposa","2020-04-25","   0","   30","   0","  0","   30","   0"
"1529","monterey","2020-04-25","  14","  875"," 111","  3","  861"," 108"
"1530","tulare","2020-04-25","  26","  882","  22","  7","  856","  15"
"1531","calaveras","2020-04-25","   1","   50","  11","  0","   49","  11"
"1532","san benito","2020-04-25","   0","   25","   0","  0","   25","   0"
"1533","yuba","2020-04-25","   2","  445","   6","  2","  443","   4"
"1534","kings","2020-04-25","   6","  199","   5","  2","  193","   3"
"1535","tehama","2020-04-25","   1","  106","   4","  1","  105","   3"
"1536","orange","2020-04-25"," 310"," 5370"," 394"," 95"," 5060"," 299"
"1537","santa clara","2020-04-25"," 172"," 3331"," 203"," 77"," 3159"," 126"
"1538","napa","2020-04-25","   2","  387","   1","  2","  385","  -1"
"1539","glenn","2020-04-25","   0","    0","   0","  0","    0","   0"
"1540","san francisco","2020-04-25","  91"," 1412"," 132"," 32"," 1321"," 100"
"1541","sutter","2020-04-25","   0","    0","   0","  0","    0","   0"
"1542","imperial","2020-04-25","  32","  249","   5","  9","  217","  -4"
"1543","colusa","2020-04-25","   2","   80","   4","  2","   78","   2"
"1544","tuolumne","2020-04-25","   0","  151","   4","  0","  151","   4"
"1545","nevada","2020-04-25","   4","  110","   2","  2","  106","   0"
"1546","mono","2020-04-25","   0","   17","   2","  0","   17","   2"
"1547","placer","2020-04-25","  34","  340"," 106","  3","  306"," 103"
"1548","humboldt","2020-04-25","   3","  308","   4","  0","  305","   4"
"1549","san joaquin","2020-04-25","  47"," 1146","  20"," 17"," 1099","   3"
"1550","lassen","2020-04-25","   0","   25","   0","  0","   25","   0"
"1551","del norte","2020-04-25","   4","    0","   0","  0","   -4","   0"
"1552","san bernardino","2020-04-25"," 248"," 4496"," 277"," 67"," 4248"," 210"
"1553","mendocino","2020-04-25","   0","  151","  10","  0","  151","  10"
"1554","santa barbara","2020-04-25","  35","  717","  79"," 20","  682","  59"
"1555","san diego","2020-04-25"," 364"," 5561"," 395","129"," 5197"," 266"
"1556","merced","2020-04-25","   3","  206","   9","  1","  203","   8"
"1557","ventura","2020-04-25","  98"," 1286","  51"," 15"," 1188","  36"
"1558","el dorado","2020-04-25","   8","  155","  11","  2","  147","   9"
"1559","alameda","2020-04-25"," 136"," 1748"," 197"," 45"," 1612"," 152"
"1560","siskiyou","2020-04-25","   1","   65","   5","  0","   64","   5"
"1561","sonoma","2020-04-25","  12","  789","  64","  0","  777","  64"
"1562","los angeles","2020-04-25","2417","20233","1359","678","17816"," 681"
"1563","trinity","2020-04-25","   0","   54","   0","  0","   54","   0"
"1564","riverside","2020-04-25"," 356"," 3550"," 235","111"," 3194"," 124"
"1565","san luis obispo","2020-04-25","   5","  526","  28","  2","  521","  26"
"1566","san diego","2020-04-26"," 363"," 5552"," 427","135"," 5189"," 292"
"1567","mendocino","2020-04-26","   0","  151","  12","  0","  151","  12"
"1568","ventura","2020-04-26"," 100"," 1282","  55","  9"," 1182","  46"
"1569","san benito","2020-04-26","   0","   25","   0","  0","   25","   0"
"1570","riverside","2020-04-26"," 367"," 3625"," 230","110"," 3258"," 120"
"1571","los angeles","2020-04-26","2462","20162","1262","710","17700"," 552"
"1572","humboldt","2020-04-26","   0","  305","   4","  0","  305","   4"
"1573","el dorado","2020-04-26","   9","  155","   7","  3","  146","   4"
"1574","siskiyou","2020-04-26","   0","   65","   5","  0","   65","   5"
"1575","colusa","2020-04-26","   2","   80","   4","  2","   78","   2"
"1576","fresno","2020-04-26","  81"," 2014","  79"," 27"," 1933","  52"
"1577","san francisco","2020-04-26"," 100"," 1412"," 126"," 34"," 1312","  92"
"1578","tuolumne","2020-04-26","   0","  151","   4","  0","  151","   4"
"1579","imperial","2020-04-26","  38","  252","   5"," 10","  214","  -5"
"1580","trinity","2020-04-26","   0","   54","   0","  0","   54","   0"
"1581","mariposa","2020-04-26","   0","   30","   0","  0","   30","   0"
"1582","inyo","2020-04-26","   0","   89","   6","  0","   89","   6"
"1583","calaveras","2020-04-26","   0","   50","  11","  0","   50","  11"
"1584","nevada","2020-04-26","   3","  110","   5","  2","  107","   3"
"1585","contra costa","2020-04-26","  69"," 1464"," 150"," 18"," 1395"," 132"
"1586","solano","2020-04-26","  22","  592","  62","  4","  570","  58"
"1587","sacramento","2020-04-26","  88"," 1255"," 171"," 22"," 1167"," 149"
"1588","tulare","2020-04-26","  26","  882","  21","  8","  856","  13"
"1589","stanislaus","2020-04-26","  47"," 1571","  97"," 11"," 1524","  86"
"1590","napa","2020-04-26","   1","  387","   8","  1","  386","   7"
"1591","santa cruz","2020-04-26","   5","  354","   5","  2","  349","   3"
"1592","butte","2020-04-26","   0","  424","  18","  0","  424","  18"
"1593","modoc","2020-04-26","   0","   12","   0","  0","   12","   0"
"1594","san joaquin","2020-04-26","  43"," 1146","  23"," 13"," 1103","  10"
"1595","placer","2020-04-26","  25","  340"," 101","  6","  315","  95"
"1596","glenn","2020-04-26","   0","    0","   0","  0","    0","   0"
"1597","sutter","2020-04-26","   0","    0","   0","  0","    0","   0"
"1598","lake","2020-04-26","   1","   58","   5","  0","   57","   5"
"1599","yuba","2020-04-26","   2","  445","  10","  1","  443","   9"
"1600","amador","2020-04-26","   0","    0","   6","  0","    0","   6"
"1601","lassen","2020-04-26","   0","   25","   0","  0","   25","   0"
"1602","santa barbara","2020-04-26","  37","  717","  85"," 16","  680","  69"
"1603","kern","2020-04-26","  44"," 1706","  50"," 23"," 1662","  27"
"1604","kings","2020-04-26","   9","  199","   6","  2","  190","   4"
"1605","tehama","2020-04-26","   0","  106","   3","  0","  106","   3"
"1606","san luis obispo","2020-04-26","   4","  526","  21","  3","  522","  18"
"1607","madera","2020-04-26","   1","  568","  20","  0","  567","  20"
"1608","san mateo","2020-04-26","  63","  790","  43"," 20","  727","  23"
"1609","yolo","2020-04-26","   2","  130","  23","  2","  128","  21"
"1610","monterey","2020-04-26","  10","  875"," 113","  5","  865"," 108"
"1611","marin","2020-04-26","  10","  358","  19","  5","  348","  14"
"1612","santa clara","2020-04-26"," 182"," 3331"," 194"," 77"," 3149"," 117"
"1613","san bernardino","2020-04-26"," 229"," 4496"," 201"," 70"," 4267"," 131"
"1614","shasta","2020-04-26","   1","  645","  10","  1","  644","   9"
"1615","mono","2020-04-26","   0","   17","   2","  0","   17","   2"
"1616","orange","2020-04-26"," 289"," 5370"," 378"," 96"," 5081"," 282"
"1617","alameda","2020-04-26"," 127"," 1748"," 191"," 47"," 1621"," 144"
"1618","plumas","2020-04-26","   0","    9","   0","  0","    9","   0"
"1619","merced","2020-04-26","   4","  206","   6","  2","  202","   4"
"1620","del norte","2020-04-26","   2","    0","   5","  1","   -2","   4"
"1621","sonoma","2020-04-26","  10","  789","  63","  1","  779","  62"
"1622","kings","2020-04-27","  11","  199","   5","  2","  188","   3"
"1623","ventura","2020-04-27"," 103"," 1282","  36"," 16"," 1179","  20"
"1624","tulare","2020-04-27"," 329","  898","  27","  7","  569","  20"
"1625","mendocino","2020-04-27","   1","  151","   7","  1","  150","   6"
"1626","butte","2020-04-27","   0","  424","  22","  0","  424","  22"
"1627","glenn","2020-04-27","   0","    0","   0","  0","    0","   0"
"1628","humboldt","2020-04-27","   3","  305","   4","  0","  302","   4"
"1629","del norte","2020-04-27","   5","    0","   5","  2","   -5","   3"
"1630","colusa","2020-04-27","   2","   80","   4","  2","   78","   2"
"1631","santa clara","2020-04-27"," 164"," 3331"," 206"," 66"," 3167"," 140"
"1632","siskiyou","2020-04-27","   1","   65","   3","  1","   64","   2"
"1633","shasta","2020-04-27","   2","  645","  12","  1","  643","  11"
"1634","sutter","2020-04-27","   0","    0","   0","  0","    0","   0"
"1635","yolo","2020-04-27","   1","  130","  15","  0","  129","  15"
"1636","solano","2020-04-27","  24","  592","  60","  7","  568","  53"
"1637","amador","2020-04-27","   0","    0","   5","  0","    0","   5"
"1638","riverside","2020-04-27"," 338"," 3649"," 208"," 98"," 3311"," 110"
"1639","trinity","2020-04-27","   0","   54","   0","  0","   54","   0"
"1640","contra costa","2020-04-27","  68"," 1485"," 158"," 21"," 1417"," 137"
"1641","san benito","2020-04-27","   0","   25","   0","  0","   25","   0"
"1642","plumas","2020-04-27","   0","    9","   0","  0","    9","   0"
"1643","placer","2020-04-27","  22","  340"," 111","  4","  318"," 107"
"1644","sacramento","2020-04-27","  88"," 1238"," 164"," 29"," 1150"," 135"
"1645","santa barbara","2020-04-27","  39","  717","  82"," 15","  678","  67"
"1646","mariposa","2020-04-27","   1","   30","   0","  0","   29","   0"
"1647","los angeles","2020-04-27","2549","20205","1226","709","17656"," 517"
"1648","sonoma","2020-04-27","  13","  789","  63","  2","  776","  61"
"1649","fresno","2020-04-27","  91"," 2013","  89"," 20"," 1922","  69"
"1650","san francisco","2020-04-27"," 101"," 1412"," 149"," 32"," 1311"," 117"
"1651","tuolumne","2020-04-27","   1","  151","   2","  1","  150","   1"
"1652","stanislaus","2020-04-27","  66"," 1573","  90"," 16"," 1507","  74"
"1653","san mateo","2020-04-27","  80","  790","  62"," 20","  710","  42"
"1654","modoc","2020-04-27","   0","   12","   0","  0","   12","   0"
"1655","mono","2020-04-27","   0","   17","   2","  0","   17","   2"
"1656","kern","2020-04-27","  50"," 1702","  53"," 25"," 1652","  28"
"1657","madera","2020-04-27","   0","  568","  10","  0","  568","  10"
"1658","lassen","2020-04-27","   0","   25","   0","  0","   25","   0"
"1659","nevada","2020-04-27","   2","  103","   2","  1","  101","   1"
"1660","san bernardino","2020-04-27"," 237"," 4556"," 183"," 67"," 4319"," 116"
"1661","tehama","2020-04-27","   0","  106","   3","  0","  106","   3"
"1662","lake","2020-04-27","   1","   58","   5","  1","   57","   4"
"1663","yuba","2020-04-27","   3","  445","  13","  3","  442","  10"
"1664","san diego","2020-04-27"," 336"," 5544"," 377","130"," 5208"," 247"
"1665","alameda","2020-04-27"," 128"," 1748"," 183"," 47"," 1620"," 136"
"1666","merced","2020-04-27","   4","  206","   7","  0","  202","   7"
"1667","san joaquin","2020-04-27","  47"," 1146","  25"," 16"," 1099","   9"
"1668","san luis obispo","2020-04-27","   9","  526","  37","  4","  517","  33"
"1669","monterey","2020-04-27","   6","  875"," 120","  3","  869"," 117"
"1670","napa","2020-04-27","   1","  387","   8","  1","  386","   7"
"1671","calaveras","2020-04-27","   1","   50","  12","  0","   49","  12"
"1672","orange","2020-04-27"," 302"," 5370"," 370"," 99"," 5068"," 271"
"1673","el dorado","2020-04-27","   8","  155","   7","  2","  147","   5"
"1674","imperial","2020-04-27","  34","  247","   4"," 12","  213","  -8"
"1675","inyo","2020-04-27","   0","   50","   6","  0","   50","   6"
"1676","marin","2020-04-27","   8","  358","  26","  1","  350","  25"
"1677","santa cruz","2020-04-27","   3","  354","   3","  1","  351","   2"
"1678","mariposa","2020-04-28","   1","   30","   0","  0","   29","   0"
"1679","ventura","2020-04-28"," 102"," 1295","  26"," 22"," 1193","   4"
"1680","los angeles","2020-04-28","2543","20337","1209","727","17794"," 482"
"1681","san mateo","2020-04-28","  63","  790","  49"," 17","  727","  32"
"1682","nevada","2020-04-28","   3","  102","   4","  2","   99","   2"
"1683","yuba","2020-04-28","   2","  445","   8","  1","  443","   7"
"1684","tuolumne","2020-04-28","   0","  151","   1","  0","  151","   1"
"1685","orange","2020-04-28"," 287"," 5370"," 369","100"," 5083"," 269"
"1686","kings","2020-04-28","  11","  199","   8","  2","  188","   6"
"1687","calaveras","2020-04-28","   1","   50","  12","  0","   49","  12"
"1688","lassen","2020-04-28","   0","   25","   0","  0","   25","   0"
"1689","sonoma","2020-04-28","  14","  789","  52","  4","  775","  48"
"1690","madera","2020-04-28","   1","  568","  19","  0","  567","  19"
"1691","santa barbara","2020-04-28","  43","  717","  81"," 16","  674","  65"
"1692","monterey","2020-04-28","   9","  875"," 116","  4","  866"," 112"
"1693","san benito","2020-04-28","   0","   25","   2","  0","   25","   2"
"1694","santa clara","2020-04-28"," 150"," 3331"," 197"," 56"," 3181"," 141"
"1695","san francisco","2020-04-28"," 104"," 1412"," 132"," 36"," 1308","  96"
"1696","el dorado","2020-04-28","   8","  159","   8","  2","  151","   6"
"1697","trinity","2020-04-28","   0","   54","   0","  0","   54","   0"
"1698","alameda","2020-04-28"," 140"," 1748"," 148"," 50"," 1608","  98"
"1699","imperial","2020-04-28","  33","  260","   4"," 13","  227","  -9"
"1700","inyo","2020-04-28","   0","   56","   6","  0","   56","   6"
"1701","placer","2020-04-28","  26","  340"," 103","  3","  314"," 100"
"1702","butte","2020-04-28","   1","  424","  19","  0","  423","  19"
"1703","stanislaus","2020-04-28","  61"," 1573","  92","  9"," 1512","  83"
"1704","fresno","2020-04-28","  83"," 2007","  87"," 21"," 1924","  66"
"1705","merced","2020-04-28","   8","  206","   4","  2","  198","   2"
"1706","santa cruz","2020-04-28","   2","  354","  15","  1","  352","  14"
"1707","san diego","2020-04-28"," 381"," 5605"," 361","130"," 5224"," 231"
"1708","napa","2020-04-28","   1","  387","   5","  0","  386","   5"
"1709","sacramento","2020-04-28","  76"," 1256"," 129"," 25"," 1180"," 104"
"1710","modoc","2020-04-28","   1","   12","   0","  0","   11","   0"
"1711","shasta","2020-04-28","   3","  645","   6","  2","  642","   4"
"1712","tulare","2020-04-28","  34","  898","  26","  6","  864","  20"
"1713","marin","2020-04-28","   8","  358","  19","  2","  350","  17"
"1714","sutter","2020-04-28","   0","    0","   0","  0","    0","   0"
"1715","riverside","2020-04-28"," 327"," 3716"," 170"," 98"," 3389","  72"
"1716","san bernardino","2020-04-28"," 279"," 4556"," 179"," 82"," 4277","  97"
"1717","amador","2020-04-28","   0","    0","   4","  0","    0","   4"
"1718","san joaquin","2020-04-28","  40"," 1146","  25"," 16"," 1106","   9"
"1719","lake","2020-04-28","   2","   58","   3","  1","   56","   2"
"1720","mendocino","2020-04-28","   0","  151","   8","  0","  151","   8"
"1721","kern","2020-04-28","  45"," 1702","  53"," 25"," 1657","  28"
"1722","mono","2020-04-28","   0","   17","   2","  0","   17","   2"
"1723","colusa","2020-04-28","   1","   80","   5","  1","   79","   4"
"1724","yolo","2020-04-28","   0","  130","  10","  1","  130","   9"
"1725","solano","2020-04-28","  28","  592","  61","  5","  564","  56"
"1726","glenn","2020-04-28","   0","    0","   0","  0","    0","   0"
"1727","humboldt","2020-04-28","   6","  305","   5","  1","  299","   4"
"1728","del norte","2020-04-28","   5","    0","   3","  1","   -5","   2"
"1729","plumas","2020-04-28","   0","    9","   0","  0","    9","   0"
"1730","contra costa","2020-04-28","  70"," 1485"," 137"," 23"," 1415"," 114"
"1731","san luis obispo","2020-04-28","   6","  526","  33","  4","  520","  29"
"1732","siskiyou","2020-04-28","   2","   65","   4","  1","   63","   3"
"1733","tehama","2020-04-28","   0","  106","   5","  0","  106","   5"
"1734","kings","2020-04-29","  11","  199","   8","  2","  188","   6"
"1735","santa barbara","2020-04-29","  42","  717","  85"," 14","  675","  71"
"1736","mariposa","2020-04-29","   1","   30","   0","  0","   29","   0"
"1737","ventura","2020-04-29","  57"," 1354","  50"," 17"," 1297","  33"
"1738","orange","2020-04-29"," 302"," 5397"," 373"," 92"," 5095"," 281"
"1739","san joaquin","2020-04-29","  41"," 1146","  30"," 16"," 1105","  14"
"1740","yolo","2020-04-29","   0","  130","  10","  1","  130","   9"
"1741","mono","2020-04-29","   0","   17","   1","  0","   17","   1"
"1742","siskiyou","2020-04-29","   3","   65","   2","  1","   62","   1"
"1743","shasta","2020-04-29","   2","  645","   5","  2","  643","   3"
"1744","tehama","2020-04-29","   0","  106","   5","  0","  106","   5"
"1745","humboldt","2020-04-29","   6","  305","   7","  3","  299","   4"
"1746","lake","2020-04-29","   2","   58","   1","  1","   56","   0"
"1747","inyo","2020-04-29","   0","   56","   6","  0","   56","   6"
"1748","san diego","2020-04-29"," 355"," 5619"," 363","136"," 5264"," 227"
"1749","stanislaus","2020-04-29","  61"," 1573","  97","  9"," 1512","  88"
"1750","merced","2020-04-29","   9","  206","   5","  2","  197","   3"
"1751","solano","2020-04-29","  28","  592","  56"," 10","  564","  46"
"1752","sacramento","2020-04-29","  78"," 1314"," 137"," 22"," 1236"," 115"
"1753","riverside","2020-04-29"," 336"," 3728"," 201","110"," 3392","  91"
"1754","los angeles","2020-04-29","2550","20960","1167","699","18410"," 468"
"1755","nevada","2020-04-29","   3","  102","   4","  2","   99","   2"
"1756","santa clara","2020-04-29"," 144"," 3331"," 198"," 48"," 3187"," 150"
"1757","san francisco","2020-04-29"," 104"," 1862"," 107"," 32"," 1758","  75"
"1758","san bernardino","2020-04-29"," 280"," 4556"," 162"," 79"," 4276","  83"
"1759","amador","2020-04-29","   0","    0","   4","  0","    0","   4"
"1760","placer","2020-04-29","  33","  340","  80","  4","  307","  76"
"1761","marin","2020-04-29","   6","  358","  22","  1","  352","  21"
"1762","san luis obispo","2020-04-29","   5","  526","  34","  3","  521","  31"
"1763","santa cruz","2020-04-29","   2","  354","   8","  1","  352","   7"
"1764","mendocino","2020-04-29","   0","  151","   6","  0","  151","   6"
"1765","napa","2020-04-29","   1","  387","   6","  0","  386","   6"
"1766","del norte","2020-04-29","   3","    0","   2","  1","   -3","   1"
"1767","glenn","2020-04-29","   0","    0","   0","  0","    0","   0"
"1768","lassen","2020-04-29","   0","   25","   0","  0","   25","   0"
"1769","tulare","2020-04-29","  30","  920","  30","  5","  890","  25"
"1770","calaveras","2020-04-29","   0","   50","  12","  0","   50","  12"
"1771","kern","2020-04-29","  49"," 1702","  59"," 26"," 1653","  33"
"1772","fresno","2020-04-29","  86"," 2007","  91"," 24"," 1921","  67"
"1773","sonoma","2020-04-29","  19","  789","  51","  4","  770","  47"
"1774","yuba","2020-04-29","   0","  445","  10","  0","  445","  10"
"1775","colusa","2020-04-29","   1","   80","   5","  1","   79","   4"
"1776","modoc","2020-04-29","   0","   24","   0","  0","   24","   0"
"1777","contra costa","2020-04-29","  74"," 1485"," 131"," 23"," 1411"," 108"
"1778","san benito","2020-04-29","   0","   25","   1","  0","   25","   1"
"1779","plumas","2020-04-29","   0","   39","   0","  0","   39","   0"
"1780","sutter","2020-04-29","   0","    0","   0","  0","    0","   0"
"1781","alameda","2020-04-29"," 139"," 1746"," 168"," 46"," 1607"," 122"
"1782","trinity","2020-04-29","   0","   54","   0","  0","   54","   0"
"1783","imperial","2020-04-29","  34","  258","   4"," 13","  224","  -9"
"1784","monterey","2020-04-29","   7","  875"," 106","  3","  868"," 103"
"1785","madera","2020-04-29","   1","  568","  22","  0","  567","  22"
"1786","tuolumne","2020-04-29","   0","  151","   0","  0","  151","   0"
"1787","el dorado","2020-04-29","   4","  156","   6","  2","  152","   4"
"1788","butte","2020-04-29","   2","  424","  20","  1","  422","  19"
"1789","san mateo","2020-04-29","  70","  790","  52"," 17","  720","  35"
"1790","solano","2020-04-30","  23","  592","  57","  8","  569","  49"
"1791","modoc","2020-04-30","   0","   41","   0","  0","   41","   0"
"1792","orange","2020-04-30"," 282"," 4725"," 457"," 87"," 4443"," 370"
"1793","marin","2020-04-30","   3","  358","  19","  0","  355","  19"
"1794","yolo","2020-04-30","   0","  130","  12","  0","  130","  12"
"1795","el dorado","2020-04-30","   6","  156","  10","  1","  150","   9"
"1796","kern","2020-04-30","  54"," 1385","  49"," 20"," 1331","  29"
"1797","tehama","2020-04-30","   0","  106","   4","  0","  106","   4"
"1798","lassen","2020-04-30","   0","   25","   0","  0","   25","   0"
"1799","tulare","2020-04-30","  30","  920","  29","  7","  890","  22"
"1800","imperial","2020-04-30","  32","  261","   4"," 13","  229","  -9"
"1801","san benito","2020-04-30","   1","   25","   2","  0","   24","   2"
"1802","los angeles","2020-04-30","2364","18236","1235","684","15872"," 551"
"1803","calaveras","2020-04-30","   0","   50","  12","  0","   50","  12"
"1804","tuolumne","2020-04-30","   0","  151","   0","  0","  151","   0"
"1805","plumas","2020-04-30","   0","   39","   0","  0","   39","   0"
"1806","santa clara","2020-04-30"," 141"," 3331"," 191"," 48"," 3190"," 143"
"1807","del norte","2020-04-30","   4","    0","   2","  2","   -4","   0"
"1808","humboldt","2020-04-30","   7","  305","   8","  2","  298","   6"
"1809","san diego","2020-04-30"," 364"," 4933"," 357","141"," 4569"," 216"
"1810","fresno","2020-04-30","  78"," 1997","  83"," 19"," 1919","  64"
"1811","santa barbara","2020-04-30","  35","  717","  85"," 16","  682","  69"
"1812","madera","2020-04-30","   3","  568","  21","  0","  565","  21"
"1813","glenn","2020-04-30","   0","    0","   0","  0","    0","   0"
"1814","colusa","2020-04-30","   1","   80","   5","  1","   79","   4"
"1815","mono","2020-04-30","   0","   17","   1","  0","   17","   1"
"1816","kings","2020-04-30","  10","  199","   3","  2","  189","   1"
"1817","nevada","2020-04-30","   1","  104","   4","  1","  103","   3"
"1818","san bernardino","2020-04-30"," 258"," 3738"," 184"," 75"," 3480"," 109"
"1819","yuba","2020-04-30","   0","  445","  14","  0","  445","  14"
"1820","inyo","2020-04-30","   0","   56","   6","  0","   56","   6"
"1821","trinity","2020-04-30","   0","   54","   0","  0","   54","   0"
"1822","monterey","2020-04-30","  12","  875"," 106","  6","  863"," 100"
"1823","butte","2020-04-30","   0","  424","  20","  0","  424","  20"
"1824","san francisco","2020-04-30","  96"," 1887"," 100"," 33"," 1791","  67"
"1825","contra costa","2020-04-30","  67"," 1485"," 141"," 15"," 1418"," 126"
"1826","napa","2020-04-30","   1","  387","   7","  0","  386","   7"
"1827","lake","2020-04-30","   2","   58","   2","  0","   56","   2"
"1828","stanislaus","2020-04-30","  62"," 1573"," 100","  8"," 1511","  92"
"1829","placer","2020-04-30","  32","  340","  82","  5","  308","  77"
"1830","san joaquin","2020-04-30","  41"," 1146","  30"," 12"," 1105","  18"
"1831","ventura","2020-04-30","  51"," 1381","  51"," 14"," 1330","  37"
"1832","san luis obispo","2020-04-30","   6","  526","  30","  4","  520","  26"
"1833","santa cruz","2020-04-30","   3","  354","  16","  2","  351","  14"
"1834","mariposa","2020-04-30","   2","   30","   0","  0","   28","   0"
"1835","mendocino","2020-04-30","   0","  151","   5","  0","  151","   5"
"1836","sacramento","2020-04-30","  72"," 1332"," 129"," 22"," 1260"," 107"
"1837","sonoma","2020-04-30","  12","  789","  50","  5","  777","  45"
"1838","sutter","2020-04-30","   0","    0","   0","  0","    0","   0"
"1839","siskiyou","2020-04-30","   2","   65","   4","  0","   63","   4"
"1840","riverside","2020-04-30"," 352"," 3310"," 184","115"," 2958","  69"
"1841","merced","2020-04-30","   5","  206","   5","  1","  201","   4"
"1842","shasta","2020-04-30","   2","  645","  10","  2","  643","   8"
"1843","amador","2020-04-30","   0","    0","   4","  0","    0","   4"
"1844","san mateo","2020-04-30","  63","  790","  48"," 17","  727","  31"
"1845","alameda","2020-04-30"," 126"," 1746"," 165"," 46"," 1620"," 119"
"1846","stanislaus","2020-05-01","  54"," 1573","  86","  5"," 1519","  81"
"1847","yuba","2020-05-01","   0","  445","   8","  0","  445","   8"
"1848","lake","2020-05-01","   2","   58","   2","  1","   56","   1"
"1849","mono","2020-05-01","   0","   17","   1","  0","   17","   1"
"1850","san benito","2020-05-01","   1","   25","   1","  0","   24","   1"
"1851","glenn","2020-05-01","   0","    0","   0","  0","    0","   0"
"1852","butte","2020-05-01","   1","  424","  20","  1","  423","  19"
"1853","tehama","2020-05-01","   0","  106","   3","  0","  106","   3"
"1854","monterey","2020-05-01","   8","  875"," 105","  4","  867"," 101"
"1855","trinity","2020-05-01","   0","   54","   0","  0","   54","   0"
"1856","nevada","2020-05-01","   1","  105","   6","  1","  104","   5"
"1857","santa barbara","2020-05-01","  38","  717","  77"," 15","  679","  62"
"1858","inyo","2020-05-01","   0","   56","   4","  0","   56","   4"
"1859","kings","2020-05-01","  11","  199","   1","  2","  188","  -1"
"1860","lassen","2020-05-01","   0","   25","   0","  0","   25","   0"
"1861","tulare","2020-05-01","  30","  920","  23","  7","  890","  16"
"1862","imperial","2020-05-01","  39","  263","   2"," 15","  224"," -13"
"1863","san luis obispo","2020-05-01","   7","  526","  21","  3","  519","  18"
"1864","san diego","2020-05-01"," 350"," 4932"," 365","134"," 4582"," 231"
"1865","el dorado","2020-05-01","   2","  156","  11","  1","  154","  10"
"1866","ventura","2020-05-01","  41"," 1375","  51"," 14"," 1334","  37"
"1867","tuolumne","2020-05-01","   0","  151","   0","  0","  151","   0"
"1868","modoc","2020-05-01","   0","   41","   0","  0","   41","   0"
"1869","plumas","2020-05-01","   0","   39","   0","  0","   39","   0"
"1870","orange","2020-05-01"," 319"," 4725"," 374"," 85"," 4406"," 289"
"1871","calaveras","2020-05-01","   1","   50","  12","  0","   49","  12"
"1872","shasta","2020-05-01","   1","  645","  15","  1","  644","  14"
"1873","amador","2020-05-01","   0","    0","  -2","  0","    0","  -2"
"1874","madera","2020-05-01","   0","  568","  19","  0","  568","  19"
"1875","san bernardino","2020-05-01"," 263"," 3738"," 138"," 70"," 3475","  68"
"1876","colusa","2020-05-01","   1","   80","   5","  1","   79","   4"
"1877","siskiyou","2020-05-01","   2","   65","   4","  0","   63","   4"
"1878","san francisco","2020-05-01"," 100"," 1887"," 101"," 32"," 1787","  69"
"1879","marin","2020-05-01","   5","  358","  23","  0","  353","  23"
"1880","solano","2020-05-01","  21","  592","  58","  9","  571","  49"
"1881","del norte","2020-05-01","   0","    0","   3","  0","    0","   3"
"1882","merced","2020-05-01","   5","  206","   3","  1","  201","   2"
"1883","sonoma","2020-05-01","  19","  789","  52","  5","  770","  47"
"1884","humboldt","2020-05-01","   5","  305","   7","  0","  300","   7"
"1885","riverside","2020-05-01"," 362"," 3302"," 217","122"," 2940","  95"
"1886","los angeles","2020-05-01","2395","18549","1185","704","16154"," 481"
"1887","yolo","2020-05-01","   0","  130","  14","  0","  130","  14"
"1888","fresno","2020-05-01","  72"," 2004","  77"," 21"," 1932","  56"
"1889","santa cruz","2020-05-01","   4","  354","  13","  2","  350","  11"
"1890","santa clara","2020-05-01"," 140"," 3331"," 197"," 44"," 3191"," 153"
"1891","contra costa","2020-05-01","  58"," 1485"," 143"," 15"," 1427"," 128"
"1892","napa","2020-05-01","   2","  387","   6","  0","  385","   6"
"1893","sutter","2020-05-01","   0","    0","   0","  0","    0","   0"
"1894","san joaquin","2020-05-01","  33"," 1146","  21"," 14"," 1113","   7"
"1895","placer","2020-05-01","  20","  340","  80","  4","  320","  76"
"1896","san mateo","2020-05-01","  60","  790","  49"," 18","  730","  31"
"1897","kern","2020-05-01","  48"," 1717","  47"," 19"," 1669","  28"
"1898","mendocino","2020-05-01","   0","  151","   6","  0","  151","   6"
"1899","alameda","2020-05-01"," 135"," 1746"," 165"," 45"," 1611"," 120"
"1900","mariposa","2020-05-01","   2","   30","   0","  0","   28","   0"
"1901","sacramento","2020-05-01","  64"," 1347"," 122"," 18"," 1283"," 104"
"1902","sutter","2020-05-02","   0","    0","   0","  0","    0","   0"
"1903","san joaquin","2020-05-02","  33"," 1146","  22"," 15"," 1113","   7"
"1904","butte","2020-05-02","   0","  424","  19","  0","  424","  19"
"1905","santa barbara","2020-05-02","  36","  717","  80"," 17","  681","  63"
"1906","monterey","2020-05-02","  11","  829"," 103","  5","  818","  98"
"1907","inyo","2020-05-02","   0","   42","   2","  0","   42","   2"
"1908","stanislaus","2020-05-02","  66"," 1573","  87","  8"," 1507","  79"
"1909","contra costa","2020-05-02","  65"," 1485"," 139"," 17"," 1420"," 122"
"1910","santa clara","2020-05-02"," 131"," 3331"," 195"," 46"," 3200"," 149"
"1911","solano","2020-05-02","  29","  592","  54"," 13","  563","  41"
"1912","marin","2020-05-02","  11","  358","  24","  0","  347","  24"
"1913","plumas","2020-05-02","   0","   39","   0","  0","   39","   0"
"1914","sacramento","2020-05-02","  58"," 1299"," 119"," 26"," 1241","  93"
"1915","tehama","2020-05-02","   0","  106","   5","  0","  106","   5"
"1916","del norte","2020-05-02","   0","    0","   4","  0","    0","   4"
"1917","lake","2020-05-02","   0","   58","   2","  0","   58","   2"
"1918","imperial","2020-05-02","  39","  261","   2"," 15","  222"," -13"
"1919","ventura","2020-05-02","  52"," 1416","  55"," 17"," 1364","  38"
"1920","madera","2020-05-02","   0","  568","  20","  0","  568","  20"
"1921","placer","2020-05-02","  28","  340","  82","  6","  312","  76"
"1922","mono","2020-05-02","   0","   17","   1","  0","   17","   1"
"1923","orange","2020-05-02"," 322"," 5374"," 376"," 98"," 5052"," 278"
"1924","san mateo","2020-05-02","  61","  790","  51"," 17","  729","  34"
"1925","glenn","2020-05-02","   0","    0","   0","  0","    0","   0"
"1926","shasta","2020-05-02","   0","  645","  13","  0","  645","  13"
"1927","amador","2020-05-02","   0","    0","   3","  0","    0","   3"
"1928","yuba","2020-05-02","   0","  445","  12","  0","  445","  12"
"1929","trinity","2020-05-02","   0","   54","   0","  0","   54","   0"
"1930","lassen","2020-05-02","   0","   25","   0","  0","   25","   0"
"1931","tulare","2020-05-02","  30","  920","  24","  7","  890","  17"
"1932","humboldt","2020-05-02","   5","  305","   8","  0","  300","   8"
"1933","merced","2020-05-02","   8","  206","   3","  2","  198","   1"
"1934","tuolumne","2020-05-02","   0","  151","   2","  0","  151","   2"
"1935","calaveras","2020-05-02","   1","   50","  11","  1","   49","  10"
"1936","el dorado","2020-05-02","   2","  156","  10","  1","  154","   9"
"1937","colusa","2020-05-02","   1","   80","   5","  1","   79","   4"
"1938","san francisco","2020-05-02"," 108"," 1915"," 101"," 36"," 1807","  65"
"1939","kern","2020-05-02","  43"," 1723","  41"," 20"," 1680","  21"
"1940","napa","2020-05-02","   1","  387","   3","  0","  386","   3"
"1941","mendocino","2020-05-02","   0","  151","   7","  0","  151","   7"
"1942","san diego","2020-05-02"," 357"," 5513"," 370","141"," 5156"," 229"
"1943","santa cruz","2020-05-02","   3","  354","  11","  1","  351","  10"
"1944","fresno","2020-05-02","  81"," 2008","  87"," 19"," 1927","  68"
"1945","los angeles","2020-05-02","2380","21176","1185","704","18796"," 481"
"1946","siskiyou","2020-05-02","   0","   65","   6","  0","   65","   6"
"1947","mariposa","2020-05-02","   0","   30","   0","  0","   30","   0"
"1948","modoc","2020-05-02","   0","   41","   0","  0","   41","   0"
"1949","alameda","2020-05-02"," 132"," 1746"," 163"," 38"," 1614"," 125"
"1950","san bernardino","2020-05-02"," 260"," 4419"," 126"," 77"," 4159","  49"
"1951","yolo","2020-05-02","   0","  130","  11","  0","  130","  11"
"1952","kings","2020-05-02","  10","  199","   3","  2","  189","   1"
"1953","sonoma","2020-05-02","  17","  789","  49","  3","  772","  46"
"1954","riverside","2020-05-02"," 337"," 3829"," 197","109"," 3492","  88"
"1955","nevada","2020-05-02","   2","  118","   6","  1","  116","   5"
"1956","san luis obispo","2020-05-02","  13","  526","  21","  5","  513","  16"
"1957","san benito","2020-05-02","   1","   25","   2","  0","   24","   2"
"1958","shasta","2020-05-03","   0","  645","  12","  0","  645","  12"
"1959","yolo","2020-05-03","   0","  130","   9","  2","  130","   7"
"1960","lake","2020-05-03","   3","   58","   2","  1","   55","   1"
"1961","lassen","2020-05-03","   0","   25","   0","  0","   25","   0"
"1962","monterey","2020-05-03","   8","  829","  92","  4","  821","  88"
"1963","merced","2020-05-03","   9","  206","   3","  4","  197","  -1"
"1964","siskiyou","2020-05-03","   0","   65","   6","  0","   65","   6"
"1965","riverside","2020-05-03"," 349"," 3809"," 179","112"," 3460","  67"
"1966","butte","2020-05-03","   2","  424","  22","  0","  422","  22"
"1967","colusa","2020-05-03","   1","   80","   5","  1","   79","   4"
"1968","fresno","2020-05-03","  88"," 2008","  86"," 22"," 1920","  64"
"1969","contra costa","2020-05-03","  64"," 1485"," 147"," 15"," 1421"," 132"
"1970","santa clara","2020-05-03"," 132"," 3331"," 199"," 47"," 3199"," 152"
"1971","san mateo","2020-05-03","  61","  790","  50"," 18","  729","  32"
"1972","humboldt","2020-05-03","   3","  305","   8","  0","  302","   8"
"1973","santa cruz","2020-05-03","   3","  354","  15","  1","  351","  14"
"1974","orange","2020-05-03"," 308"," 5374"," 376"," 91"," 5066"," 285"
"1975","solano","2020-05-03","  25","  592","  58","  9","  567","  49"
"1976","plumas","2020-05-03","   2","   29","   0","  0","   27","   0"
"1977","placer","2020-05-03","  19","  340","  84","  6","  321","  78"
"1978","san francisco","2020-05-03"," 101"," 1915"," 107"," 34"," 1814","  73"
"1979","los angeles","2020-05-03","2299","21621","1178","694","19322"," 484"
"1980","sacramento","2020-05-03","  57"," 1293"," 117"," 28"," 1236","  89"
"1981","san bernardino","2020-05-03"," 254"," 4419"," 135"," 75"," 4165","  60"
"1982","napa","2020-05-03","   0","  387","   4","  0","  387","   4"
"1983","mono","2020-05-03","   0","   17","   1","  0","   17","   1"
"1984","amador","2020-05-03","   0","    0","   2","  0","    0","   2"
"1985","modoc","2020-05-03","   0","   41","   0","  0","   41","   0"
"1986","glenn","2020-05-03","   0","    0","   0","  0","    0","   0"
"1987","alameda","2020-05-03"," 135"," 1746"," 164"," 48"," 1611"," 116"
"1988","marin","2020-05-03","   6","  358","  24","  0","  352","  24"
"1989","sonoma","2020-05-03","  16","  789","  51","  5","  773","  46"
"1990","trinity","2020-05-03","   0","   54","   0","  0","   54","   0"
"1991","sutter","2020-05-03","   0","    0","   0","  0","    0","   0"
"1992","inyo","2020-05-03","   1","   42","   2","  0","   41","   2"
"1993","tulare","2020-05-03","  28","  920","  26","  7","  892","  19"
"1994","tehama","2020-05-03","   0","  106","   5","  0","  106","   5"
"1995","del norte","2020-05-03","   0","    0","   7","  0","    0","   7"
"1996","imperial","2020-05-03","  44","  251","   3"," 14","  207"," -11"
"1997","ventura","2020-05-03","  63"," 1386","  58"," 16"," 1323","  42"
"1998","tuolumne","2020-05-03","   0","  151","   2","  0","  151","   2"
"1999","san diego","2020-05-03"," 352"," 5545"," 369","145"," 5193"," 224"
"2000","mendocino","2020-05-03","   0","  151","   7","  0","  151","   7"
"2001","kings","2020-05-03","  10","  199","   2","  2","  189","   0"
"2002","san luis obispo","2020-05-03","   9","  526","  22","  4","  517","  18"
"2003","san joaquin","2020-05-03","  35"," 1146","  22"," 15"," 1111","   7"
"2004","stanislaus","2020-05-03","  48"," 1573","  77","  8"," 1525","  69"
"2005","mariposa","2020-05-03","   0","   30","   0","  0","   30","   0"
"2006","nevada","2020-05-03","   1","  118","   8","  0","  117","   8"
"2007","madera","2020-05-03","   0","  568","  19","  0","  568","  19"
"2008","kern","2020-05-03","  42"," 1710","  86"," 18"," 1668","  68"
"2009","el dorado","2020-05-03","   2","  154","  10","  1","  152","   9"
"2010","calaveras","2020-05-03","   1","   50","  11","  1","   49","  10"
"2011","santa barbara","2020-05-03","  34","  717","  88"," 15","  683","  73"
"2012","san benito","2020-05-03","   0","   25","   2","  0","   25","   2"
"2013","yuba","2020-05-03","   1","  445","   7","  1","  444","   6"
"2014","tehama","2020-05-04","   0","  106","   6","  0","  106","   6"
"2015","solano","2020-05-04","  37","  592","  57","  8","  555","  49"
"2016","san diego","2020-05-04"," 354"," 5588"," 373","135"," 5234"," 238"
"2017","stanislaus","2020-05-04","  45","  995","  90","  5","  950","  85"
"2018","riverside","2020-05-04"," 323"," 3898"," 202","104"," 3575","  98"
"2019","amador","2020-05-04","   0","    0","   3","  0","    0","   3"
"2020","sutter","2020-05-04","   0","    0","   0","  0","    0","   0"
"2021","san bernardino","2020-05-04"," 259"," 4564"," 146"," 69"," 4305","  77"
"2022","contra costa","2020-05-04","  51"," 1485"," 142"," 13"," 1434"," 129"
"2023","siskiyou","2020-05-04","   0","   65","   6","  0","   65","   6"
"2024","los angeles","2020-05-04","2371","22298","1166","676","19927"," 490"
"2025","orange","2020-05-04"," 294"," 5607"," 349"," 88"," 5313"," 261"
"2026","mariposa","2020-05-04","   0","   30","   0","  0","   30","   0"
"2027","placer","2020-05-04","  17","  340","  88","  1","  323","  87"
"2028","sacramento","2020-05-04","  50"," 1284"," 131"," 21"," 1234"," 110"
"2029","inyo","2020-05-04","   1","   42","   4","  0","   41","   4"
"2030","el dorado","2020-05-04","   3","  185","   9","  0","  182","   9"
"2031","yolo","2020-05-04","   0","  130","   9","  2","  130","   7"
"2032","lassen","2020-05-04","   0","   25","   0","  0","   25","   0"
"2033","mono","2020-05-04","   0","   17","   1","  0","   17","   1"
"2034","calaveras","2020-05-04","   1","   50","  11","  0","   49","  11"
"2035","ventura","2020-05-04","  43"," 1383","  55"," 14"," 1340","  41"
"2036","humboldt","2020-05-04","   3","  344","   8","  1","  341","   7"
"2037","nevada","2020-05-04","   1","  122","   3","  0","  121","   3"
"2038","del norte","2020-05-04","   0","    0","   5","  0","    0","   5"
"2039","san benito","2020-05-04","   0","   25","   2","  0","   25","   2"
"2040","kings","2020-05-04","  10","  199","   4","  2","  189","   2"
"2041","colusa","2020-05-04","   0","   88","   6","  0","   88","   6"
"2042","trinity","2020-05-04","   0","   54","   0","  0","   54","   0"
"2043","lake","2020-05-04","   4","   58","   4","  0","   54","   4"
"2044","imperial","2020-05-04","  56","  252","   1"," 16","  196"," -15"
"2045","santa barbara","2020-05-04","  39","  717","  97"," 18","  678","  79"
"2046","marin","2020-05-04","   8","  350","  21","  3","  342","  18"
"2047","tuolumne","2020-05-04","   0","  151","   1","  0","  151","   1"
"2048","yuba","2020-05-04","   1","  445","   9","  1","  444","   8"
"2049","merced","2020-05-04","  12","  206","   6","  5","  194","   1"
"2050","madera","2020-05-04","   1","  568","  22","  0","  567","  22"
"2051","san luis obispo","2020-05-04","  11","  526","  24","  4","  515","  20"
"2052","tulare","2020-05-04","  22","  920","  24","  6","  898","  18"
"2053","monterey","2020-05-04","   5","  829"," 102","  3","  824","  99"
"2054","plumas","2020-05-04","   2","   29","   0","  0","   27","   0"
"2055","modoc","2020-05-04","   0","   41","   0","  0","   41","   0"
"2056","butte","2020-05-04","   1","  448","  12","  0","  447","  12"
"2057","alameda","2020-05-04"," 135"," 1769"," 163"," 46"," 1634"," 117"
"2058","san joaquin","2020-05-04","  33"," 1287","  23"," 14"," 1254","   9"
"2059","san mateo","2020-05-04","  59","  790","  54"," 13","  731","  41"
"2060","santa clara","2020-05-04"," 123"," 3331"," 210"," 42"," 3208"," 168"
"2061","napa","2020-05-04","   0","  387","   5","  1","  387","   4"
"2062","fresno","2020-05-04","  86"," 2001","  89"," 25"," 1915","  64"
"2063","santa cruz","2020-05-04","   3","  354","  15","  0","  351","  15"
"2064","sonoma","2020-05-04","  16","  789","  57","  3","  773","  54"
"2065","san francisco","2020-05-04","  94"," 1887"," 118"," 26"," 1793","  92"
"2066","glenn","2020-05-04","   0","    0","   0","  0","    0","   0"
"2067","shasta","2020-05-04","   0","  667","  12","  0","  667","  12"
"2068","mendocino","2020-05-04","   0","  180","   5","  0","  180","   5"
"2069","kern","2020-05-04","  48"," 1728","  74"," 23"," 1680","  51"
"2070","los angeles","2020-05-05","2370","22079","1164","681","19709"," 483"
"2071","mendocino","2020-05-05","   0","  158","   5","  0","  158","   5"
"2072","marin","2020-05-05","  14","  390","  20","  3","  376","  17"
"2073","colusa","2020-05-05","   0","   88","   6","  0","   88","   6"
"2074","madera","2020-05-05","   0","  568","  19","  0","  568","  19"
"2075","imperial","2020-05-05","  58","  255","   1"," 16","  197"," -15"
"2076","contra costa","2020-05-05","  69"," 1628"," 119"," 18"," 1559"," 101"
"2077","kern","2020-05-05","  42"," 1737","  80"," 20"," 1695","  60"
"2078","modoc","2020-05-05","   0","   41","   0","  0","   41","   0"
"2079","mono","2020-05-05","   0","   17","   2","  0","   17","   2"
"2080","butte","2020-05-05","   0","  448","  14","  0","  448","  14"
"2081","san joaquin","2020-05-05","  47"," 1366","  25"," 17"," 1319","   8"
"2082","kings","2020-05-05","  12","  199","   0","  2","  187","  -2"
"2083","yolo","2020-05-05","   0","  186","  12","  0","  186","  12"
"2084","mariposa","2020-05-05","   1","   30","   0","  0","   29","   0"
"2085","amador","2020-05-05","   0","   51","   0","  0","   51","   0"
"2086","sutter","2020-05-05","   0","   14","   0","  0","   14","   0"
"2087","merced","2020-05-05","  10","  242","   4","  4","  232","   0"
"2088","trinity","2020-05-05","   0","   54","   0","  0","   54","   0"
"2089","san luis obispo","2020-05-05","   5","  526","  27","  3","  521","  24"
"2090","calaveras","2020-05-05","   0","   50","  12","  0","   50","  12"
"2091","el dorado","2020-05-05","   4","  185","   9","  0","  181","   9"
"2092","san benito","2020-05-05","   0","   25","   2","  0","   25","   2"
"2093","santa cruz","2020-05-05","   3","  397","  12","  1","  394","  11"
"2094","san francisco","2020-05-05"," 103"," 2619"," 101"," 33"," 2516","  68"
"2095","lassen","2020-05-05","   0","   25","   0","  0","   25","   0"
"2096","plumas","2020-05-05","   2","   45","   0","  0","   43","   0"
"2097","sacramento","2020-05-05","  50"," 2323"," 119"," 19"," 2273"," 100"
"2098","tehama","2020-05-05","   0","  106","   6","  0","  106","   6"
"2099","del norte","2020-05-05","   0","   51","   5","  0","   51","   5"
"2100","yuba","2020-05-05","   1","  445","  10","  1","  444","   9"
"2101","tuolumne","2020-05-05","   0","  151","   1","  0","  151","   1"
"2102","ventura","2020-05-05","  48"," 1360","  56"," 18"," 1312","  38"
"2103","san bernardino","2020-05-05"," 260"," 4564"," 139"," 78"," 4304","  61"
"2104","san diego","2020-05-05"," 363"," 6128"," 345","133"," 5765"," 212"
"2105","napa","2020-05-05","   2","  387","   4","  2","  385","   2"
"2106","santa clara","2020-05-05"," 113"," 3273"," 220"," 39"," 3160"," 181"
"2107","riverside","2020-05-05"," 333"," 3898"," 185","114"," 3565","  71"
"2108","shasta","2020-05-05","   0","  667","   9","  0","  667","   9"
"2109","orange","2020-05-05"," 279"," 5585"," 372"," 85"," 5306"," 287"
"2110","humboldt","2020-05-05","  13","  344","  10","  2","  331","   8"
"2111","inyo","2020-05-05","   0","   42","   4","  0","   42","   4"
"2112","santa barbara","2020-05-05","  35","  717","  99"," 15","  682","  84"
"2113","siskiyou","2020-05-05","   0","   65","   6","  0","   65","   6"
"2114","stanislaus","2020-05-05","  40"," 1369","  87","  4"," 1329","  83"
"2115","glenn","2020-05-05","   0","    0","   0","  0","    0","   0"
"2116","fresno","2020-05-05","  99"," 2049","  88"," 27"," 1950","  61"
"2117","solano","2020-05-05","  29","  707","  50","  6","  678","  44"
"2118","nevada","2020-05-05","   0","  129","   3","  0","  129","   3"
"2119","tulare","2020-05-05","  24","  920","  18","  5","  896","  13"
"2120","sonoma","2020-05-05","  16","  871","  60","  3","  855","  57"
"2121","san mateo","2020-05-05","  58"," 1096","  35"," 18"," 1038","  17"
"2122","lake","2020-05-05","   2","  110","  -2","  1","  108","  -3"
"2123","alameda","2020-05-05"," 147"," 2446"," 143"," 42"," 2299"," 101"
"2124","monterey","2020-05-05","   5","  829"," 107","  3","  824"," 104"
"2125","placer","2020-05-05","  24","  753","  80","  2","  729","  78"
"2126","kern","2020-05-06","  41"," 1747","  80"," 18"," 1706","  62"
"2127","calaveras","2020-05-06","   0","   50","  12","  0","   50","  12"
"2128","san mateo","2020-05-06","  61"," 1096","  52"," 14"," 1035","  38"
"2129","san luis obispo","2020-05-06","   4","  526","  31","  4","  522","  27"
"2130","lassen","2020-05-06","   1","   25","   0","  0","   24","   0"
"2131","glenn","2020-05-06","   0","    0","   0","  0","    0","   0"
"2132","stanislaus","2020-05-06","  38"," 1369","  88","  3"," 1331","  85"
"2133","tehama","2020-05-06","   0","  106","   4","  0","  106","   4"
"2134","del norte","2020-05-06","   0","   51","   6","  0","   51","   6"
"2135","inyo","2020-05-06","   0","   42","   4","  0","   42","   4"
"2136","sutter","2020-05-06","   0","   14","   0","  0","   14","   0"
"2137","yolo","2020-05-06","   1","  186","  11","  0","  185","  11"
"2138","amador","2020-05-06","   0","   51","   1","  0","   51","   1"
"2139","san benito","2020-05-06","   0","   25","   1","  0","   25","   1"
"2140","yuba","2020-05-06","   0","  445","   7","  0","  445","   7"
"2141","mariposa","2020-05-06","   1","   30","   0","  0","   29","   0"
"2142","nevada","2020-05-06","   0","  126","   2","  1","  126","   1"
"2143","los angeles","2020-05-06","2292","23573","1206","657","21281"," 549"
"2144","plumas","2020-05-06","   2","   45","   0","  0","   43","   0"
"2145","riverside","2020-05-06"," 296"," 3938"," 183","109"," 3642","  74"
"2146","merced","2020-05-06","   9","  242","   4","  6","  233","  -2"
"2147","santa barbara","2020-05-06","  36","  717","  81"," 14","  681","  67"
"2148","modoc","2020-05-06","   0","   41","   0","  0","   41","   0"
"2149","santa cruz","2020-05-06","   3","  397","   7","  1","  394","   6"
"2150","mendocino","2020-05-06","   0","  180","   4","  0","  180","   4"
"2151","fresno","2020-05-06","  94"," 2054","  92"," 22"," 1960","  70"
"2152","siskiyou","2020-05-06","   0","   65","   5","  0","   65","   5"
"2153","san joaquin","2020-05-06","  46"," 1366","  31"," 17"," 1320","  14"
"2154","madera","2020-05-06","   0","  568","  15","  0","  568","  15"
"2155","kings","2020-05-06","  13","  199","   2","  2","  186","   0"
"2156","mono","2020-05-06","   1","   17","   2","  0","   16","   2"
"2157","shasta","2020-05-06","   0","  667","  12","  0","  667","  12"
"2158","monterey","2020-05-06","   6","  829"," 106","  3","  823"," 103"
"2159","napa","2020-05-06","   2","  387","   6","  1","  385","   5"
"2160","trinity","2020-05-06","   0","   54","   0","  0","   54","   0"
"2161","tulare","2020-05-06","  28","  920","  18","  5","  892","  13"
"2162","san diego","2020-05-06"," 379"," 6195"," 339","134"," 5816"," 205"
"2163","contra costa","2020-05-06","  67"," 1628"," 122"," 20"," 1561"," 102"
"2164","imperial","2020-05-06","  63","  252","   7"," 19","  189"," -12"
"2165","ventura","2020-05-06","  51"," 1352","  45"," 19"," 1301","  26"
"2166","tuolumne","2020-05-06","   0","  151","   1","  0","  151","   1"
"2167","lake","2020-05-06","   3","  110","   4","  1","  107","   3"
"2168","el dorado","2020-05-06","   4","  175","   8","  0","  171","   8"
"2169","santa clara","2020-05-06"," 111"," 3275"," 210"," 40"," 3164"," 170"
"2170","orange","2020-05-06"," 279"," 5585"," 372"," 85"," 5306"," 287"
"2171","san bernardino","2020-05-06"," 236"," 4564"," 157"," 65"," 4328","  92"
"2172","marin","2020-05-06","  17","  390","  21","  3","  373","  18"
"2173","colusa","2020-05-06","   0","   88","   6","  0","   88","   6"
"2174","solano","2020-05-06","  30","  707","  61","  8","  677","  53"
"2175","humboldt","2020-05-06","   7","  344","   6","  2","  337","   4"
"2176","sonoma","2020-05-06","  17","  871","  56","  3","  854","  53"
"2177","butte","2020-05-06","   0","  448","  17","  0","  448","  17"
"2178","sacramento","2020-05-06","  67"," 2319"," 115"," 19"," 2252","  96"
"2179","san francisco","2020-05-06","  88"," 2619"," 113"," 30"," 2531","  83"
"2180","placer","2020-05-06","  30","  753","  84","  6","  723","  78"
"2181","alameda","2020-05-06"," 136"," 2407"," 171"," 43"," 2271"," 128"
"2182","kern","2020-05-07","  36"," 1734","  79"," 20"," 1698","  59"
"2183","orange","2020-05-07"," 299"," 5585"," 351"," 94"," 5286"," 257"
"2184","san joaquin","2020-05-07","  38"," 1366","  31"," 12"," 1328","  19"
"2185","lassen","2020-05-07","   0","   25","   0","  0","   25","   0"
"2186","placer","2020-05-07","  31","  753","  38","  5","  722","  33"
"2187","tehama","2020-05-07","   0","  106","   5","  0","  106","   5"
"2188","lake","2020-05-07","   0","  110","   3","  0","  110","   3"
"2189","ventura","2020-05-07","  58"," 1353","  56"," 20"," 1295","  36"
"2190","inyo","2020-05-07","   0","   42","   4","  0","   42","   4"
"2191","colusa","2020-05-07","   1","   88","   6","  0","   87","   6"
"2192","shasta","2020-05-07","   0","  667","  17","  0","  667","  17"
"2193","sacramento","2020-05-07","  51"," 2318","  91"," 19"," 2267","  72"
"2194","tuolumne","2020-05-07","   0","  151","   1","  0","  151","   1"
"2195","alameda","2020-05-07"," 136"," 2446"," 131"," 43"," 2310","  88"
"2196","napa","2020-05-07","   2","  387","   3","  1","  385","   2"
"2197","glenn","2020-05-07","   0","    0","   0","  0","    0","   0"
"2198","del norte","2020-05-07","   1","   51","   1","  0","   50","   1"
"2199","yolo","2020-05-07","   0","  186","  11","  0","  186","  11"
"2200","el dorado","2020-05-07","   2","  172","  10","  0","  170","  10"
"2201","imperial","2020-05-07","  59","  334","   7"," 19","  275"," -12"
"2202","contra costa","2020-05-07","  65"," 1628","  97"," 19"," 1563","  78"
"2203","modoc","2020-05-07","   0","   41","   0","  0","   41","   0"
"2204","santa cruz","2020-05-07","   4","  397","   9","  0","  393","   9"
"2205","san mateo","2020-05-07","  51"," 1096","  43"," 13"," 1045","  30"
"2206","butte","2020-05-07","   2","  448","  19","  0","  446","  19"
"2207","riverside","2020-05-07"," 270"," 3902"," 177"," 99"," 3632","  78"
"2208","sutter","2020-05-07","   0","   14","   0","  0","   14","   0"
"2209","los angeles","2020-05-07","2323","23461","1220","638","21138"," 582"
"2210","sonoma","2020-05-07","  13","  871","  52","  3","  858","  49"
"2211","marin","2020-05-07","  13","  390","  14","  2","  377","  12"
"2212","monterey","2020-05-07","   5","  829"," 106","  3","  824"," 103"
"2213","mono","2020-05-07","   0","   17","   2","  0","   17","   2"
"2214","san francisco","2020-05-07","  93"," 2619","  78"," 31"," 2526","  47"
"2215","san benito","2020-05-07","   0","   25","   0","  0","   25","   0"
"2216","yuba","2020-05-07","   0","  445","   7","  0","  445","   7"
"2217","amador","2020-05-07","   0","   51","   1","  0","   51","   1"
"2218","san diego","2020-05-07"," 387"," 6204"," 338","139"," 5817"," 199"
"2219","calaveras","2020-05-07","   0","   50","  12","  0","   50","  12"
"2220","san luis obispo","2020-05-07","   6","  526","  26","  3","  520","  23"
"2221","madera","2020-05-07","   1","  568","  14","  0","  567","  14"
"2222","mariposa","2020-05-07","   1","   30","   0","  0","   29","   0"
"2223","tulare","2020-05-07","  11","  920","  28","  5","  909","  23"
"2224","nevada","2020-05-07","   0","  112","   4","  0","  112","   4"
"2225","merced","2020-05-07","   8","  242","   4","  4","  234","   0"
"2226","santa barbara","2020-05-07","  39","  717","  82"," 14","  678","  68"
"2227","plumas","2020-05-07","   0","   45","   0","  0","   45","   0"
"2228","siskiyou","2020-05-07","   3","   65","   3","  2","   62","   1"
"2229","mendocino","2020-05-07","   0","  180","   3","  0","  180","   3"
"2230","fresno","2020-05-07","  88"," 2051","  92"," 18"," 1963","  74"
"2231","stanislaus","2020-05-07","  39"," 1369","  75","  5"," 1330","  70"
"2232","humboldt","2020-05-07","   6","  352","   6","  0","  346","   6"
"2233","san bernardino","2020-05-07"," 226"," 4564"," 165"," 63"," 4338"," 102"
"2234","santa clara","2020-05-07"," 107"," 3275"," 180"," 35"," 3168"," 145"
"2235","solano","2020-05-07","  25","  707","  39"," 10","  682","  29"
"2236","trinity","2020-05-07","   0","   54","   0","  0","   54","   0"
"2237","kings","2020-05-07","  14","  199","   0","  3","  185","  -3"
"2238","lassen","2020-05-08","   1","   25","   0","  0","   24","   0"
"2239","plumas","2020-05-08","   0","   45","   0","  0","   45","   0"
"2240","amador","2020-05-08","   0","   51","   2","  0","   51","   2"
"2241","riverside","2020-05-08"," 277"," 3902"," 158","104"," 3625","  54"
"2242","shasta","2020-05-08","   0","  667","  15","  0","  667","  15"
"2243","kern","2020-05-08","  39"," 1726","  81"," 23"," 1687","  58"
"2244","napa","2020-05-08","   1","  387","   2","  1","  386","   1"
"2245","mendocino","2020-05-08","   0","  180","   4","  0","  180","   4"
"2246","placer","2020-05-08","  26","  753","  32","  3","  727","  29"
"2247","butte","2020-05-08","   2","  448","  23","  0","  446","  23"
"2248","colusa","2020-05-08","   2","   88","   5","  1","   86","   4"
"2249","del norte","2020-05-08","   1","   51","   2","  1","   50","   1"
"2250","lake","2020-05-08","   1","  110","   2","  0","  109","   2"
"2251","mariposa","2020-05-08","   1","   30","   0","  0","   29","   0"
"2252","calaveras","2020-05-08","   0","   50","  11","  0","   50","  11"
"2253","yuba","2020-05-08","   0","  445","   6","  0","  445","   6"
"2254","siskiyou","2020-05-08","   3","   65","   0","  2","   62","  -2"
"2255","orange","2020-05-08"," 299"," 6836"," 338"," 99"," 6537"," 239"
"2256","san luis obispo","2020-05-08","   4","  526","  21","  3","  522","  18"
"2257","mono","2020-05-08","   0","   17","   2","  0","   17","   2"
"2258","stanislaus","2020-05-08","  36"," 1369","  81","  5"," 1333","  76"
"2259","san mateo","2020-05-08","  56"," 1096","  43"," 14"," 1040","  29"
"2260","alameda","2020-05-08"," 136"," 2446"," 126"," 46"," 2310","  80"
"2261","tulare","2020-05-08","  26","  920","  20","  7","  894","  13"
"2262","tuolumne","2020-05-08","   0","  151","   2","  0","  151","   2"
"2263","san diego","2020-05-08"," 407"," 6156"," 328","144"," 5749"," 184"
"2264","trinity","2020-05-08","   0","   54","   0","  0","   54","   0"
"2265","tehama","2020-05-08","   0","  106","   2","  0","  106","   2"
"2266","yolo","2020-05-08","   0","  186","   4","  0","  186","   4"
"2267","modoc","2020-05-08","   0","   41","   0","  0","   41","   0"
"2268","merced","2020-05-08","   8","  242","   2","  5","  234","  -3"
"2269","madera","2020-05-08","   1","  530","  26","  0","  529","  26"
"2270","san joaquin","2020-05-08","  47"," 1366","  27"," 14"," 1319","  13"
"2271","humboldt","2020-05-08","   6","  352","   6","  0","  346","   6"
"2272","sutter","2020-05-08","   0","   14","   0","  0","   14","   0"
"2273","santa cruz","2020-05-08","   4","  397","  14","  0","  393","  14"
"2274","santa clara","2020-05-08","  95"," 3306"," 180"," 34"," 3211"," 146"
"2275","los angeles","2020-05-08","2276","23900","1181","617","21624"," 564"
"2276","fresno","2020-05-08","  81"," 2049","  89"," 19"," 1968","  70"
"2277","santa barbara","2020-05-08","  36","  717","  86"," 13","  681","  73"
"2278","solano","2020-05-08","  33","  707","  48","  7","  674","  41"
"2279","contra costa","2020-05-08","  82"," 1628","  99"," 21"," 1546","  78"
"2280","san francisco","2020-05-08"," 103"," 2619","  92"," 35"," 2516","  57"
"2281","glenn","2020-05-08","   0","    0","   0","  0","    0","   0"
"2282","inyo","2020-05-08","   1","   42","   4","  0","   41","   4"
"2283","san bernardino","2020-05-08"," 220"," 4821"," 166"," 63"," 4601"," 103"
"2284","el dorado","2020-05-08","   4","  171","   7","  0","  167","   7"
"2285","sacramento","2020-05-08","  51"," 2332","  82"," 16"," 2281","  66"
"2286","nevada","2020-05-08","   0","  120","   7","  0","  120","   7"
"2287","kings","2020-05-08","  15","  199","   0","  4","  184","  -4"
"2288","imperial","2020-05-08","  70","  342","   9"," 19","  272"," -10"
"2289","san benito","2020-05-08","   0","   25","   1","  0","   25","   1"
"2290","monterey","2020-05-08","   9","  829"," 115","  3","  820"," 112"
"2291","ventura","2020-05-08","  54"," 1300","  52"," 19"," 1246","  33"
"2292","marin","2020-05-08","   7","  390","  11","  2","  383","   9"
"2293","sonoma","2020-05-08","  17","  871","  51","  5","  854","  46"
"2294","santa clara","2020-05-09"," 102"," 3306"," 183"," 33"," 3204"," 150"
"2295","shasta","2020-05-09","   0","  667","  17","  0","  667","  17"
"2296","tuolumne","2020-05-09","   0","  151","   3","  0","  151","   3"
"2297","tulare","2020-05-09","  30","  920","  27","  9","  890","  18"
"2298","yolo","2020-05-09","   0","  186","   1","  2","  186","  -1"
"2299","mariposa","2020-05-09","   1","   30","   0","  0","   29","   0"
"2300","merced","2020-05-09","  11","  242","   2","  6","  231","  -4"
"2301","san mateo","2020-05-09","  58"," 1096","  40"," 16"," 1038","  24"
"2302","trinity","2020-05-09","   0","   54","   0","  0","   54","   0"
"2303","del norte","2020-05-09","   0","   51","   0","  0","   51","   0"
"2304","san diego","2020-05-09"," 396"," 6172"," 329","143"," 5776"," 186"
"2305","colusa","2020-05-09","   0","   88","   6","  0","   88","   6"
"2306","stanislaus","2020-05-09","  29"," 1369","  82","  6"," 1340","  76"
"2307","siskiyou","2020-05-09","   0","   65","   4","  0","   65","   4"
"2308","fresno","2020-05-09","  98"," 2049","  88"," 21"," 1951","  67"
"2309","napa","2020-05-09","   2","  387","   8","  1","  385","   7"
"2310","modoc","2020-05-09","   0","   41","   0","  0","   41","   0"
"2311","sutter","2020-05-09","   0","   14","   0","  0","   14","   0"
"2312","ventura","2020-05-09","  57"," 1321","  50"," 17"," 1264","  33"
"2313","el dorado","2020-05-09","   4","  171","  11","  0","  167","  11"
"2314","amador","2020-05-09","   0","   51","   2","  0","   51","   2"
"2315","calaveras","2020-05-09","   2","   50","   9","  1","   48","   8"
"2316","san luis obispo","2020-05-09","   6","  526","  27","  4","  520","  23"
"2317","monterey","2020-05-09","  10","  829"," 113","  3","  819"," 110"
"2318","san benito","2020-05-09","   0","   25","   3","  0","   25","   3"
"2319","mono","2020-05-09","   0","   17","   2","  0","   17","   2"
"2320","inyo","2020-05-09","   0","   42","   3","  0","   42","   3"
"2321","lake","2020-05-09","   0","  110","   3","  0","  110","   3"
"2322","yuba","2020-05-09","   0","  445","   7","  0","  445","   7"
"2323","nevada","2020-05-09","   0","  108","   4","  0","  108","   4"
"2324","santa cruz","2020-05-09","   3","  397","  19","  0","  394","  19"
"2325","san bernardino","2020-05-09"," 231"," 4821"," 171"," 68"," 4590"," 103"
"2326","imperial","2020-05-09","  70","  349","   9"," 19","  279"," -10"
"2327","kern","2020-05-09","  51"," 1728","  78"," 27"," 1677","  51"
"2328","glenn","2020-05-09","   0","    0","   0","  0","    0","   0"
"2329","orange","2020-05-09"," 300"," 6836"," 321","104"," 6536"," 217"
"2330","los angeles","2020-05-09","2221","23877","1213","575","21656"," 638"
"2331","san francisco","2020-05-09","  97"," 2619","  97"," 32"," 2522","  65"
"2332","santa barbara","2020-05-09","  32","  717","  80"," 12","  685","  68"
"2333","lassen","2020-05-09","   1","   25","   0","  0","   24","   0"
"2334","kings","2020-05-09","  18","  199","   0","  4","  181","  -4"
"2335","madera","2020-05-09","   1","  530","  30","  0","  529","  30"
"2336","placer","2020-05-09","  37","  753","  40","  3","  716","  37"
"2337","tehama","2020-05-09","   0","  106","   2","  0","  106","   2"
"2338","butte","2020-05-09","   3","  448","  24","  2","  445","  22"
"2339","riverside","2020-05-09"," 310"," 3874"," 159","103"," 3564","  56"
"2340","sonoma","2020-05-09","  15","  871","  50","  5","  856","  45"
"2341","sacramento","2020-05-09","  53"," 2327","  88"," 17"," 2274","  71"
"2342","alameda","2020-05-09"," 139"," 2446"," 122"," 51"," 2307","  71"
"2343","humboldt","2020-05-09","   6","  352","   6","  0","  346","   6"
"2344","san joaquin","2020-05-09","  44"," 1366","  24"," 11"," 1322","  13"
"2345","plumas","2020-05-09","   1","   45","   0","  0","   44","   0"
"2346","contra costa","2020-05-09","  68"," 1628"," 104"," 20"," 1560","  84"
"2347","marin","2020-05-09","  13","  390","   6","  4","  377","   2"
"2348","solano","2020-05-09","  35","  707","  46","  9","  672","  37"
"2349","mendocino","2020-05-09","   0","  180","   4","  0","  180","   4"
"2350","mariposa","2020-05-10","   0","   30","   0","  0","   30","   0"
"2351","sonoma","2020-05-10","  12","  871","  50","  4","  859","  46"
"2352","monterey","2020-05-10","   9","  829"," 108","  3","  820"," 105"
"2353","orange","2020-05-10"," 308"," 6836"," 353","102"," 6528"," 251"
"2354","santa clara","2020-05-10"," 111"," 3306"," 179"," 32"," 3195"," 147"
"2355","inyo","2020-05-10","   0","   42","   3","  0","   42","   3"
"2356","colusa","2020-05-10","   0","   88","   6","  0","   88","   6"
"2357","tulare","2020-05-10","  29","  920","  26","  8","  891","  18"
"2358","tuolumne","2020-05-10","   0","  151","   2","  0","  151","   2"
"2359","yuba","2020-05-10","   0","  445","   6","  0","  445","   6"
"2360","humboldt","2020-05-10","   6","  352","   3","  0","  346","   3"
"2361","san bernardino","2020-05-10"," 227"," 4821"," 188"," 65"," 4594"," 123"
"2362","alameda","2020-05-10"," 123"," 2446"," 125"," 44"," 2323","  81"
"2363","san mateo","2020-05-10","  52"," 1096","  43"," 17"," 1044","  26"
"2364","yolo","2020-05-10","   0","  186","   1","  2","  186","  -1"
"2365","tehama","2020-05-10","   0","  106","   3","  0","  106","   3"
"2366","napa","2020-05-10","   2","  387","   3","  2","  385","   1"
"2367","san benito","2020-05-10","   0","   25","   1","  0","   25","   1"
"2368","santa barbara","2020-05-10","  30","  717","  81"," 12","  687","  69"
"2369","glenn","2020-05-10","   0","    0","   0","  0","    0","   0"
"2370","butte","2020-05-10","   3","  448","  21","  1","  445","  20"
"2371","stanislaus","2020-05-10","  27"," 1369","  80","  4"," 1342","  76"
"2372","ventura","2020-05-10","  52"," 1308","  49"," 17"," 1256","  32"
"2373","merced","2020-05-10","   6","  242","   4","  4","  236","   0"
"2374","mendocino","2020-05-10","   0","  180","   4","  0","  180","   4"
"2375","marin","2020-05-10","  17","  390","  11","  5","  373","   6"
"2376","calaveras","2020-05-10","   0","   50","   9","  0","   50","   9"
"2377","contra costa","2020-05-10","  61"," 1628"," 110"," 16"," 1567","  94"
"2378","solano","2020-05-10","  36","  707","  48","  9","  671","  39"
"2379","kern","2020-05-10","  51"," 1728","  96"," 29"," 1677","  67"
"2380","fresno","2020-05-10","  98"," 2056","  89"," 31"," 1958","  58"
"2381","placer","2020-05-10","  27","  753","  34","  4","  726","  30"
"2382","madera","2020-05-10","   2","  530","  30","  0","  528","  30"
"2383","siskiyou","2020-05-10","   0","   65","   4","  0","   65","   4"
"2384","mono","2020-05-10","   0","   17","   2","  0","   17","   2"
"2385","san francisco","2020-05-10","  91"," 2619"," 102"," 34"," 2528","  68"
"2386","modoc","2020-05-10","   0","   41","   0","  0","   41","   0"
"2387","kings","2020-05-10","  17","  199","   3","  4","  182","  -1"
"2388","san diego","2020-05-10"," 390"," 6056"," 357","142"," 5666"," 215"
"2389","riverside","2020-05-10"," 316"," 3856"," 177","102"," 3540","  75"
"2390","amador","2020-05-10","   0","   51","   2","  0","   51","   2"
"2391","los angeles","2020-05-10","2270","23858","1253","588","21588"," 665"
"2392","sutter","2020-05-10","   0","   14","   0","  0","   14","   0"
"2393","del norte","2020-05-10","   0","   51","   1","  0","   51","   1"
"2394","lake","2020-05-10","   1","  110","   0","  0","  109","   0"
"2395","imperial","2020-05-10","  64","  336","   9"," 17","  272","  -8"
"2396","san luis obispo","2020-05-10","   5","  526","  24","  2","  521","  22"
"2397","trinity","2020-05-10","   0","   54","   0","  0","   54","   0"
"2398","nevada","2020-05-10","   1","  107","   5","  0","  106","   5"
"2399","el dorado","2020-05-10","   2","  171","  15","  0","  169","  15"
"2400","shasta","2020-05-10","   0","  667","   8","  1","  667","   7"
"2401","santa cruz","2020-05-10","   3","  397","  16","  0","  394","  16"
"2402","plumas","2020-05-10","   1","   45","   0","  0","   44","   0"
"2403","san joaquin","2020-05-10","  43"," 1366","  19"," 10"," 1323","   9"
"2404","lassen","2020-05-10","   1","   25","   0","  0","   24","   0"
"2405","sacramento","2020-05-10","  55"," 2310"," 105"," 18"," 2255","  87"
"2406","amador","2020-05-11","   0","   51","   2","  0","   51","   2"
"2407","mono","2020-05-11","   0","   17","   2","  0","   17","   2"
"2408","santa barbara","2020-05-11","  32","  717","  89"," 12","  685","  77"
"2409","placer","2020-05-11","  24","  753","  36","  4","  729","  32"
"2410","trinity","2020-05-11","   0","   54","   0","  0","   54","   0"
"2411","colusa","2020-05-11","   0","   88","   6","  0","   88","   6"
"2412","yuba","2020-05-11","   1","  445","   9","  1","  444","   8"
"2413","del norte","2020-05-11","   0","   51","   0","  0","   51","   0"
"2414","sutter","2020-05-11","   0","   14","   0","  0","   14","   0"
"2415","plumas","2020-05-11","   1","   45","   0","  0","   44","   0"
"2416","yolo","2020-05-11","   0","  186","   4","  0","  186","   4"
"2417","siskiyou","2020-05-11","   0","   65","   5","  0","   65","   5"
"2418","sacramento","2020-05-11","  51"," 2335","  93"," 14"," 2284","  79"
"2419","monterey","2020-05-11","   9","  829"," 109","  5","  820"," 104"
"2420","sonoma","2020-05-11","  14","  871","  50","  6","  857","  44"
"2421","mendocino","2020-05-11","   0","  180","   5","  0","  180","   5"
"2422","humboldt","2020-05-11","   8","  352","   5","  0","  344","   5"
"2423","glenn","2020-05-11","   0","    0","   0","  0","    0","   0"
"2424","solano","2020-05-11","  28","  707","  45"," 12","  679","  33"
"2425","marin","2020-05-11","  15","  390","  12","  2","  375","  10"
"2426","fresno","2020-05-11","  93"," 2057","  87"," 30"," 1964","  57"
"2427","alameda","2020-05-11"," 131"," 2446"," 125"," 49"," 2315","  76"
"2428","riverside","2020-05-11"," 290"," 3935"," 184","103"," 3645","  81"
"2429","san mateo","2020-05-11","  49"," 1096","  43"," 17"," 1047","  26"
"2430","los angeles","2020-05-11","2310","23866","1242","584","21556"," 658"
"2431","santa cruz","2020-05-11","   1","  397","  16","  0","  396","  16"
"2432","lake","2020-05-11","   0","  110","   5","  0","  110","   5"
"2433","san luis obispo","2020-05-11","   5","  526","  22","  3","  521","  19"
"2434","mariposa","2020-05-11","   0","   30","   0","  0","   30","   0"
"2435","lassen","2020-05-11","   1","   25","   0","  0","   24","   0"
"2436","merced","2020-05-11","   9","  242","   7","  6","  233","   1"
"2437","tehama","2020-05-11","   0","  106","   6","  0","  106","   6"
"2438","san francisco","2020-05-11","  91"," 2619"," 107"," 34"," 2528","  73"
"2439","madera","2020-05-11","   1","  528","  27","  0","  527","  27"
"2440","kings","2020-05-11","  17","  199","   4","  4","  182","   0"
"2441","shasta","2020-05-11","   0","  667","   9","  0","  667","   9"
"2442","napa","2020-05-11","   1","  387","  13","  1","  386","  12"
"2443","san bernardino","2020-05-11"," 218"," 4821"," 178"," 65"," 4603"," 113"
"2444","san joaquin","2020-05-11","  30"," 1366","  34","  7"," 1336","  27"
"2445","san diego","2020-05-11"," 400"," 6089"," 374","144"," 5689"," 230"
"2446","imperial","2020-05-11","  62","  323","  10"," 17","  261","  -7"
"2447","tuolumne","2020-05-11","   1","  151","   2","  0","  150","   2"
"2448","ventura","2020-05-11","  54"," 1301","  48"," 19"," 1247","  29"
"2449","inyo","2020-05-11","   1","   42","   3","  0","   41","   3"
"2450","el dorado","2020-05-11","   3","  171","   8","  0","  168","   8"
"2451","tulare","2020-05-11","  35","  920","  20"," 10","  885","  10"
"2452","nevada","2020-05-11","   1","  114","   7","  1","  113","   6"
"2453","stanislaus","2020-05-11","  35"," 1374","  74","  8"," 1339","  66"
"2454","kern","2020-05-11","  43"," 1724","  77"," 28"," 1681","  49"
"2455","santa clara","2020-05-11"," 100"," 3306"," 193"," 34"," 3206"," 159"
"2456","contra costa","2020-05-11","  54"," 1628"," 105"," 18"," 1574","  87"
"2457","modoc","2020-05-11","   0","   41","   0","  0","   41","   0"
"2458","orange","2020-05-11"," 320"," 6836"," 362","110"," 6516"," 252"
"2459","calaveras","2020-05-11","   1","   50","   8","  1","   49","   7"
"2460","san benito","2020-05-11","   1","   25","   2","  0","   24","   2"
"2461","butte","2020-05-11","   3","  448","  25","  0","  445","  25"
"2462","inyo","2020-05-12","   0","   42","   4","  0","   42","   4"
"2463","colusa","2020-05-12","   1","   88","   5","  1","   87","   4"
"2464","santa clara","2020-05-12","  84"," 3306"," 180"," 29"," 3222"," 151"
"2465","los angeles","2020-05-12","2248","23941","1267","583","21693"," 684"
"2466","monterey","2020-05-12","   7","  829"," 106","  5","  822"," 101"
"2467","butte","2020-05-12","   5","  448","  25","  1","  443","  24"
"2468","san diego","2020-05-12"," 385"," 6136"," 357","142"," 5751"," 215"
"2469","san bernardino","2020-05-12"," 197"," 4821"," 180"," 58"," 4624"," 122"
"2470","kern","2020-05-12","  52"," 1729","  72"," 29"," 1677","  43"
"2471","stanislaus","2020-05-12","  34"," 1369","  81","  3"," 1335","  78"
"2472","fresno","2020-05-12"," 110"," 2061","  84"," 23"," 1951","  61"
"2473","sacramento","2020-05-12","  48"," 2373","  94"," 13"," 2325","  81"
"2474","orange","2020-05-12"," 348"," 6836"," 358","102"," 6488"," 256"
"2475","sutter","2020-05-12","   0","   14","   0","  0","   14","   0"
"2476","mendocino","2020-05-12","   0","  180","   4","  0","  180","   4"
"2477","calaveras","2020-05-12","   0","   50","   8","  0","   50","   8"
"2478","tulare","2020-05-12","  34","  920","  17"," 11","  886","   6"
"2479","san benito","2020-05-12","   1","   25","   2","  0","   24","   2"
"2480","alameda","2020-05-12"," 130"," 2446"," 116"," 46"," 2316","  70"
"2481","modoc","2020-05-12","   0","   41","   0","  0","   41","   0"
"2482","contra costa","2020-05-12","  66"," 1628"," 121"," 19"," 1562"," 102"
"2483","solano","2020-05-12","  29","  707","  48"," 15","  678","  33"
"2484","napa","2020-05-12","   1","  387","   6","  1","  386","   5"
"2485","glenn","2020-05-12","   0","    0","   0","  0","    0","   0"
"2486","amador","2020-05-12","   0","   51","   1","  0","   51","   1"
"2487","riverside","2020-05-12"," 306"," 3924"," 172"," 96"," 3618","  76"
"2488","san joaquin","2020-05-12","  34"," 1366","  26","  8"," 1332","  18"
"2489","yuba","2020-05-12","   1","  445","  11","  1","  444","  10"
"2490","tehama","2020-05-12","   0","  106","   6","  0","  106","   6"
"2491","santa cruz","2020-05-12","   1","  397","  11","  0","  396","  11"
"2492","shasta","2020-05-12","   0","  667","   9","  0","  667","   9"
"2493","san mateo","2020-05-12","  63"," 1096","  35"," 20"," 1033","  15"
"2494","plumas","2020-05-12","   0","   45","   0","  0","   45","   0"
"2495","del norte","2020-05-12","   0","   51","   1","  0","   51","   1"
"2496","kings","2020-05-12","  20","  199","   0","  4","  179","  -4"
"2497","santa barbara","2020-05-12","  29","  717","  83"," 11","  688","  72"
"2498","nevada","2020-05-12","   0","  111","   5","  1","  111","   4"
"2499","imperial","2020-05-12","  63","  330","   8"," 19","  267"," -11"
"2500","mariposa","2020-05-12","   1","   30","   0","  0","   29","   0"
"2501","yolo","2020-05-12","   0","  186","   5","  0","  186","   5"
"2502","sonoma","2020-05-12","  28","  871","  49","  8","  843","  41"
"2503","el dorado","2020-05-12","   2","  199","  10","  0","  197","  10"
"2504","san luis obispo","2020-05-12","   8","  526","  28","  3","  518","  25"
"2505","merced","2020-05-12","  11","  242","   5","  5","  231","   0"
"2506","tuolumne","2020-05-12","   0","  151","   3","  0","  151","   3"
"2507","ventura","2020-05-12","  51"," 1319","  42"," 22"," 1268","  20"
"2508","trinity","2020-05-12","   0","   54","   0","  0","   54","   0"
"2509","lake","2020-05-12","   1","  110","   1","  1","  109","   0"
"2510","san francisco","2020-05-12","  90"," 2619"," 100"," 27"," 2529","  73"
"2511","mono","2020-05-12","   0","   17","   2","  0","   17","   2"
"2512","humboldt","2020-05-12","   8","  352","   6","  0","  344","   6"
"2513","placer","2020-05-12","  27","  753","  32","  5","  726","  27"
"2514","siskiyou","2020-05-12","   0","   65","   3","  1","   65","   2"
"2515","madera","2020-05-12","   0","  528","  31","  0","  528","  31"
"2516","lassen","2020-05-12","   0","   25","   0","  0","   25","   0"
"2517","marin","2020-05-12","  21","  390","  13","  1","  369","  12"
"2518","colusa","2020-05-13","   1","   88","   5","  1","   87","   4"
"2519","san bernardino","2020-05-13"," 223"," 4821"," 153"," 59"," 4598","  94"
"2520","los angeles","2020-05-13","2351","23951","1253","587","21600"," 666"
"2521","imperial","2020-05-13","  65","  317","   8"," 19","  252"," -11"
"2522","alameda","2020-05-13"," 140"," 2446"," 117"," 49"," 2306","  68"
"2523","contra costa","2020-05-13","  60"," 1628"," 108"," 15"," 1568","  93"
"2524","plumas","2020-05-13","   0","   45","   0","  0","   45","   0"
"2525","monterey","2020-05-13","   9","  829"," 106","  5","  820"," 101"
"2526","orange","2020-05-13"," 342"," 7007"," 393","127"," 6665"," 266"
"2527","amador","2020-05-13","   0","   51","   1","  0","   51","   1"
"2528","humboldt","2020-05-13","   8","  352","   5","  2","  344","   3"
"2529","modoc","2020-05-13","   0","   41","   0","  0","   41","   0"
"2530","san francisco","2020-05-13","  89"," 2619"," 108"," 31"," 2530","  77"
"2531","yuba","2020-05-13","   0","  445","  12","  0","  445","  12"
"2532","san diego","2020-05-13"," 380"," 6144"," 346","146"," 5764"," 200"
"2533","fresno","2020-05-13"," 129"," 2051","  78"," 23"," 1922","  55"
"2534","santa barbara","2020-05-13","  29","  717","  67"," 11","  688","  56"
"2535","merced","2020-05-13","  11","  242","  10","  4","  231","   6"
"2536","sutter","2020-05-13","   0","   14","   0","  0","   14","   0"
"2537","kings","2020-05-13","  20","  199","   0","  4","  179","  -4"
"2538","tuolumne","2020-05-13","   0","  151","   5","  0","  151","   5"
"2539","tulare","2020-05-13","  40","  920","  22"," 10","  880","  12"
"2540","trinity","2020-05-13","   0","   54","   0","  0","   54","   0"
"2541","inyo","2020-05-13","   0","   42","   4","  0","   42","   4"
"2542","shasta","2020-05-13","   0","  667","   5","  0","  667","   5"
"2543","san mateo","2020-05-13","  69"," 1096","  38"," 19"," 1027","  19"
"2544","el dorado","2020-05-13","   2","  199","  11","  0","  197","  11"
"2545","calaveras","2020-05-13","   0","   50","  11","  0","   50","  11"
"2546","san benito","2020-05-13","   1","   25","   1","  1","   24","   0"
"2547","yolo","2020-05-13","   1","  186","   6","  1","  185","   5"
"2548","sonoma","2020-05-13","  25","  871","  53","  4","  846","  49"
"2549","solano","2020-05-13","  34","  707","  41"," 11","  673","  30"
"2550","san joaquin","2020-05-13","  27"," 1366","  32","  5"," 1339","  27"
"2551","mono","2020-05-13","   0","   17","   2","  0","   17","   2"
"2552","madera","2020-05-13","   0","  528","  26","  0","  528","  26"
"2553","placer","2020-05-13","  30","  753","  37","  4","  723","  33"
"2554","mendocino","2020-05-13","   0","  180","   2","  0","  180","   2"
"2555","stanislaus","2020-05-13","  31"," 1369","  79","  3"," 1338","  76"
"2556","butte","2020-05-13","   5","  448","  19","  2","  443","  17"
"2557","marin","2020-05-13","  19","  390","  16","  1","  371","  15"
"2558","napa","2020-05-13","   1","  487","  10","  0","  486","  10"
"2559","kern","2020-05-13","  40"," 1718","  73"," 28"," 1678","  45"
"2560","sacramento","2020-05-13","  50"," 2371"," 105","  9"," 2321","  96"
"2561","riverside","2020-05-13"," 265"," 4002"," 180"," 88"," 3737","  92"
"2562","glenn","2020-05-13","   0","    0","   0","  0","    0","   0"
"2563","lassen","2020-05-13","   0","   25","   0","  0","   25","   0"
"2564","ventura","2020-05-13","  54"," 1312","  37"," 23"," 1258","  14"
"2565","siskiyou","2020-05-13","   1","   65","   5","  0","   64","   5"
"2566","tehama","2020-05-13","   0","  106","   5","  0","  106","   5"
"2567","del norte","2020-05-13","   0","   51","   3","  0","   51","   3"
"2568","nevada","2020-05-13","   0","  112","   7","  1","  112","   6"
"2569","lake","2020-05-13","   0","  110","   2","  1","  110","   1"
"2570","san luis obispo","2020-05-13","  10","  526","  24","  3","  516","  21"
"2571","santa cruz","2020-05-13","   1","  397","  15","  0","  396","  15"
"2572","mariposa","2020-05-13","   1","   30","   0","  0","   29","   0"
"2573","santa clara","2020-05-13","  91"," 3306"," 194"," 27"," 3215"," 167"
"2574","alameda","2020-05-14"," 138"," 2446"," 118"," 50"," 2308","  68"
"2575","solano","2020-05-14","  40","  707","  47"," 10","  667","  37"
"2576","sutter","2020-05-14","   0","   14","   0","  0","   14","   0"
"2577","kings","2020-05-14","  18","  199","   2","  4","  181","  -2"
"2578","orange","2020-05-14"," 327"," 7007"," 385","116"," 6680"," 269"
"2579","yolo","2020-05-14","   0","  186","   3","  0","  186","   3"
"2580","santa clara","2020-05-14","  91"," 3306"," 172"," 25"," 3215"," 147"
"2581","san joaquin","2020-05-14","  36"," 1366","  27"," 13"," 1330","  14"
"2582","san mateo","2020-05-14","  44"," 1096","  45"," 12"," 1052","  33"
"2583","modoc","2020-05-14","   0","   41","   0","  0","   41","   0"
"2584","placer","2020-05-14","  23","  753","  29","  3","  730","  26"
"2585","stanislaus","2020-05-14","  38"," 1369","  85","  3"," 1331","  82"
"2586","lake","2020-05-14","   0","  110","   2","  0","  110","   2"
"2587","calaveras","2020-05-14","   0","   50","  10","  0","   50","  10"
"2588","santa barbara","2020-05-14","  30","  717","  64"," 12","  687","  52"
"2589","mendocino","2020-05-14","   0","  180","   3","  0","  180","   3"
"2590","kern","2020-05-14","  44"," 1721","  58"," 23"," 1677","  35"
"2591","napa","2020-05-14","   1","  487","  10","  0","  486","  10"
"2592","fresno","2020-05-14"," 116"," 2134","  82"," 23"," 2018","  59"
"2593","shasta","2020-05-14","   0","  667","   8","  0","  667","   8"
"2594","los angeles","2020-05-14","2207","23919","1230","581","21712"," 649"
"2595","sonoma","2020-05-14","  28","  871","  51","  6","  843","  45"
"2596","ventura","2020-05-14","  58"," 1340","  48"," 27"," 1282","  21"
"2597","glenn","2020-05-14","   0","    0","   0","  0","    0","   0"
"2598","contra costa","2020-05-14","  67"," 1628"," 121"," 12"," 1561"," 109"
"2599","siskiyou","2020-05-14","   1","   65","   4","  0","   64","   4"
"2600","yuba","2020-05-14","   0","  445","  10","  0","  445","  10"
"2601","marin","2020-05-14","  12","  390","  12","  2","  378","  10"
"2602","sacramento","2020-05-14","  52"," 2393","  91"," 16"," 2341","  75"
"2603","san benito","2020-05-14","   1","   25","   1","  1","   24","   0"
"2604","imperial","2020-05-14","  71","  327","   6"," 20","  256"," -14"
"2605","trinity","2020-05-14","   0","   54","   0","  0","   54","   0"
"2606","madera","2020-05-14","   0","  528","  29","  0","  528","  29"
"2607","plumas","2020-05-14","   0","   45","   0","  0","   45","   0"
"2608","santa cruz","2020-05-14","   1","  397","  13","  0","  396","  13"
"2609","butte","2020-05-14","   3","  448","  19","  0","  445","  19"
"2610","del norte","2020-05-14","   0","   51","   5","  0","   51","   5"
"2611","mono","2020-05-14","   0","   17","   2","  0","   17","   2"
"2612","san francisco","2020-05-14","  94"," 2619"," 111"," 30"," 2525","  81"
"2613","amador","2020-05-14","   0","   51","   0","  0","   51","   0"
"2614","tuolumne","2020-05-14","   0","  151","   5","  0","  151","   5"
"2615","riverside","2020-05-14"," 275"," 4015"," 180"," 94"," 3740","  86"
"2616","monterey","2020-05-14","   7","  829"," 104","  5","  822","  99"
"2617","merced","2020-05-14","   9","  242","   5","  5","  233","   0"
"2618","lassen","2020-05-14","   0","   25","   0","  0","   25","   0"
"2619","humboldt","2020-05-14","  12","  352","   3","  2","  340","   1"
"2620","inyo","2020-05-14","   0","   42","   4","  0","   42","   4"
"2621","nevada","2020-05-14","   0","  110","   7","  1","  110","   6"
"2622","colusa","2020-05-14","   0","   88","   6","  0","   88","   6"
"2623","tulare","2020-05-14","  37","  920","  21"," 10","  883","  11"
"2624","san diego","2020-05-14"," 399"," 6151"," 354","155"," 5752"," 199"
"2625","san luis obispo","2020-05-14","   5","  526","  21","  1","  521","  20"
"2626","el dorado","2020-05-14","   3","  199","  11","  0","  196","  11"
"2627","san bernardino","2020-05-14"," 229"," 4821"," 182"," 62"," 4592"," 120"
"2628","mariposa","2020-05-14","   1","   30","   0","  0","   29","   0"
"2629","tehama","2020-05-14","   1","  106","   5","  0","  105","   5"
"2630","riverside","2020-05-15"," 256"," 4015"," 182"," 92"," 3759","  90"
"2631","san bernardino","2020-05-15"," 194"," 4821"," 168"," 65"," 4627"," 103"
"2632","kern","2020-05-15","  52"," 1721","  82"," 18"," 1669","  64"
"2633","sutter","2020-05-15","   0","   14","   0","  0","   14","   0"
"2634","tuolumne","2020-05-15","   0","  151","   3","  0","  151","   3"
"2635","contra costa","2020-05-15","  56"," 1628"," 114"," 16"," 1572","  98"
"2636","humboldt","2020-05-15","   9","  352","   6","  1","  343","   5"
"2637","san luis obispo","2020-05-15","   5","  526","  22","  3","  521","  19"
"2638","imperial","2020-05-15","  71","  262","   0"," 20","  191"," -20"
"2639","yuba","2020-05-15","   0","  445","  12","  0","  445","  12"
"2640","butte","2020-05-15","   4","  448","  14","  1","  444","  13"
"2641","santa cruz","2020-05-15","   1","  397","  13","  0","  396","  13"
"2642","san joaquin","2020-05-15","  45"," 1366","  28"," 16"," 1321","  12"
"2643","los angeles","2020-05-15","2201","23901","1229","571","21700"," 658"
"2644","modoc","2020-05-15","   0","   41","   0","  0","   41","   0"
"2645","lake","2020-05-15","   0","  110","   2","  0","  110","   2"
"2646","san diego","2020-05-15"," 392"," 6126"," 332","151"," 5734"," 181"
"2647","calaveras","2020-05-15","   1","   50","  10","  1","   49","   9"
"2648","colusa","2020-05-15","   0","   88","   6","  0","   88","   6"
"2649","el dorado","2020-05-15","   0","  199","  10","  0","  199","  10"
"2650","ventura","2020-05-15","  47"," 1340","  54"," 19"," 1293","  35"
"2651","fresno","2020-05-15","  91"," 2128","  81"," 18"," 2037","  63"
"2652","alameda","2020-05-15"," 148"," 2446"," 117"," 57"," 2298","  60"
"2653","nevada","2020-05-15","   0","  119","   7","  1","  119","   6"
"2654","yolo","2020-05-15","   0","  186","   3","  0","  186","   3"
"2655","amador","2020-05-15","   0","   51","   0","  0","   51","   0"
"2656","inyo","2020-05-15","   0","   42","   4","  0","   42","   4"
"2657","stanislaus","2020-05-15","  38"," 1369","  80","  5"," 1331","  75"
"2658","mendocino","2020-05-15","   0","  180","   4","  0","  180","   4"
"2659","lassen","2020-05-15","   0","   25","   0","  0","   25","   0"
"2660","san benito","2020-05-15","   1","   25","   1","  1","   24","   0"
"2661","tehama","2020-05-15","   1","  106","   4","  1","  105","   3"
"2662","madera","2020-05-15","   1","  528","  29","  0","  527","  29"
"2663","napa","2020-05-15","   1","  387","   6","  1","  386","   5"
"2664","glenn","2020-05-15","   0","    0","   0","  0","    0","   0"
"2665","santa barbara","2020-05-15","  32","  717","  64"," 14","  685","  50"
"2666","tulare","2020-05-15","  39","  920","  15","  9","  881","   6"
"2667","san francisco","2020-05-15","  89"," 2619","  85"," 23"," 2530","  62"
"2668","monterey","2020-05-15","   7","  829"," 109","  5","  822"," 104"
"2669","placer","2020-05-15","  29","  753","  32","  5","  724","  27"
"2670","kings","2020-05-15","  22","  199","   4","  3","  177","   1"
"2671","mono","2020-05-15","   0","   17","   2","  0","   17","   2"
"2672","mariposa","2020-05-15","   0","   30","   0","  0","   30","   0"
"2673","marin","2020-05-15","  10","  390","  11","  1","  380","  10"
"2674","shasta","2020-05-15","   0","  667","   7","  0","  667","   7"
"2675","trinity","2020-05-15","   0","   54","   0","  0","   54","   0"
"2676","sonoma","2020-05-15","  39","  871","  51","  4","  832","  47"
"2677","plumas","2020-05-15","   0","   45","   0","  0","   45","   0"
"2678","solano","2020-05-15","  40","  707","  50","  9","  667","  41"
"2679","del norte","2020-05-15","   0","   51","   2","  0","   51","   2"
"2680","merced","2020-05-15","   8","  242","   7","  4","  234","   3"
"2681","sacramento","2020-05-15","  55"," 2410"," 100"," 13"," 2355","  87"
"2682","siskiyou","2020-05-15","   0","   65","   5","  0","   65","   5"
"2683","san mateo","2020-05-15","  54"," 1096","  40"," 16"," 1042","  24"
"2684","orange","2020-05-15"," 310"," 7007"," 339","124"," 6697"," 215"
"2685","santa clara","2020-05-15","  75"," 3318"," 164"," 25"," 3243"," 139"
"2686","orange","2020-05-16"," 325"," 7007"," 345","121"," 6682"," 224"
"2687","santa clara","2020-05-16","  90"," 3318"," 177"," 28"," 3228"," 149"
"2688","mendocino","2020-05-16","   0","  180","   5","  0","  180","   5"
"2689","inyo","2020-05-16","   0","   42","   4","  0","   42","   4"
"2690","calaveras","2020-05-16","   0","   50","  10","  0","   50","  10"
"2691","glenn","2020-05-16","   0","    0","   0","  0","    0","   0"
"2692","marin","2020-05-16","  11","  390","  15","  0","  379","  15"
"2693","alameda","2020-05-16"," 145"," 2446"," 114"," 50"," 2301","  64"
"2694","sonoma","2020-05-16","  36","  871","  54","  2","  835","  52"
"2695","trinity","2020-05-16","   0","   54","   0","  0","   54","   0"
"2696","nevada","2020-05-16","   0","  113","   7","  2","  113","   5"
"2697","colusa","2020-05-16","   0","   88","   6","  0","   88","   6"
"2698","yuba","2020-05-16","   0","  445","  11","  0","  445","  11"
"2699","tehama","2020-05-16","   0","  106","   4","  0","  106","   4"
"2700","sutter","2020-05-16","   0","   14","   0","  0","   14","   0"
"2701","yolo","2020-05-16","   1","  186","   2","  0","  185","   2"
"2702","mono","2020-05-16","   0","   17","   2","  0","   17","   2"
"2703","fresno","2020-05-16","  97"," 2139","  85"," 20"," 2042","  65"
"2704","shasta","2020-05-16","   0","  667","   7","  0","  667","   7"
"2705","placer","2020-05-16","  28","  753","  38","  7","  725","  31"
"2706","san francisco","2020-05-16","  74"," 2619"," 106"," 24"," 2545","  82"
"2707","san bernardino","2020-05-16"," 201"," 4821"," 145"," 67"," 4620","  78"
"2708","santa cruz","2020-05-16","   1","  397","  15","  0","  396","  15"
"2709","kern","2020-05-16","  51"," 1713","  77"," 19"," 1662","  58"
"2710","riverside","2020-05-16"," 266"," 3957"," 194"," 85"," 3691"," 109"
"2711","butte","2020-05-16","   3","  448","  20","  1","  445","  19"
"2712","contra costa","2020-05-16","  50"," 1628"," 105"," 17"," 1578","  88"
"2713","napa","2020-05-16","   4","  387","   6","  1","  383","   5"
"2714","humboldt","2020-05-16","   7","  352","   5","  1","  345","   4"
"2715","mariposa","2020-05-16","   0","   30","   0","  0","   30","   0"
"2716","lake","2020-05-16","   0","  110","   2","  0","  110","   2"
"2717","imperial","2020-05-16","  61","  260","   8"," 18","  199"," -10"
"2718","ventura","2020-05-16","  50"," 1333","  47"," 21"," 1283","  26"
"2719","san luis obispo","2020-05-16","   6","  526","  25","  2","  520","  23"
"2720","el dorado","2020-05-16","   4","  199","   8","  1","  195","   7"
"2721","madera","2020-05-16","   0","  528","  28","  0","  528","  28"
"2722","tulare","2020-05-16","  41","  920","  14"," 10","  879","   4"
"2723","modoc","2020-05-16","   0","   41","   0","  0","   41","   0"
"2724","los angeles","2020-05-16","2086","23918","1207","563","21832"," 644"
"2725","del norte","2020-05-16","   0","   51","   2","  0","   51","   2"
"2726","san joaquin","2020-05-16","  30"," 1366","  21"," 12"," 1336","   9"
"2727","stanislaus","2020-05-16","  39"," 1369","  82","  3"," 1330","  79"
"2728","kings","2020-05-16","  22","  199","   2","  3","  177","  -1"
"2729","merced","2020-05-16","   7","  242","   4","  5","  235","  -1"
"2730","solano","2020-05-16","  40","  707","  46"," 10","  667","  36"
"2731","san benito","2020-05-16","   1","   25","   2","  1","   24","   1"
"2732","amador","2020-05-16","   0","   51","   2","  0","   51","   2"
"2733","siskiyou","2020-05-16","   1","   65","   3","  1","   64","   2"
"2734","san mateo","2020-05-16","  54"," 1096","  43"," 14"," 1042","  29"
"2735","lassen","2020-05-16","   0","   25","   0","  0","   25","   0"
"2736","monterey","2020-05-16","   9","  811"," 104","  4","  802"," 100"
"2737","sacramento","2020-05-16","  46"," 2370"," 100"," 12"," 2324","  88"
"2738","santa barbara","2020-05-16","  34","  717","  63"," 15","  683","  48"
"2739","tuolumne","2020-05-16","   0","  151","   6","  0","  151","   6"
"2740","plumas","2020-05-16","   0","   45","   0","  0","   45","   0"
"2741","san diego","2020-05-16"," 370"," 6144"," 326","153"," 5774"," 173"
"2742","inyo","2020-05-17","   0","   42","   4","  0","   42","   4"
"2743","sonoma","2020-05-17","  31","  871","  55","  3","  840","  52"
"2744","tuolumne","2020-05-17","   0","  151","   3","  0","  151","   3"
"2745","los angeles","2020-05-17","2107","23854","1233","575","21747"," 658"
"2746","imperial","2020-05-17","  71","  268","   5"," 18","  197"," -13"
"2747","calaveras","2020-05-17","   0","   50","  11","  0","   50","  11"
"2748","colusa","2020-05-17","   0","   88","   6","  0","   88","   6"
"2749","shasta","2020-05-17","   0","  667","   6","  1","  667","   5"
"2750","sacramento","2020-05-17","  56"," 2350"," 107"," 14"," 2294","  93"
"2751","humboldt","2020-05-17","   5","  352","   6","  1","  347","   5"
"2752","del norte","2020-05-17","   0","   51","   3","  0","   51","   3"
"2753","san luis obispo","2020-05-17","   5","  526","  21","  2","  521","  19"
"2754","madera","2020-05-17","   0","  528","  53","  0","  528","  53"
"2755","santa cruz","2020-05-17","   1","  397","  15","  0","  396","  15"
"2756","yolo","2020-05-17","   0","  186","   1","  2","  186","  -1"
"2757","san benito","2020-05-17","   1","   25","   1","  1","   24","   0"
"2758","solano","2020-05-17","  47","  707","  46"," 10","  660","  36"
"2759","stanislaus","2020-05-17","  41"," 1369","  85","  3"," 1328","  82"
"2760","modoc","2020-05-17","   1","   41","   0","  0","   40","   0"
"2761","napa","2020-05-17","   3","  387","   6","  1","  384","   5"
"2762","placer","2020-05-17","  27","  753","  38","  7","  726","  31"
"2763","kings","2020-05-17","  25","  199","   5","  5","  174","   0"
"2764","monterey","2020-05-17","  10","  811"," 102","  4","  801","  98"
"2765","tehama","2020-05-17","   0","  106","   3","  0","  106","   3"
"2766","sutter","2020-05-17","   0","   14","   0","  0","   14","   0"
"2767","santa clara","2020-05-17","  82"," 3318"," 192"," 25"," 3236"," 167"
"2768","plumas","2020-05-17","   0","   45","   0","  0","   45","   0"
"2769","siskiyou","2020-05-17","   1","   65","   3","  1","   64","   2"
"2770","marin","2020-05-17","  12","  390","  15","  0","  378","  15"
"2771","lake","2020-05-17","   0","  110","   1","  0","  110","   1"
"2772","nevada","2020-05-17","   0","  117","   7","  1","  117","   6"
"2773","glenn","2020-05-17","   0","    0","   0","  0","    0","   0"
"2774","lassen","2020-05-17","   0","   25","   0","  0","   25","   0"
"2775","mono","2020-05-17","   0","   17","   2","  0","   17","   2"
"2776","san francisco","2020-05-17","  71"," 2619"," 101"," 23"," 2548","  78"
"2777","mariposa","2020-05-17","   1","   30","   0","  0","   29","   0"
"2778","san diego","2020-05-17"," 380"," 6131"," 364","150"," 5751"," 214"
"2779","orange","2020-05-17"," 355"," 7007"," 341","135"," 6652"," 206"
"2780","kern","2020-05-17","  48"," 1743","  71"," 18"," 1695","  53"
"2781","san bernardino","2020-05-17"," 210"," 4821"," 184"," 67"," 4611"," 117"
"2782","mendocino","2020-05-17","   1","  180","   4","  1","  179","   3"
"2783","san mateo","2020-05-17","  55"," 1096","  40"," 15"," 1041","  25"
"2784","san joaquin","2020-05-17","  28"," 1366","  21"," 10"," 1338","  11"
"2785","trinity","2020-05-17","   0","   54","   0","  0","   54","   0"
"2786","yuba","2020-05-17","   1","  445","  10","  0","  444","  10"
"2787","amador","2020-05-17","   0","   51","   1","  0","   51","   1"
"2788","contra costa","2020-05-17","  55"," 1628"," 110"," 18"," 1573","  92"
"2789","riverside","2020-05-17"," 277"," 3945"," 187"," 86"," 3668"," 101"
"2790","el dorado","2020-05-17","   4","  199","  11","  2","  195","   9"
"2791","merced","2020-05-17","   9","  242","   4","  5","  233","  -1"
"2792","tulare","2020-05-17","  41","  881","  14"," 10","  840","   4"
"2793","alameda","2020-05-17"," 146"," 2446"," 125"," 53"," 2300","  72"
"2794","ventura","2020-05-17","  44"," 1314","  45"," 13"," 1270","  32"
"2795","fresno","2020-05-17"," 106"," 2133","  94"," 28"," 2027","  66"
"2796","santa barbara","2020-05-17","  31","  717","  62"," 16","  686","  46"
"2797","butte","2020-05-17","   2","  448","  22","  1","  446","  21"
"2798","placer","2020-05-18","  35","  753","  40","  4","  718","  36"
"2799","san mateo","2020-05-18","  60"," 1096","  41"," 15"," 1036","  26"
"2800","humboldt","2020-05-18","   5","  352","   3","  1","  347","   2"
"2801","kings","2020-05-18","  25","  199","   2","  6","  174","  -4"
"2802","santa clara","2020-05-18","  79"," 3318"," 201"," 22"," 3239"," 179"
"2803","siskiyou","2020-05-18","   0","   65","   4","  0","   65","   4"
"2804","napa","2020-05-18","   1","  387","  10","  2","  386","   8"
"2805","calaveras","2020-05-18","   0","   50","  11","  0","   50","  11"
"2806","yuba","2020-05-18","   1","  445","  13","  0","  444","  13"
"2807","plumas","2020-05-18","   0","   45","   0","  0","   45","   0"
"2808","imperial","2020-05-18","  74","  187","  11"," 17","  113","  -6"
"2809","madera","2020-05-18","   2","  528","   4","  0","  526","   4"
"2810","modoc","2020-05-18","   1","   41","   0","  0","   40","   0"
"2811","sutter","2020-05-18","   0","   14","   0","  0","   14","   0"
"2812","sacramento","2020-05-18","  71"," 2367"," 113"," 18"," 2296","  95"
"2813","stanislaus","2020-05-18","  38"," 1369","  77","  2"," 1331","  75"
"2814","mendocino","2020-05-18","   1","  180","   4","  1","  179","   3"
"2815","solano","2020-05-18","  43","  707","  42"," 11","  664","  31"
"2816","contra costa","2020-05-18","  70"," 1628"," 122"," 19"," 1558"," 103"
"2817","alameda","2020-05-18"," 138"," 2968"," 120"," 52"," 2830","  68"
"2818","mono","2020-05-18","   0","   17","   2","  0","   17","   2"
"2819","fresno","2020-05-18"," 105"," 2135","  99"," 19"," 2030","  80"
"2820","riverside","2020-05-18"," 281"," 3994"," 210"," 86"," 3713"," 124"
"2821","tehama","2020-05-18","   1","  106","   3","  0","  105","   3"
"2822","santa cruz","2020-05-18","   2","  397","  15","  0","  395","  15"
"2823","el dorado","2020-05-18","   4","  199","  13","  2","  195","  11"
"2824","san luis obispo","2020-05-18","   3","  526","  22","  2","  523","  20"
"2825","shasta","2020-05-18","   0","  667","   5","  0","  667","   5"
"2826","san diego","2020-05-18"," 378"," 6040"," 341","149"," 5662"," 192"
"2827","inyo","2020-05-18","   0","   42","   4","  0","   42","   4"
"2828","colusa","2020-05-18","   1","   88","   5","  1","   87","   4"
"2829","butte","2020-05-18","   3","  448","  22","  1","  445","  21"
"2830","san francisco","2020-05-18","  79"," 2619"," 115"," 31"," 2540","  84"
"2831","amador","2020-05-18","   1","   51","   4","  1","   50","   3"
"2832","tulare","2020-05-18","  36","  920","  29"," 10","  884","  19"
"2833","trinity","2020-05-18","   0","   54","   0","  0","   54","   0"
"2834","ventura","2020-05-18","  49"," 1307","  39"," 18"," 1258","  21"
"2835","tuolumne","2020-05-18","   0","  151","   1","  0","  151","   1"
"2836","santa barbara","2020-05-18","  27","  717","  70"," 14","  690","  56"
"2837","del norte","2020-05-18","   0","   51","   2","  0","   51","   2"
"2838","kern","2020-05-18","  48"," 1704","  72"," 18"," 1656","  54"
"2839","yolo","2020-05-18","   0","  186","   3","  0","  186","   3"
"2840","glenn","2020-05-18","   0","    0","   0","  0","    0","   0"
"2841","orange","2020-05-18"," 341"," 7007"," 387","123"," 6666"," 264"
"2842","san benito","2020-05-18","   1","   25","   1","  1","   24","   0"
"2843","merced","2020-05-18","   6","  242","   7","  5","  236","   2"
"2844","sonoma","2020-05-18","  23","  871","  53","  4","  848","  49"
"2845","marin","2020-05-18","  12","  390","  17","  3","  378","  14"
"2846","san joaquin","2020-05-18","  32"," 1366","  31","  9"," 1334","  22"
"2847","los angeles","2020-05-18","2051","23910","1221","570","21859"," 651"
"2848","san bernardino","2020-05-18"," 221"," 4821"," 197"," 66"," 4600"," 131"
"2849","mariposa","2020-05-18","   2","   30","   0","  0","   28","   0"
"2850","lake","2020-05-18","   2","  110","   3","  0","  108","   3"
"2851","nevada","2020-05-18","   0","  107","   8","  0","  107","   8"
"2852","lassen","2020-05-18","   1","   25","   0","  0","   24","   0"
"2853","monterey","2020-05-18","   9","  811"," 106","  4","  802"," 102"
"2854","orange","2020-05-19"," 366"," 7007"," 352","135"," 6641"," 217"
"2855","monterey","2020-05-19","  11","  811"," 102","  4","  800","  98"
"2856","ventura","2020-05-19","  60"," 1336","  41"," 19"," 1276","  22"
"2857","calaveras","2020-05-19","   0","   50","  11","  0","   50","  11"
"2858","san luis obispo","2020-05-19","   3","  526","  20","  2","  523","  18"
"2859","san diego","2020-05-19"," 387"," 6142"," 311","155"," 5755"," 156"
"2860","glenn","2020-05-19","   0","    0","   0","  0","    0","   0"
"2861","solano","2020-05-19","  47","  707","  42"," 12","  660","  30"
"2862","kern","2020-05-19","  53"," 1735","  72"," 21"," 1682","  51"
"2863","amador","2020-05-19","   0","   51","   3","  0","   51","   3"
"2864","marin","2020-05-19","  24","  390","  14","  2","  366","  12"
"2865","placer","2020-05-19","  48","  753","  38","  6","  705","  32"
"2866","tuolumne","2020-05-19","   0","  151","   1","  0","  151","   1"
"2867","san bernardino","2020-05-19"," 210"," 4821"," 206"," 75"," 4611"," 131"
"2868","kings","2020-05-19","  24","  199","   0","  6","  175","  -6"
"2869","napa","2020-05-19","   1","  387","  14","  2","  386","  12"
"2870","tulare","2020-05-19","  42","  920","  22"," 11","  878","  11"
"2871","lake","2020-05-19","   1","  110","   1","  1","  109","   0"
"2872","yolo","2020-05-19","   0","  186","   4","  0","  186","   4"
"2873","inyo","2020-05-19","   0","   42","   4","  0","   42","   4"
"2874","modoc","2020-05-19","   1","   41","   0","  0","   40","   0"
"2875","sutter","2020-05-19","   0","   14","   0","  0","   14","   0"
"2876","sacramento","2020-05-19"," 101"," 2392"," 115"," 16"," 2291","  99"
"2877","riverside","2020-05-19"," 292"," 3999"," 191","100"," 3707","  91"
"2878","shasta","2020-05-19","   0","  667","   4","  0","  667","   4"
"2879","los angeles","2020-05-19","2136","23675","1216","560","21539"," 656"
"2880","plumas","2020-05-19","   0","   45","   0","  0","   45","   0"
"2881","siskiyou","2020-05-19","   0","   65","   3","  0","   65","   3"
"2882","fresno","2020-05-19"," 107"," 2138","  88"," 24"," 2031","  64"
"2883","stanislaus","2020-05-19","  48"," 1369","  87","  5"," 1321","  82"
"2884","tehama","2020-05-19","   0","  106","   6","  0","  106","   6"
"2885","santa barbara","2020-05-19","  28","  717","  61"," 13","  689","  48"
"2886","mono","2020-05-19","   0","   17","   2","  0","   17","   2"
"2887","colusa","2020-05-19","   1","   88","   5","  1","   87","   4"
"2888","madera","2020-05-19","   1","  528","  23","  0","  527","  23"
"2889","merced","2020-05-19","   8","  242","   2","  4","  234","  -2"
"2890","del norte","2020-05-19","   0","   51","   1","  0","   51","   1"
"2891","san benito","2020-05-19","   1","   25","   1","  1","   24","   0"
"2892","sonoma","2020-05-19","  28","  871","  54","  4","  843","  50"
"2893","imperial","2020-05-19","  78","  200","  10"," 19","  122","  -9"
"2894","lassen","2020-05-19","   1","   25","   0","  0","   24","   0"
"2895","mariposa","2020-05-19","   3","   30","   0","  0","   27","   0"
"2896","trinity","2020-05-19","   0","   54","   0","  0","   54","   0"
"2897","san mateo","2020-05-19","  71"," 1096","  26"," 15"," 1025","  11"
"2898","alameda","2020-05-19"," 191"," 2968"," 122"," 56"," 2777","  66"
"2899","san francisco","2020-05-19","  74"," 2619"," 114"," 20"," 2545","  94"
"2900","contra costa","2020-05-19","  88"," 1628"," 117"," 17"," 1540"," 100"
"2901","humboldt","2020-05-19","   7","  352","   6","  1","  345","   5"
"2902","yuba","2020-05-19","   1","  445","  10","  0","  444","  10"
"2903","mendocino","2020-05-19","   1","  180","   6","  1","  179","   5"
"2904","santa cruz","2020-05-19","   1","  397","  13","  0","  396","  13"
"2905","el dorado","2020-05-19","   2","  199","  10","  2","  197","   8"
"2906","butte","2020-05-19","   1","  448","  23","  1","  447","  22"
"2907","san joaquin","2020-05-19","  33"," 1366","  27"," 12"," 1333","  15"
"2908","santa clara","2020-05-19"," 100"," 3318"," 195"," 22"," 3218"," 173"
"2909","nevada","2020-05-19","   0","  113","   9","  0","  113","   9"
"2910","riverside","2020-05-20"," 290"," 4010"," 144"," 95"," 3720","  49"
"2911","stanislaus","2020-05-20","  48"," 1369","  80","  8"," 1321","  72"
"2912","santa cruz","2020-05-20","   3","  397","  16","  0","  394","  16"
"2913","modoc","2020-05-20","   1","   41","   0","  0","   40","   0"
"2914","napa","2020-05-20","   1","  387","   6","  2","  386","   4"
"2915","kern","2020-05-20","  56"," 1735","  66"," 23"," 1679","  43"
"2916","kings","2020-05-20","  26","  199","   5","  5","  173","   0"
"2917","inyo","2020-05-20","   0","   42","   2","  0","   42","   2"
"2918","monterey","2020-05-20","  10","  811"," 103","  4","  801","  99"
"2919","butte","2020-05-20","   5","  448","  20","  2","  443","  18"
"2920","mono","2020-05-20","   0","   17","   2","  0","   17","   2"
"2921","san benito","2020-05-20","   1","   25","   0","  1","   24","  -1"
"2922","nevada","2020-05-20","   0","  116","   9","  0","  116","   9"
"2923","merced","2020-05-20","   9","  242","   1","  4","  233","  -3"
"2924","san bernardino","2020-05-20"," 216"," 4821"," 213"," 65"," 4605"," 148"
"2925","san mateo","2020-05-20","  74"," 1096","  25"," 17"," 1022","   8"
"2926","tehama","2020-05-20","   0","  106","   7","  0","  106","   7"
"2927","sacramento","2020-05-20"," 103"," 2378"," 106"," 17"," 2275","  89"
"2928","marin","2020-05-20","  29","  390","  20","  0","  361","  20"
"2929","colusa","2020-05-20","   0","   88","   6","  0","   88","   6"
"2930","lake","2020-05-20","   2","  110","   3","  0","  108","   3"
"2931","amador","2020-05-20","   0","   51","   2","  0","   51","   2"
"2932","contra costa","2020-05-20","  82"," 1628"," 128"," 15"," 1546"," 113"
"2933","tulare","2020-05-20","  45","  920","  21"," 12","  875","   9"
"2934","san francisco","2020-05-20","  79"," 2619"," 113"," 27"," 2540","  86"
"2935","trinity","2020-05-20","   0","   54","   0","  0","   54","   0"
"2936","mariposa","2020-05-20","   2","   30","   0","  0","   28","   0"
"2937","fresno","2020-05-20","  97"," 2140","  97"," 18"," 2043","  79"
"2938","orange","2020-05-20"," 388"," 7007"," 382","130"," 6619"," 252"
"2939","placer","2020-05-20","  56","  753","  45","  5","  697","  40"
"2940","plumas","2020-05-20","   0","   45","   0","  0","   45","   0"
"2941","lassen","2020-05-20","   1","   25","   0","  0","   24","   0"
"2942","tuolumne","2020-05-20","   0","  151","   4","  0","  151","   4"
"2943","sonoma","2020-05-20","  36","  871","  52","  4","  835","  48"
"2944","del norte","2020-05-20","   0","   51","   0","  0","   51","   0"
"2945","santa barbara","2020-05-20","  27","  717","  60"," 12","  690","  48"
"2946","ventura","2020-05-20","  62"," 1339","  39"," 21"," 1277","  18"
"2947","el dorado","2020-05-20","   2","  199","   7","  2","  197","   5"
"2948","imperial","2020-05-20","  83","  214","   8"," 22","  131"," -14"
"2949","san luis obispo","2020-05-20","   8","  526","  21","  3","  518","  18"
"2950","madera","2020-05-20","   4","  528","  21","  0","  524","  21"
"2951","mendocino","2020-05-20","   1","  180","   7","  1","  179","   6"
"2952","san diego","2020-05-20"," 404"," 6207"," 322","150"," 5803"," 172"
"2953","los angeles","2020-05-20","2067","23670","1253","539","21603"," 714"
"2954","san joaquin","2020-05-20","  38"," 1366","  27","  9"," 1328","  18"
"2955","sutter","2020-05-20","   0","   14","   0","  0","   14","   0"
"2956","glenn","2020-05-20","   0","    0","   0","  0","    0","   0"
"2957","santa clara","2020-05-20","  96"," 3318"," 170"," 21"," 3222"," 149"
"2958","humboldt","2020-05-20","  12","  352","   4","  2","  340","   2"
"2959","calaveras","2020-05-20","   0","   50","  10","  0","   50","  10"
"2960","alameda","2020-05-20"," 215"," 2968"," 112"," 63"," 2753","  49"
"2961","solano","2020-05-20","  55","  707","  44"," 11","  652","  33"
"2962","siskiyou","2020-05-20","   0","   65","   4","  0","   65","   4"
"2963","yolo","2020-05-20","   0","  186","   7","  0","  186","   7"
"2964","shasta","2020-05-20","   0","  667","   6","  0","  667","   6"
"2965","yuba","2020-05-20","   1","  445","  11","  0","  444","  11"
"2966","ventura","2020-05-21","  49"," 1329","  44"," 15"," 1280","  29"
"2967","napa","2020-05-21","   1","  387","   0","  2","  386","  -2"
"2968","tehama","2020-05-21","   0","  106","   8","  0","  106","   8"
"2969","lake","2020-05-21","   0","  110","   3","  0","  110","   3"
"2970","nevada","2020-05-21","   0","  112","   6","  0","  112","   6"
"2971","imperial","2020-05-21","  78","  210","  10"," 22","  132"," -12"
"2972","monterey","2020-05-21","   9","  811"," 103","  4","  802","  99"
"2973","lassen","2020-05-21","   1","   25","   0","  0","   24","   0"
"2974","glenn","2020-05-21","   0","    0","   0","  0","    0","   0"
"2975","colusa","2020-05-21","   0","   88","   6","  0","   88","   6"
"2976","yuba","2020-05-21","   1","  445","   8","  0","  444","   8"
"2977","placer","2020-05-21","  66","  753","  35","  9","  687","  26"
"2978","mono","2020-05-21","   0","   17","   2","  0","   17","   2"
"2979","stanislaus","2020-05-21","  52"," 1369","  82","  8"," 1317","  74"
"2980","sutter","2020-05-21","   0","   14","   0","  0","   14","   0"
"2981","kern","2020-05-21","  54"," 1728","  73"," 20"," 1674","  53"
"2982","shasta","2020-05-21","   0","  667","   5","  0","  667","   5"
"2983","san joaquin","2020-05-21","  31"," 1366","  28"," 13"," 1335","  15"
"2984","sacramento","2020-05-21"," 107"," 2409"," 108"," 18"," 2302","  90"
"2985","el dorado","2020-05-21","   2","  199","   6","  2","  197","   4"
"2986","calaveras","2020-05-21","   1","   50","   9","  1","   49","   8"
"2987","del norte","2020-05-21","   0","   51","   1","  0","   51","   1"
"2988","inyo","2020-05-21","   0","   42","   2","  0","   42","   2"
"2989","tulare","2020-05-21","  40","  920","   9","  9","  880","   0"
"2990","san benito","2020-05-21","   1","   25","   0","  1","   24","  -1"
"2991","humboldt","2020-05-21","  16","  352","   5","  3","  336","   2"
"2992","mendocino","2020-05-21","   1","  180","   7","  1","  179","   6"
"2993","alameda","2020-05-21"," 239"," 2968"," 114"," 62"," 2729","  52"
"2994","butte","2020-05-21","   9","  448","  17","  3","  439","  14"
"2995","orange","2020-05-21"," 364"," 6993"," 401","130"," 6629"," 271"
"2996","mariposa","2020-05-21","   0","   30","   0","  0","   30","   0"
"2997","trinity","2020-05-21","   0","   54","   0","  0","   54","   0"
"2998","santa cruz","2020-05-21","   5","  397","  14","  1","  392","  13"
"2999","contra costa","2020-05-21","  83"," 1628"," 118"," 17"," 1545"," 101"
"3000","san bernardino","2020-05-21"," 224"," 4821"," 225"," 63"," 4597"," 162"
"3001","sonoma","2020-05-21","  35","  871","  49","  8","  836","  41"
"3002","san diego","2020-05-21"," 378"," 6180"," 313","145"," 5802"," 168"
"3003","san luis obispo","2020-05-21","   7","  473","  20","  3","  466","  17"
"3004","san mateo","2020-05-21","  70"," 1096","  26"," 14"," 1026","  12"
"3005","riverside","2020-05-21"," 285"," 4020"," 129"," 82"," 3735","  47"
"3006","modoc","2020-05-21","   1","   41","   0","  0","   40","   0"
"3007","siskiyou","2020-05-21","   0","   65","   4","  0","   65","   4"
"3008","marin","2020-05-21","  33","  390","  18","  0","  357","  18"
"3009","los angeles","2020-05-21","2105","23620","1199","556","21515"," 643"
"3010","san francisco","2020-05-21","  80"," 2619"," 103"," 27"," 2539","  76"
"3011","santa clara","2020-05-21","  99"," 3318"," 167"," 24"," 3219"," 143"
"3012","plumas","2020-05-21","   0","   45","   0","  0","   45","   0"
"3013","fresno","2020-05-21"," 118"," 2144","  99"," 20"," 2026","  79"
"3014","santa barbara","2020-05-21","  30","  717","  58"," 10","  687","  48"
"3015","kings","2020-05-21","  25","  199","   2","  6","  174","  -4"
"3016","merced","2020-05-21","   6","  242","   3","  4","  236","  -1"
"3017","madera","2020-05-21","   0","  528","  18","  0","  528","  18"
"3018","amador","2020-05-21","   0","   51","   1","  0","   51","   1"
"3019","tuolumne","2020-05-21","   0","  151","   2","  0","  151","   2"
"3020","yolo","2020-05-21","   3","  186","   5","  1","  183","   4"
"3021","solano","2020-05-21","  53","  707","  45"," 13","  654","  32"
"3022","san mateo","2020-05-22","  52"," 1096","  40"," 14"," 1044","  26"
"3023","contra costa","2020-05-22","  41"," 1628"," 113"," 11"," 1587"," 102"
"3024","shasta","2020-05-22","   1","  667","  13","  0","  666","  13"
"3025","alameda","2020-05-22"," 160"," 2968"," 119"," 55"," 2808","  64"
"3026","imperial","2020-05-22","  77","  210","   9"," 23","  133"," -14"
"3027","yolo","2020-05-22","   0","  186","   7","  0","  186","   7"
"3028","san benito","2020-05-22","   1","   25","   1","  0","   24","   1"
"3029","mariposa","2020-05-22","   0","   30","   0","  0","   30","   0"
"3030","monterey","2020-05-22","  10","  811"," 104","  4","  801"," 100"
"3031","placer","2020-05-22","  26","  753","  42","  8","  727","  34"
"3032","amador","2020-05-22","   1","   51","   1","  0","   50","   1"
"3033","san luis obispo","2020-05-22","   3","  469","  21","  2","  466","  19"
"3034","mono","2020-05-22","   0","   17","   2","  0","   17","   2"
"3035","tulare","2020-05-22","  39","  881","  31"," 10","  842","  21"
"3036","colusa","2020-05-22","   0","   88","   6","  0","   88","   6"
"3037","el dorado","2020-05-22","   4","  199","   8","  3","  195","   5"
"3038","orange","2020-05-22"," 358"," 6993"," 397","145"," 6635"," 252"
"3039","santa cruz","2020-05-22","   5","  397","  11","  1","  392","  10"
"3040","san francisco","2020-05-22","  72"," 2619","  84"," 29"," 2547","  55"
"3041","humboldt","2020-05-22","  17","  352","   3","  2","  335","   1"
"3042","nevada","2020-05-22","   0","  119","   8","  0","  119","   8"
"3043","glenn","2020-05-22","   0","    0","   0","  0","    0","   0"
"3044","san diego","2020-05-22"," 381"," 6221"," 333","155"," 5840"," 178"
"3045","sonoma","2020-05-22","  21","  871","  47","  5","  850","  42"
"3046","marin","2020-05-22","   6","  390","  15","  2","  384","  13"
"3047","siskiyou","2020-05-22","   2","   65","   5","  1","   63","   4"
"3048","sacramento","2020-05-22","  23"," 2400"," 106","  4"," 2377"," 102"
"3049","kern","2020-05-22","  53"," 1761","  64"," 20"," 1708","  44"
"3050","yuba","2020-05-22","   1","  445","   4","  0","  444","   4"
"3051","los angeles","2020-05-22","2055","23628","1187","572","21573"," 615"
"3052","kings","2020-05-22","  28","  199","   4","  8","  171","  -4"
"3053","calaveras","2020-05-22","   0","   50","   9","  0","   50","   9"
"3054","tehama","2020-05-22","   0","  106","   7","  0","  106","   7"
"3055","sutter","2020-05-22","   0","   14","   0","  0","   14","   0"
"3056","trinity","2020-05-22","   0","   54","   0","  0","   54","   0"
"3057","merced","2020-05-22","   7","  242","   4","  4","  235","   0"
"3058","ventura","2020-05-22","  64"," 1345","  42"," 17"," 1281","  25"
"3059","santa clara","2020-05-22","  55"," 3318"," 170"," 20"," 3263"," 150"
"3060","solano","2020-05-22","  34","  707","  45","  7","  673","  38"
"3061","napa","2020-05-22","   8","  387","   0","  1","  379","  -1"
"3062","madera","2020-05-22","   1","  528","  21","  0","  527","  21"
"3063","stanislaus","2020-05-22","  34"," 1374","  81","  5"," 1340","  76"
"3064","fresno","2020-05-22","  94"," 2135","  89"," 26"," 2041","  63"
"3065","modoc","2020-05-22","   1","   41","   0","  0","   40","   0"
"3066","plumas","2020-05-22","   0","   45","   0","  0","   45","   0"
"3067","san joaquin","2020-05-22","  35"," 1366","  23"," 11"," 1331","  12"
"3068","butte","2020-05-22","   8","  448","  17","  2","  440","  15"
"3069","lassen","2020-05-22","   1","   25","   0","  0","   24","   0"
"3070","santa barbara","2020-05-22","  24","  717","  60","  9","  693","  51"
"3071","inyo","2020-05-22","   0","   42","   3","  0","   42","   3"
"3072","del norte","2020-05-22","   0","   51","   4","  0","   51","   4"
"3073","lake","2020-05-22","   2","  110","   3","  0","  108","   3"
"3074","san bernardino","2020-05-22"," 226"," 4821"," 218"," 55"," 4595"," 163"
"3075","riverside","2020-05-22"," 310"," 4029"," 130"," 80"," 3719","  50"
"3076","mendocino","2020-05-22","   1","  180","   6","  1","  179","   5"
"3077","tuolumne","2020-05-22","   0","  151","   2","  0","  151","   2"
"3078","mendocino","2020-05-23","   5","  180","   7","  0","  175","   7"
"3079","el dorado","2020-05-23","   6","  199","   3","  6","  193","  -3"
"3080","madera","2020-05-23","   0","  528","  21","  0","  528","  21"
"3081","amador","2020-05-23","   0","   51","   2","  0","   51","   2"
"3082","riverside","2020-05-23"," 288"," 3971"," 142"," 79"," 3683","  63"
"3083","siskiyou","2020-05-23","   2","   65","   5","  1","   63","   4"
"3084","santa cruz","2020-05-23","   5","  397","  10","  1","  392","   9"
"3085","alameda","2020-05-23"," 158"," 2968"," 110"," 60"," 2810","  50"
"3086","fresno","2020-05-23"," 103"," 2137","  85"," 27"," 2034","  58"
"3087","shasta","2020-05-23","   1","  667","  13","  0","  666","  13"
"3088","sacramento","2020-05-23","  24"," 2388"," 101","  3"," 2364","  98"
"3089","lassen","2020-05-23","   0","   25","   0","  0","   25","   0"
"3090","san francisco","2020-05-23","  73"," 2619","  83"," 27"," 2546","  56"
"3091","san benito","2020-05-23","   1","   25","   2","  0","   24","   2"
"3092","colusa","2020-05-23","   0","   88","   6","  0","   88","   6"
"3093","san luis obispo","2020-05-23","   2","  462","  27","  1","  460","  26"
"3094","los angeles","2020-05-23","2006","23605","1257","566","21599"," 691"
"3095","san diego","2020-05-23"," 386"," 6224"," 323","152"," 5838"," 171"
"3096","imperial","2020-05-23","  77","  210","   9"," 23","  133"," -14"
"3097","trinity","2020-05-23","   0","   54","   0","  0","   54","   0"
"3098","mono","2020-05-23","   0","   17","   2","  0","   17","   2"
"3099","kern","2020-05-23","  58"," 1727","  78"," 24"," 1669","  54"
"3100","placer","2020-05-23","  25","  753","  42","  8","  728","  34"
"3101","yuba","2020-05-23","   1","  445","   9","  0","  444","   9"
"3102","napa","2020-05-23","   2","  387","   2","  1","  385","   1"
"3103","del norte","2020-05-23","   0","   51","   0","  0","   51","   0"
"3104","lake","2020-05-23","   1","  110","   2","  1","  109","   1"
"3105","monterey","2020-05-23","   8","  811"," 104","  4","  803"," 100"
"3106","ventura","2020-05-23","  54"," 1318","  39"," 12"," 1264","  27"
"3107","mariposa","2020-05-23","   0","   30","   0","  0","   30","   0"
"3108","calaveras","2020-05-23","   0","   50","   9","  0","   50","   9"
"3109","tehama","2020-05-23","   0","  106","   6","  0","  106","   6"
"3110","contra costa","2020-05-23","  48"," 1628"," 100"," 12"," 1580","  88"
"3111","butte","2020-05-23","   5","  448","  20","  2","  443","  18"
"3112","san bernardino","2020-05-23"," 234"," 4821"," 207"," 62"," 4587"," 145"
"3113","nevada","2020-05-23","   0","  120","   4","  1","  120","   3"
"3114","plumas","2020-05-23","   0","   45","   0","  0","   45","   0"
"3115","kings","2020-05-23","  28","  199","   4","  8","  171","  -4"
"3116","tulare","2020-05-23","  41","  920","  13"," 10","  879","   3"
"3117","merced","2020-05-23","  11","  242","   4","  6","  231","  -2"
"3118","humboldt","2020-05-23","  17","  352","   3","  2","  335","   1"
"3119","inyo","2020-05-23","   0","   42","   4","  0","   42","   4"
"3120","solano","2020-05-23","  32","  707","  43","  6","  675","  37"
"3121","glenn","2020-05-23","   0","    0","   0","  0","    0","   0"
"3122","yolo","2020-05-23","   0","  186","   0","  2","  186","  -2"
"3123","san mateo","2020-05-23","  50"," 1096","  42"," 16"," 1046","  26"
"3124","modoc","2020-05-23","   1","   41","   0","  0","   40","   0"
"3125","santa clara","2020-05-23","  54"," 3318"," 178"," 19"," 3264"," 159"
"3126","tuolumne","2020-05-23","   0","  151","   1","  0","  151","   1"
"3127","sonoma","2020-05-23","  22","  871","  49","  5","  849","  44"
"3128","san joaquin","2020-05-23","  31"," 1366","  21"," 13"," 1335","   8"
"3129","orange","2020-05-23"," 372"," 6993"," 407","135"," 6621"," 272"
"3130","stanislaus","2020-05-23","  38"," 1369","  87","  8"," 1331","  79"
"3131","marin","2020-05-23","   6","  390","  15","  3","  384","  12"
"3132","santa barbara","2020-05-23","  24","  717","  66","  9","  693","  57"
"3133","sutter","2020-05-23","   0","   14","   0","  0","   14","   0"
"3134","kern","2020-05-24","  57"," 1712","  84"," 24"," 1655","  60"
"3135","trinity","2020-05-24","   0","   54","   0","  0","   54","   0"
"3136","santa barbara","2020-05-24","  27","  717","  71","  8","  690","  63"
"3137","nevada","2020-05-24","   0","  121","   1","  2","  121","  -1"
"3138","lake","2020-05-24","   4","  110","   0","  2","  106","  -2"
"3139","calaveras","2020-05-24","   1","   50","  10","  0","   49","  10"
"3140","sonoma","2020-05-24","  22","  871","  50","  6","  849","  44"
"3141","shasta","2020-05-24","   0","  667","  15","  0","  667","  15"
"3142","siskiyou","2020-05-24","   2","   65","   5","  1","   63","   4"
"3143","san bernardino","2020-05-24"," 242"," 4821"," 196"," 70"," 4579"," 126"
"3144","humboldt","2020-05-24","   7","  352","   5","  1","  345","   4"
"3145","yuba","2020-05-24","   1","  445","  13","  0","  444","  13"
"3146","riverside","2020-05-24"," 268"," 3944"," 150"," 78"," 3676","  72"
"3147","imperial","2020-05-24","  81","  210","   9"," 23","  129"," -14"
"3148","mariposa","2020-05-24","   0","   30","   0","  0","   30","   0"
"3149","contra costa","2020-05-24","  42"," 1628"," 102"," 11"," 1586","  91"
"3150","alameda","2020-05-24"," 149"," 2968"," 119"," 55"," 2819","  64"
"3151","marin","2020-05-24","   6","  390","  13","  3","  384","  10"
"3152","san francisco","2020-05-24","  88"," 2619","  97"," 30"," 2531","  67"
"3153","san mateo","2020-05-24","  52"," 1096","  43"," 16"," 1044","  27"
"3154","butte","2020-05-24","   5","  448","  20","  2","  443","  18"
"3155","modoc","2020-05-24","   1","   41","   0","  0","   40","   0"
"3156","solano","2020-05-24","  37","  707","  46","  8","  670","  38"
"3157","san joaquin","2020-05-24","  36"," 1366","  17"," 11"," 1330","   6"
"3158","mendocino","2020-05-24","   5","  180","   7","  0","  175","   7"
"3159","plumas","2020-05-24","   0","   45","   0","  0","   45","   0"
"3160","glenn","2020-05-24","   0","    0","   0","  0","    0","   0"
"3161","los angeles","2020-05-24","1990","23608","1227","549","21618"," 678"
"3162","fresno","2020-05-24"," 106"," 2128","  91"," 23"," 2022","  68"
"3163","merced","2020-05-24","  12","  242","   5","  5","  230","   0"
"3164","madera","2020-05-24","   1","  528","  22","  1","  527","  21"
"3165","santa clara","2020-05-24","  54"," 3318"," 195"," 18"," 3264"," 177"
"3166","san diego","2020-05-24"," 370"," 6189"," 321","150"," 5819"," 171"
"3167","el dorado","2020-05-24","   5","  199","   4","  5","  194","  -1"
"3168","kings","2020-05-24","  28","  199","   7"," 10","  171","  -3"
"3169","san luis obispo","2020-05-24","   3","  461","  28","  1","  458","  27"
"3170","stanislaus","2020-05-24","  37"," 1369","  85","  7"," 1332","  78"
"3171","sacramento","2020-05-24","  26"," 2363"," 110","  6"," 2337"," 104"
"3172","del norte","2020-05-24","   0","   51","   2","  0","   51","   2"
"3173","sutter","2020-05-24","   0","   14","   0","  0","   14","   0"
"3174","inyo","2020-05-24","   0","   42","   4","  0","   42","   4"
"3175","colusa","2020-05-24","   0","   88","   6","  0","   88","   6"
"3176","tehama","2020-05-24","   0","  106","   6","  0","  106","   6"
"3177","santa cruz","2020-05-24","   5","  397","  14","  1","  392","  13"
"3178","lassen","2020-05-24","   0","   25","   0","  0","   25","   0"
"3179","ventura","2020-05-24","  68"," 1331","  46"," 18"," 1263","  28"
"3180","tulare","2020-05-24","  44","  920","  13"," 11","  876","   2"
"3181","napa","2020-05-24","   1","  387","   2","  1","  386","   1"
"3182","mono","2020-05-24","   0","   17","   2","  0","   17","   2"
"3183","amador","2020-05-24","   0","   51","   0","  0","   51","   0"
"3184","placer","2020-05-24","  26","  753","  39","  9","  727","  30"
"3185","orange","2020-05-24"," 388"," 6993"," 404","131"," 6605"," 273"
"3186","tuolumne","2020-05-24","   0","  151","   1","  0","  151","   1"
"3187","yolo","2020-05-24","   0","  186","   0","  0","  186","   0"
"3188","monterey","2020-05-24","   8","  811"," 106","  4","  803"," 102"
"3189","san benito","2020-05-24","   1","   25","   0","  0","   24","   0"
"3190","lassen","2020-05-25","   0","   25","   0","  0","   25","   0"
"3191","mono","2020-05-25","   0","   17","   2","  0","   17","   2"
"3192","yuba","2020-05-25","   1","  445","  11","  0","  444","  11"
"3193","tehama","2020-05-25","   0","  106","   3","  0","  106","   3"
"3194","tuolumne","2020-05-25","   0","  151","   2","  0","  151","   2"
"3195","sacramento","2020-05-25","  26"," 2381"," 116"," 31"," 2355","  85"
"3196","san benito","2020-05-25","   1","   25","   0","  0","   24","   0"
"3197","madera","2020-05-25","   2","  528","  24","  0","  526","  24"
"3198","kings","2020-05-25","  29","  199","   3"," 10","  170","  -7"
"3199","calaveras","2020-05-25","   1","   50","  10","  0","   49","  10"
"3200","mendocino","2020-05-25","   2","  180","   5","  1","  178","   4"
"3201","merced","2020-05-25","  10","  242","  10","  5","  232","   5"
"3202","placer","2020-05-25","  25","  753","  47","  9","  728","  38"
"3203","stanislaus","2020-05-25","  29"," 1369","  79"," 10"," 1340","  69"
"3204","plumas","2020-05-25","   0","   45","   0","  0","   45","   0"
"3205","sutter","2020-05-25","   0","   14","   0","  0","   14","   0"
"3206","kern","2020-05-25","  59"," 1707","  77"," 26"," 1648","  51"
"3207","glenn","2020-05-25","   0","    0","   0","  0","    0","   0"
"3208","santa cruz","2020-05-25","   7","  397","  15","  1","  390","  14"
"3209","siskiyou","2020-05-25","   2","   65","   5","  1","   63","   4"
"3210","alameda","2020-05-25"," 156"," 2968"," 115"," 60"," 2812","  55"
"3211","san bernardino","2020-05-25"," 254"," 4821"," 245"," 71"," 4567"," 174"
"3212","shasta","2020-05-25","   0","  667","  16","  0","  667","  16"
"3213","san francisco","2020-05-25","  81"," 2619"," 100"," 32"," 2538","  68"
"3214","fresno","2020-05-25"," 104"," 2128","  92"," 20"," 2024","  72"
"3215","mariposa","2020-05-25","   1","   30","   0","  0","   29","   0"
"3216","amador","2020-05-25","   0","   51","   1","  0","   51","   1"
"3217","colusa","2020-05-25","   0","   88","   6","  0","   88","   6"
"3218","marin","2020-05-25","   7","  390","   9","  7","  383","   2"
"3219","modoc","2020-05-25","   1","   41","   0","  0","   40","   0"
"3220","san joaquin","2020-05-25","  36"," 1366","  22"," 10"," 1330","  12"
"3221","orange","2020-05-25"," 394"," 6993"," 441","138"," 6599"," 303"
"3222","del norte","2020-05-25","   1","   51","   3","  0","   50","   3"
"3223","solano","2020-05-25","  41","  707","  44"," 15","  666","  29"
"3224","yolo","2020-05-25","   1","  186","   4","  0","  185","   4"
"3225","san mateo","2020-05-25","  57"," 1096","  46"," 20"," 1039","  26"
"3226","napa","2020-05-25","   1","  387","   4","  1","  386","   3"
"3227","lake","2020-05-25","   1","  110","   2","  0","  109","   2"
"3228","butte","2020-05-25","   7","  448","  19","  3","  441","  16"
"3229","riverside","2020-05-25"," 281"," 3959"," 159"," 78"," 3678","  81"
"3230","tulare","2020-05-25","  42","  920","  22"," 15","  878","   7"
"3231","contra costa","2020-05-25","  48"," 1628"," 103"," 19"," 1580","  84"
"3232","santa barbara","2020-05-25","  27","  717","  70","  8","  690","  62"
"3233","monterey","2020-05-25","  10","  811"," 106","  3","  801"," 103"
"3234","imperial","2020-05-25","  75","  210","   9"," 23","  135"," -14"
"3235","nevada","2020-05-25","   0","  120","   6","  1","  120","   5"
"3236","inyo","2020-05-25","   0","   42","   4","  0","   42","   4"
"3237","los angeles","2020-05-25","2041","23620","1453","559","21579"," 894"
"3238","sonoma","2020-05-25","  27","  871","  46","  9","  844","  37"
"3239","san diego","2020-05-25"," 385"," 6158"," 385","160"," 5773"," 225"
"3240","ventura","2020-05-25","  63"," 1337","  46"," 14"," 1274","  32"
"3241","santa clara","2020-05-25","  52"," 3318"," 204"," 26"," 3266"," 178"
"3242","trinity","2020-05-25","   0","   54","   0","  0","   54","   0"
"3243","humboldt","2020-05-25","  10","  352","   4","  1","  342","   3"
"3244","san luis obispo","2020-05-25","   2","  448","  26","  1","  446","  25"
"3245","el dorado","2020-05-25","   4","  199","  11","  4","  195","   7"
"3246","butte","2020-05-26","   5","  448","  20","  3","  443","  17"
"3247","san mateo","2020-05-26","  54"," 1096","  47"," 20"," 1042","  27"
"3248","los angeles","2020-05-26","2087","23592","1449","567","21505"," 882"
"3249","alameda","2020-05-26"," 169"," 2968"," 124"," 57"," 2799","  67"
"3250","merced","2020-05-26","   9","  242","   5","  5","  233","   0"
"3251","kern","2020-05-26","  66"," 1724","  82"," 24"," 1658","  58"
"3252","yolo","2020-05-26","   1","  186","   5","  0","  185","   5"
"3253","inyo","2020-05-26","   0","   42","   4","  0","   42","   4"
"3254","trinity","2020-05-26","   3","   54","   0","  0","   51","   0"
"3255","santa barbara","2020-05-26","  23","  717","  84"," 10","  694","  74"
"3256","plumas","2020-05-26","   0","   45","   0","  0","   45","   0"
"3257","san diego","2020-05-26"," 383"," 6167"," 375","153"," 5784"," 222"
"3258","calaveras","2020-05-26","   0","   50","  11","  0","   50","  11"
"3259","el dorado","2020-05-26","   2","  199","   8","  2","  197","   6"
"3260","san benito","2020-05-26","   1","   25","   2","  0","   24","   2"
"3261","san luis obispo","2020-05-26","   4","  447","  28","  1","  443","  27"
"3262","lake","2020-05-26","   1","  110","   0","  0","  109","   0"
"3263","nevada","2020-05-26","   4","  129","   6","  3","  125","   3"
"3264","tehama","2020-05-26","   1","  106","   2","  0","  105","   2"
"3265","siskiyou","2020-05-26","   0","   65","   7","  0","   65","   7"
"3266","modoc","2020-05-26","   1","   41","   0","  0","   40","   0"
"3267","amador","2020-05-26","   0","   51","   3","  0","   51","   3"
"3268","shasta","2020-05-26","   1","  667","  13","  0","  666","  13"
"3269","monterey","2020-05-26","  12","  811"," 105","  4","  799"," 101"
"3270","ventura","2020-05-26","  62"," 1344","  40"," 16"," 1282","  24"
"3271","glenn","2020-05-26","   0","   47","   0","  0","   47","   0"
"3272","placer","2020-05-26","  27","  753","  43","  8","  726","  35"
"3273","mono","2020-05-26","   0","   17","   2","  0","   17","   2"
"3274","fresno","2020-05-26","  98"," 2141","  96"," 22"," 2043","  74"
"3275","santa clara","2020-05-26","  53"," 3318"," 195"," 26"," 3265"," 169"
"3276","contra costa","2020-05-26","  49"," 1628"," 115"," 20"," 1579","  95"
"3277","lassen","2020-05-26","   1","   25","   0","  0","   24","   0"
"3278","mendocino","2020-05-26","   4","  180","   4","  1","  176","   3"
"3279","imperial","2020-05-26","  77","  210","  10"," 22","  133"," -12"
"3280","orange","2020-05-26"," 418"," 6993"," 439","137"," 6575"," 302"
"3281","tulare","2020-05-26","  41","  920","  19"," 12","  879","   7"
"3282","del norte","2020-05-26","   1","   51","   2","  0","   50","   2"
"3283","sutter","2020-05-26","   0","   14","   0","  0","   14","   0"
"3284","mariposa","2020-05-26","   2","   30","   0","  0","   28","   0"
"3285","napa","2020-05-26","   2","  387","   3","  1","  385","   2"
"3286","madera","2020-05-26","   5","  528","  22","  0","  523","  22"
"3287","santa cruz","2020-05-26","   5","  397","  14","  1","  392","  13"
"3288","sonoma","2020-05-26","  25","  871","  59","  6","  846","  53"
"3289","sacramento","2020-05-26","  18"," 2376","  98"," 30"," 2358","  68"
"3290","stanislaus","2020-05-26","  32"," 1369","  85"," 12"," 1337","  73"
"3291","yuba","2020-05-26","   1","  445","  12","  0","  444","  12"
"3292","kings","2020-05-26","  27","  199","   2"," 10","  172","  -8"
"3293","tuolumne","2020-05-26","   1","  151","   0","  1","  150","  -1"
"3294","san francisco","2020-05-26","  87"," 2619","  95"," 34"," 2532","  61"
"3295","marin","2020-05-26","   5","  390","   8","  6","  385","   2"
"3296","colusa","2020-05-26","   0","   88","   6","  0","   88","   6"
"3297","solano","2020-05-26","  35","  707","  45"," 11","  672","  34"
"3298","humboldt","2020-05-26","  10","  352","   3","  2","  342","   1"
"3299","san bernardino","2020-05-26"," 279"," 4821"," 237"," 76"," 4542"," 161"
"3300","san joaquin","2020-05-26","  43"," 1366","  24"," 14"," 1323","  10"
"3301","riverside","2020-05-26"," 309"," 3959"," 173"," 90"," 3650","  83"
"3302","solano","2020-05-27","  34","  707","  41"," 10","  673","  31"
"3303","colusa","2020-05-27","   0","   88","   6","  0","   88","   6"
"3304","tulare","2020-05-27","  41","  920","  13"," 13","  879","   0"
"3305","siskiyou","2020-05-27","   3","   65","   5","  1","   62","   4"
"3306","mono","2020-05-27","   0","   17","   2","  0","   17","   2"
"3307","yolo","2020-05-27","   0","  186","   3","  0","  186","   3"
"3308","santa barbara","2020-05-27","  27","  717","  94"," 11","  690","  83"
"3309","shasta","2020-05-27","   0","  667","  15","  0","  667","  15"
"3310","imperial","2020-05-27","  84","  210","  13"," 14","  126","  -1"
"3311","san bernardino","2020-05-27"," 260"," 4821"," 222"," 73"," 4561"," 149"
"3312","calaveras","2020-05-27","   0","   50","  11","  0","   50","  11"
"3313","plumas","2020-05-27","   0","   45","   0","  0","   45","   0"
"3314","contra costa","2020-05-27","  41"," 1628"," 115"," 13"," 1587"," 102"
"3315","stanislaus","2020-05-27","  25"," 1369","  89","  9"," 1344","  80"
"3316","santa cruz","2020-05-27","   3","  397","  15","  1","  394","  14"
"3317","inyo","2020-05-27","   0","   42","   4","  0","   42","   4"
"3318","modoc","2020-05-27","   0","   41","   0","  0","   41","   0"
"3319","glenn","2020-05-27","   0","   47","   0","  0","   47","   0"
"3320","amador","2020-05-27","   0","   51","   3","  0","   51","   3"
"3321","yuba","2020-05-27","   1","  445","  12","  0","  444","  12"
"3322","riverside","2020-05-27"," 313"," 4005"," 131"," 87"," 3692","  44"
"3323","kern","2020-05-27","  68"," 1727","  72"," 28"," 1659","  44"
"3324","tehama","2020-05-27","   0","  106","   3","  0","  106","   3"
"3325","san benito","2020-05-27","   1","   25","   1","  0","   24","   1"
"3326","napa","2020-05-27","   2","  387","   2","  1","  385","   1"
"3327","kings","2020-05-27","  24","  199","   0","  7","  175","  -7"
"3328","nevada","2020-05-27","   4","  122","   6","  3","  118","   3"
"3329","trinity","2020-05-27","   2","   54","   0","  0","   52","   0"
"3330","mariposa","2020-05-27","   2","   30","   0","  0","   28","   0"
"3331","monterey","2020-05-27","  11","  811"," 100","  3","  800","  97"
"3332","humboldt","2020-05-27","   9","  352","   3","  1","  343","   2"
"3333","placer","2020-05-27","  20","  753","  45","  4","  733","  41"
"3334","san joaquin","2020-05-27","  37"," 1366","  21"," 11"," 1329","  10"
"3335","merced","2020-05-27","   8","  242","   3","  4","  234","  -1"
"3336","sacramento","2020-05-27","  29"," 2401","  87","  9"," 2372","  78"
"3337","alameda","2020-05-27"," 164"," 2968"," 128"," 47"," 2804","  81"
"3338","madera","2020-05-27","   4","  528","  24","  0","  524","  24"
"3339","marin","2020-05-27","   2","  390","  10","  1","  388","   9"
"3340","santa clara","2020-05-27","  52"," 3318"," 188"," 15"," 3266"," 173"
"3341","del norte","2020-05-27","   0","   51","   4","  0","   51","   4"
"3342","mendocino","2020-05-27","   4","  180","   3","  2","  176","   1"
"3343","san luis obispo","2020-05-27","   6","  464","  22","  3","  458","  19"
"3344","orange","2020-05-27"," 418"," 6993"," 403","144"," 6575"," 259"
"3345","san mateo","2020-05-27","  41"," 1096","  46"," 19"," 1055","  27"
"3346","lake","2020-05-27","   0","  110","   0","  0","  110","   0"
"3347","tuolumne","2020-05-27","   0","  151","   0","  0","  151","   0"
"3348","lassen","2020-05-27","   1","   25","   0","  0","   24","   0"
"3349","san francisco","2020-05-27","  82"," 2619","  98"," 27"," 2537","  71"
"3350","butte","2020-05-27","   7","  448","  21","  3","  441","  18"
"3351","sutter","2020-05-27","   0","   14","   0","  0","   14","   0"
"3352","sonoma","2020-05-27","  31","  871","  51","  5","  840","  46"
"3353","san diego","2020-05-27"," 408"," 6215"," 315","156"," 5807"," 159"
"3354","ventura","2020-05-27","  52"," 1349","  40"," 20"," 1297","  20"
"3355","el dorado","2020-05-27","   3","  199","   7","  3","  196","   4"
"3356","fresno","2020-05-27"," 115"," 2143","  93"," 23"," 2028","  70"
"3357","los angeles","2020-05-27","2090","23626","1275","554","21536"," 721"
"3358","san diego","2020-05-28"," 383"," 6238"," 317","153"," 5855"," 164"
"3359","tulare","2020-05-28","  39","  920","   8"," 11","  881","  -3"
"3360","lake","2020-05-28","   1","  110","   0","  0","  109","   0"
"3361","modoc","2020-05-28","   0","   41","   0","  0","   41","   0"
"3362","inyo","2020-05-28","   0","   42","   4","  0","   42","   4"
"3363","sutter","2020-05-28","   0","   14","   0","  0","   14","   0"
"3364","ventura","2020-05-28","  47"," 1353","  54"," 19"," 1306","  35"
"3365","sacramento","2020-05-28","  41"," 2395","  95"," 12"," 2354","  83"
"3366","tehama","2020-05-28","   0","  106","   4","  0","  106","   4"
"3367","calaveras","2020-05-28","   1","   50","  10","  1","   49","   9"
"3368","santa clara","2020-05-28","  40"," 3318"," 180"," 15"," 3278"," 165"
"3369","kern","2020-05-28","  66"," 1744","  77"," 25"," 1678","  52"
"3370","yuba","2020-05-28","   1","  445","  11","  0","  444","  11"
"3371","lassen","2020-05-28","   1","   25","   0","  0","   24","   0"
"3372","san luis obispo","2020-05-28","   2","  475","  24","  2","  473","  22"
"3373","contra costa","2020-05-28","  51"," 1628"," 103"," 14"," 1577","  89"
"3374","san bernardino","2020-05-28"," 243"," 4821"," 186"," 70"," 4578"," 116"
"3375","mendocino","2020-05-28","   3","  180","   4","  1","  177","   3"
"3376","napa","2020-05-28","   2","  387","   1","  1","  385","   0"
"3377","marin","2020-05-28","  10","  390","  14","  1","  380","  13"
"3378","riverside","2020-05-28"," 301"," 4000"," 134"," 85"," 3699","  49"
"3379","san mateo","2020-05-28","  49"," 1096","  44"," 18"," 1047","  26"
"3380","madera","2020-05-28","   1","  528","  25","  0","  527","  25"
"3381","merced","2020-05-28","   8","  242","   4","  4","  234","   0"
"3382","solano","2020-05-28","  35","  707","  40","  8","  672","  32"
"3383","del norte","2020-05-28","   0","   51","   4","  0","   51","   4"
"3384","humboldt","2020-05-28","   9","  352","   5","  1","  343","   4"
"3385","yolo","2020-05-28","   0","  186","   8","  0","  186","   8"
"3386","santa cruz","2020-05-28","   3","  397","  13","  1","  394","  12"
"3387","santa barbara","2020-05-28","  26","  717","  74"," 12","  691","  62"
"3388","glenn","2020-05-28","   0","   47","   0","  0","   47","   0"
"3389","alameda","2020-05-28"," 153"," 2968"," 106"," 57"," 2815","  49"
"3390","orange","2020-05-28"," 397"," 6993"," 403","132"," 6596"," 271"
"3391","plumas","2020-05-28","   0","   45","   0","  0","   45","   0"
"3392","tuolumne","2020-05-28","   0","  151","   2","  0","  151","   2"
"3393","fresno","2020-05-28"," 107"," 2131","  82"," 18"," 2024","  64"
"3394","imperial","2020-05-28","  68","  199","  10"," 20","  131"," -10"
"3395","sonoma","2020-05-28","  38","  871","  46","  4","  833","  42"
"3396","shasta","2020-05-28","   0","  667","   9","  0","  667","   9"
"3397","trinity","2020-05-28","   3","   54","   0","  0","   51","   0"
"3398","san joaquin","2020-05-28","  40"," 1366","  16"," 10"," 1326","   6"
"3399","mono","2020-05-28","   0","   40","   2","  0","   40","   2"
"3400","butte","2020-05-28","   6","  448","  22","  3","  442","  19"
"3401","stanislaus","2020-05-28","  23"," 1369","  78","  7"," 1346","  71"
"3402","san francisco","2020-05-28","  91"," 2619","  83"," 29"," 2528","  54"
"3403","monterey","2020-05-28","  11","  811"," 101","  3","  800","  98"
"3404","mariposa","2020-05-28","   2","   30","   0","  0","   28","   0"
"3405","placer","2020-05-28","  23","  753","  33","  6","  730","  27"
"3406","los angeles","2020-05-28","2054","23608","1275","570","21554"," 705"
"3407","el dorado","2020-05-28","   6","  199","   8","  6","  193","   2"
"3408","amador","2020-05-28","   1","   51","   4","  0","   50","   4"
"3409","siskiyou","2020-05-28","   0","   65","   6","  0","   65","   6"
"3410","colusa","2020-05-28","   0","   88","   6","  0","   88","   6"
"3411","nevada","2020-05-28","   3","  128","   5","  2","  125","   3"
"3412","kings","2020-05-28","  25","  199","   2","  7","  174","  -5"
"3413","san benito","2020-05-28","   0","   25","   0","  0","   25","   0"
"3414","napa","2020-05-29","   0","  387","   4","  1","  387","   3"
"3415","san luis obispo","2020-05-29","   8","  469","  13","  6","  461","   7"
"3416","marin","2020-05-29","  10","  390","  19","  2","  380","  17"
"3417","humboldt","2020-05-29","  13","  352","   7","  0","  339","   7"
"3418","santa cruz","2020-05-29","  12","  397","  18","  1","  385","  17"
"3419","siskiyou","2020-05-29","   1","   65","   5","  0","   64","   5"
"3420","monterey","2020-05-29","  11","  811"," 116","  3","  800"," 113"
"3421","plumas","2020-05-29","   1","   45","   0","  0","   44","   0"
"3422","san bernardino","2020-05-29"," 229"," 4821"," 164"," 63"," 4592"," 101"
"3423","yuba","2020-05-29","   1","  445","  11","  0","  444","  11"
"3424","orange","2020-05-29"," 324"," 6993"," 409","108"," 6669"," 301"
"3425","butte","2020-05-29","   6","  448","  18","  2","  442","  16"
"3426","santa clara","2020-05-29","  48"," 3318"," 182"," 14"," 3270"," 168"
"3427","riverside","2020-05-29"," 270"," 3994"," 128"," 76"," 3724","  52"
"3428","solano","2020-05-29","  31","  707","  38"," 10","  676","  28"
"3429","lake","2020-05-29","   1","  110","   0","  0","  109","   0"
"3430","stanislaus","2020-05-29","  24"," 1370","  75","  9"," 1346","  66"
"3431","santa barbara","2020-05-29","  27","  717","  76"," 12","  690","  64"
"3432","san mateo","2020-05-29","  45"," 1096","  47"," 15"," 1051","  32"
"3433","sutter","2020-05-29","   0","   14","   0","  0","   14","   0"
"3434","tehama","2020-05-29","   0","  106","   1","  0","  106","   1"
"3435","san diego","2020-05-29"," 358"," 6192"," 291","154"," 5834"," 137"
"3436","yolo","2020-05-29","   0","  186","   5","  0","  186","   5"
"3437","nevada","2020-05-29","   2","  130","   8","  0","  128","   8"
"3438","san francisco","2020-05-29","  65"," 2619","  88"," 25"," 2554","  63"
"3439","ventura","2020-05-29","  47"," 1352","  47"," 16"," 1305","  31"
"3440","mariposa","2020-05-29","   2","   30","   0","  0","   28","   0"
"3441","madera","2020-05-29","   0","  528","  22","  0","  528","  22"
"3442","calaveras","2020-05-29","   2","   50","   9","  2","   48","   7"
"3443","inyo","2020-05-29","   0","   42","   3","  0","   42","   3"
"3444","mono","2020-05-29","   0","   40","   2","  0","   40","   2"
"3445","glenn","2020-05-29","   0","   47","   0","  0","   47","   0"
"3446","tulare","2020-05-29","  40","  920","  17"," 13","  880","   4"
"3447","kings","2020-05-29","  28","  199","   2","  7","  171","  -5"
"3448","lassen","2020-05-29","   1","   25","   0","  0","   24","   0"
"3449","alameda","2020-05-29"," 179"," 2968"," 118"," 54"," 2789","  64"
"3450","contra costa","2020-05-29","  50"," 1628"," 101"," 11"," 1578","  90"
"3451","kern","2020-05-29","  70"," 1741","  70"," 29"," 1671","  41"
"3452","del norte","2020-05-29","   0","   51","   3","  0","   51","   3"
"3453","mendocino","2020-05-29","   2","  180","   3","  1","  178","   2"
"3454","san benito","2020-05-29","   0","   25","   1","  0","   25","   1"
"3455","tuolumne","2020-05-29","   0","  151","   2","  0","  151","   2"
"3456","san joaquin","2020-05-29","  41"," 1366","  17"," 11"," 1325","   6"
"3457","shasta","2020-05-29","   0","  667","   9","  0","  667","   9"
"3458","merced","2020-05-29","  13","  242","   5","  5","  229","   0"
"3459","amador","2020-05-29","   0","   51","   3","  0","   51","   3"
"3460","placer","2020-05-29","  23","  753","  35","  5","  730","  30"
"3461","modoc","2020-05-29","   0","   41","   0","  0","   41","   0"
"3462","colusa","2020-05-29","   0","   88","   6","  0","   88","   6"
"3463","imperial","2020-05-29","  64","  192","  11"," 18","  128","  -7"
"3464","el dorado","2020-05-29","   6","  199","   8","  4","  193","   4"
"3465","fresno","2020-05-29"," 107"," 2145","  86"," 22"," 2038","  64"
"3466","los angeles","2020-05-29","1972","23642","1258","549","21670"," 709"
"3467","sacramento","2020-05-29","  37"," 2416","  84"," 17"," 2379","  67"
"3468","trinity","2020-05-29","   0","   54","   0","  0","   54","   0"
"3469","sonoma","2020-05-29","  44","  871","  51","  8","  827","  43"
"3470","napa","2020-05-30","   4","  387","   1","  2","  383","  -1"
"3471","alameda","2020-05-30"," 146"," 2968"," 126"," 50"," 2822","  76"
"3472","solano","2020-05-30","  29","  707","  39","  9","  678","  30"
"3473","san luis obispo","2020-05-30","   5","  464","  13","  3","  459","  10"
"3474","stanislaus","2020-05-30","  22"," 1369","  77"," 10"," 1347","  67"
"3475","el dorado","2020-05-30","   7","  199","   8","  7","  192","   1"
"3476","mono","2020-05-30","   0","   40","   2","  0","   40","   2"
"3477","imperial","2020-05-30","  81","  217","   6"," 22","  136"," -16"
"3478","riverside","2020-05-30"," 269"," 3954"," 133"," 76"," 3685","  57"
"3479","monterey","2020-05-30","  11","  811","  95","  3","  800","  92"
"3480","nevada","2020-05-30","   1","  126","   8","  0","  125","   8"
"3481","lake","2020-05-30","   0","  110","   0","  0","  110","   0"
"3482","santa clara","2020-05-30","  46"," 3318"," 175"," 11"," 3272"," 164"
"3483","fresno","2020-05-30"," 118"," 2147","  89"," 19"," 2029","  70"
"3484","placer","2020-05-30","  22","  753","  42","  4","  731","  38"
"3485","san mateo","2020-05-30","  57"," 1096","  51"," 15"," 1039","  36"
"3486","mariposa","2020-05-30","   2","   30","   0","  0","   28","   0"
"3487","ventura","2020-05-30","  46"," 1332","  42"," 23"," 1286","  19"
"3488","contra costa","2020-05-30","  46"," 1628","  97"," 11"," 1582","  86"
"3489","plumas","2020-05-30","   1","   45","   0","  0","   44","   0"
"3490","orange","2020-05-30"," 422"," 6993"," 396","148"," 6571"," 248"
"3491","siskiyou","2020-05-30","   0","   65","   2","  1","   65","   1"
"3492","san francisco","2020-05-30","  64"," 2619","  78"," 25"," 2555","  53"
"3493","humboldt","2020-05-30","  17","  352","   4","  1","  335","   3"
"3494","sacramento","2020-05-30","  37"," 2402","  86"," 17"," 2365","  69"
"3495","tulare","2020-05-30","  39","  920","  19"," 14","  881","   5"
"3496","san bernardino","2020-05-30"," 225"," 4821"," 203"," 64"," 4596"," 139"
"3497","glenn","2020-05-30","   0","   47","   0","  0","   47","   0"
"3498","sonoma","2020-05-30","  61","  871","  46"," 12","  810","  34"
"3499","los angeles","2020-05-30","1934","23636","1288","540","21702"," 748"
"3500","del norte","2020-05-30","   0","   51","   3","  0","   51","   3"
"3501","mendocino","2020-05-30","   2","  180","   4","  1","  178","   3"
"3502","kings","2020-05-30","  28","  199","   0","  9","  171","  -9"
"3503","san diego","2020-05-30"," 397"," 6197"," 302","161"," 5800"," 141"
"3504","yolo","2020-05-30","   0","  186","   3","  0","  186","   3"
"3505","sutter","2020-05-30","   0","   14","   0","  0","   14","   0"
"3506","amador","2020-05-30","   0","   51","   4","  0","   51","   4"
"3507","inyo","2020-05-30","   0","   42","   3","  0","   42","   3"
"3508","calaveras","2020-05-30","   2","   50","   9","  2","   48","   7"
"3509","madera","2020-05-30","   3","  528","  17","  0","  525","  17"
"3510","colusa","2020-05-30","   0","   88","   6","  0","   88","   6"
"3511","shasta","2020-05-30","   1","  667","  10","  1","  666","   9"
"3512","tehama","2020-05-30","   0","  106","   8","  0","  106","   8"
"3513","san benito","2020-05-30","   0","   25","   2","  0","   25","   2"
"3514","yuba","2020-05-30","   1","  445","  12","  0","  444","  12"
"3515","kern","2020-05-30","  76"," 1564","  72"," 31"," 1488","  41"
"3516","san joaquin","2020-05-30","  42"," 1366","  15"," 14"," 1324","   1"
"3517","lassen","2020-05-30","   1","   25","   0","  0","   24","   0"
"3518","butte","2020-05-30","   6","  448","  24","  2","  442","  22"
"3519","santa cruz","2020-05-30","  12","  397","  18","  1","  385","  17"
"3520","santa barbara","2020-05-30","  26","  717","  90"," 10","  691","  80"
"3521","trinity","2020-05-30","   0","   54","   0","  0","   54","   0"
"3522","tuolumne","2020-05-30","   0","  151","   4","  0","  151","   4"
"3523","marin","2020-05-30","   8","  390","  18","  1","  382","  17"
"3524","modoc","2020-05-30","   0","   41","   0","  0","   41","   0"
"3525","merced","2020-05-30","  14","  242","   4","  4","  228","   0"
"3526","calaveras","2020-05-31","   1","   50","   9","  1","   49","   8"
"3527","yolo","2020-05-31","   0","  186","   3","  0","  186","   3"
"3528","placer","2020-05-31","  18","  753","  39","  3","  735","  36"
"3529","el dorado","2020-05-31","   7","  199","   4","  4","  192","   0"
"3530","san benito","2020-05-31","   0","   25","   2","  0","   25","   2"
"3531","orange","2020-05-31"," 407"," 6993"," 408","142"," 6586"," 266"
"3532","contra costa","2020-05-31","  43"," 1628","  94"," 12"," 1585","  82"
"3533","modoc","2020-05-31","   0","   41","   0","  0","   41","   0"
"3534","colusa","2020-05-31","   1","   88","   6","  0","   87","   6"
"3535","shasta","2020-05-31","   1","  667","  11","  1","  666","  10"
"3536","fresno","2020-05-31"," 120"," 2138","  83"," 28"," 2018","  55"
"3537","santa cruz","2020-05-31","  13","  397","  18","  1","  384","  17"
"3538","tuolumne","2020-05-31","   0","  151","   3","  0","  151","   3"
"3539","mono","2020-05-31","   0","   40","   2","  0","   40","   2"
"3540","tehama","2020-05-31","   0","  106","   7","  0","  106","   7"
"3541","kern","2020-05-31","  75"," 1732","  64"," 32"," 1657","  32"
"3542","plumas","2020-05-31","   1","   45","   0","  0","   44","   0"
"3543","solano","2020-05-31","  29","  707","  38","  6","  678","  32"
"3544","kings","2020-05-31","  30","  199","   0"," 10","  169"," -10"
"3545","mariposa","2020-05-31","   0","   30","   0","  0","   30","   0"
"3546","lake","2020-05-31","   1","  110","   0","  0","  109","   0"
"3547","imperial","2020-05-31","  80","  217","   6"," 22","  137"," -16"
"3548","lassen","2020-05-31","   1","   25","   0","  0","   24","   0"
"3549","del norte","2020-05-31","   1","   51","   4","  1","   50","   3"
"3550","sutter","2020-05-31","   0","   14","   0","  0","   14","   0"
"3551","sonoma","2020-05-31","  49","  871","  48"," 10","  822","  38"
"3552","glenn","2020-05-31","   0","   47","   0","  0","   47","   0"
"3553","tulare","2020-05-31","  36","  920","  13"," 13","  884","   0"
"3554","napa","2020-05-31","   2","  387","  11","  0","  385","  11"
"3555","stanislaus","2020-05-31","  33"," 1369","  85","  8"," 1336","  77"
"3556","madera","2020-05-31","   4","  528","  23","  1","  524","  22"
"3557","ventura","2020-05-31","  46"," 1329","  40"," 16"," 1283","  24"
"3558","trinity","2020-05-31","   1","   54","   0","  0","   53","   0"
"3559","humboldt","2020-05-31","  10","  352","   8","  0","  342","   8"
"3560","san diego","2020-05-31"," 398"," 6120"," 327","153"," 5722"," 174"
"3561","butte","2020-05-31","   5","  448","  22","  2","  443","  20"
"3562","marin","2020-05-31","   8","  390","  17","  1","  382","  16"
"3563","nevada","2020-05-31","   0","  127","   3","  0","  127","   3"
"3564","amador","2020-05-31","   0","   51","   0","  0","   51","   0"
"3565","alameda","2020-05-31"," 132"," 2968"," 131"," 45"," 2836","  86"
"3566","santa clara","2020-05-31","  38"," 3318"," 196"," 11"," 3280"," 185"
"3567","san bernardino","2020-05-31"," 209"," 4821"," 205"," 63"," 4612"," 142"
"3568","merced","2020-05-31","  11","  242","   5","  4","  231","   1"
"3569","los angeles","2020-05-31","1908","23606","1316","511","21698"," 805"
"3570","riverside","2020-05-31"," 294"," 3954"," 141"," 77"," 3660","  64"
"3571","siskiyou","2020-05-31","   0","   65","   1","  1","   65","   0"
"3572","yuba","2020-05-31","   1","  445","  12","  0","  444","  12"
"3573","inyo","2020-05-31","   0","   42","   4","  0","   42","   4"
"3574","san francisco","2020-05-31","  69"," 2619","  91"," 26"," 2550","  65"
"3575","sacramento","2020-05-31","  34"," 2393","  94","  9"," 2359","  85"
"3576","santa barbara","2020-05-31","  26","  717","  89","  9","  691","  80"
"3577","san luis obispo","2020-05-31","   4","  455","  20","  4","  451","  16"
"3578","monterey","2020-05-31","   9","  811","  98","  4","  802","  94"
"3579","san mateo","2020-05-31","  56"," 1096","  39"," 27"," 1040","  12"
"3580","san joaquin","2020-05-31","  45"," 1366","  18"," 14"," 1321","   4"
"3581","mendocino","2020-05-31","   1","  180","   2","  1","  179","   1"
"3582","san benito","2020-06-01","   0","   25","   3","  0","   25","   3"
"3583","madera","2020-06-01","   3","  528","  22","  1","  525","  21"
"3584","tuolumne","2020-06-01","   0","  151","   0","  0","  151","   0"
"3585","shasta","2020-06-01","   1","  667","   8","  1","  666","   7"
"3586","sutter","2020-06-01","   0","   14","   0","  0","   14","   0"
"3587","trinity","2020-06-01","   1","   54","   0","  0","   53","   0"
"3588","lake","2020-06-01","   2","  110","   2","  1","  108","   1"
"3589","calaveras","2020-06-01","   1","   50","   9","  1","   49","   8"
"3590","kern","2020-06-01","  77"," 1722","  69"," 33"," 1645","  36"
"3591","imperial","2020-06-01","  71","  193","   8"," 21","  122"," -13"
"3592","stanislaus","2020-06-01","  33"," 1369","  79","  8"," 1336","  71"
"3593","san mateo","2020-06-01","  46"," 1096","  42"," 11"," 1050","  31"
"3594","plumas","2020-06-01","   0","   45","   0","  0","   45","   0"
"3595","riverside","2020-06-01"," 307"," 3969"," 148"," 76"," 3662","  72"
"3596","marin","2020-06-01","   5","  390","  22","  1","  385","  21"
"3597","butte","2020-06-01","   4","  448","  17","  2","  444","  15"
"3598","tulare","2020-06-01","  35","  920","  14"," 12","  885","   2"
"3599","lassen","2020-06-01","   1","   25","   0","  0","   24","   0"
"3600","sacramento","2020-06-01","  32"," 2409"," 103"," 13"," 2377","  90"
"3601","nevada","2020-06-01","   1","  131","   6","  0","  130","   6"
"3602","napa","2020-06-01","   2","  387","   6","  0","  385","   6"
"3603","yuba","2020-06-01","   1","  445","  14","  0","  444","  14"
"3604","mendocino","2020-06-01","   1","  180","   2","  2","  179","   0"
"3605","kings","2020-06-01","  28","  199","   2","  8","  171","  -6"
"3606","yolo","2020-06-01","   0","  186","   4","  0","  186","   4"
"3607","san luis obispo","2020-06-01","   6","  454","  22","  3","  448","  19"
"3608","glenn","2020-06-01","   0","   47","   0","  0","   47","   0"
"3609","colusa","2020-06-01","   1","   88","   6","  0","   87","   6"
"3610","monterey","2020-06-01","   9","  811"," 100","  4","  802","  96"
"3611","mono","2020-06-01","   0","   40","   2","  0","   40","   2"
"3612","del norte","2020-06-01","   0","   51","   4","  0","   51","   4"
"3613","merced","2020-06-01","   8","  242","   5","  3","  234","   2"
"3614","placer","2020-06-01","  17","  753","  38","  3","  736","  35"
"3615","amador","2020-06-01","   0","   51","   4","  0","   51","   4"
"3616","solano","2020-06-01","  37","  707","  41","  9","  670","  32"
"3617","mariposa","2020-06-01","   0","   30","   0","  0","   30","   0"
"3618","siskiyou","2020-06-01","   3","   65","   5","  1","   62","   4"
"3619","santa cruz","2020-06-01","   4","  397","  18","  3","  393","  15"
"3620","alameda","2020-06-01"," 148"," 2968"," 134"," 46"," 2820","  88"
"3621","modoc","2020-06-01","   0","   41","   0","  0","   41","   0"
"3622","santa barbara","2020-06-01","  29","  717","  80"," 10","  688","  70"
"3623","humboldt","2020-06-01","  10","  352","   7","  0","  342","   7"
"3624","san francisco","2020-06-01","  74"," 2619","  85"," 20"," 2545","  65"
"3625","contra costa","2020-06-01","  30"," 1628"," 100"," 13"," 1598","  87"
"3626","el dorado","2020-06-01","   6","  199","   8","  4","  193","   4"
"3627","ventura","2020-06-01","  45"," 1317","  36"," 13"," 1272","  23"
"3628","fresno","2020-06-01"," 122"," 2142"," 393"," 23"," 2020"," 370"
"3629","orange","2020-06-01"," 405"," 6993"," 430","141"," 6588"," 289"
"3630","inyo","2020-06-01","   0","   42","   4","  0","   42","   4"
"3631","santa clara","2020-06-01","  40"," 3318"," 192"," 11"," 3278"," 181"
"3632","sonoma","2020-06-01","  67","  871","  50","  7","  804","  43"
"3633","san diego","2020-06-01"," 397"," 6121"," 317","166"," 5724"," 151"
"3634","los angeles","2020-06-01","2018","23614","1305","530","21596"," 775"
"3635","san bernardino","2020-06-01"," 217"," 4821"," 186"," 79"," 4604"," 107"
"3636","tehama","2020-06-01","   0","  106","   3","  0","  106","   3"
"3637","san joaquin","2020-06-01","  48"," 1366","  26"," 16"," 1318","  10"
"3638","contra costa","2020-06-02","  56"," 1628","  94"," 20"," 1572","  74"
"3639","humboldt","2020-06-02","   9","  352","   7","  0","  343","   7"
"3640","siskiyou","2020-06-02","   3","   65","   5","  1","   62","   4"
"3641","mono","2020-06-02","   0","   40","   2","  0","   40","   2"
"3642","san francisco","2020-06-02","  71"," 2647","  76"," 26"," 2576","  50"
"3643","sutter","2020-06-02","   0","   14","   0","  0","   14","   0"
"3644","alameda","2020-06-02"," 160"," 2968"," 131"," 38"," 2808","  93"
"3645","san mateo","2020-06-02","  59"," 1096","  31"," 18"," 1037","  13"
"3646","shasta","2020-06-02","   1","  667","   6","  1","  666","   5"
"3647","santa clara","2020-06-02","  49"," 3318"," 177"," 17"," 3269"," 160"
"3648","butte","2020-06-02","   6","  448","  15","  1","  442","  14"
"3649","placer","2020-06-02","  27","  753","  38","  4","  726","  34"
"3650","marin","2020-06-02","  11","  390","  17","  2","  379","  15"
"3651","merced","2020-06-02","   6","  242","   2","  3","  236","  -1"
"3652","el dorado","2020-06-02","   8","  199","   2","  6","  191","  -4"
"3653","lassen","2020-06-02","   1","   25","   0","  0","   24","   0"
"3654","mendocino","2020-06-02","   1","  180","   4","  1","  179","   3"
"3655","yuba","2020-06-02","   1","  445","  15","  0","  444","  15"
"3656","modoc","2020-06-02","   0","   41","   0","  0","   41","   0"
"3657","solano","2020-06-02","  32","  707","  41","  9","  675","  32"
"3658","amador","2020-06-02","   0","   51","   3","  0","   51","   3"
"3659","orange","2020-06-02"," 398"," 6993"," 388","148"," 6595"," 240"
"3660","monterey","2020-06-02","  12","  811","  98","  4","  799","  94"
"3661","del norte","2020-06-02","   0","   51","   2","  0","   51","   2"
"3662","san joaquin","2020-06-02","  52"," 1366","  20"," 15"," 1314","   5"
"3663","riverside","2020-06-02"," 305"," 3979"," 127"," 80"," 3674","  47"
"3664","ventura","2020-06-02","  46"," 1343","  34"," 19"," 1297","  15"
"3665","stanislaus","2020-06-02","  36"," 1374","  68"," 10"," 1338","  58"
"3666","napa","2020-06-02","   2","  387","   6","  0","  385","   6"
"3667","tuolumne","2020-06-02","   0","  151","   1","  0","  151","   1"
"3668","colusa","2020-06-02","   1","   88","   5","  1","   87","   4"
"3669","kern","2020-06-02","  82"," 1732","  67"," 34"," 1650","  33"
"3670","tehama","2020-06-02","   0","  106","   4","  0","  106","   4"
"3671","plumas","2020-06-02","   0","   45","   0","  0","   45","   0"
"3672","yolo","2020-06-02","   0","  186","   2","  0","  186","   2"
"3673","calaveras","2020-06-02","   1","   50","   8","  1","   49","   7"
"3674","inyo","2020-06-02","   0","   42","   4","  0","   42","   4"
"3675","san bernardino","2020-06-02"," 226"," 4821"," 189"," 76"," 4595"," 113"
"3676","los angeles","2020-06-02","2027","23620","1276","524","21593"," 752"
"3677","fresno","2020-06-02"," 101"," 2126","  90"," 18"," 2025","  72"
"3678","santa barbara","2020-06-02","  28","  717","  84","  9","  689","  75"
"3679","glenn","2020-06-02","   0","   47","   0","  0","   47","   0"
"3680","trinity","2020-06-02","   2","   54","   0","  0","   52","   0"
"3681","santa cruz","2020-06-02","   5","  397","  16","  1","  392","  15"
"3682","lake","2020-06-02","   2","  110","   0","  0","  108","   0"
"3683","kings","2020-06-02","  32","  199","   6","  8","  167","  -2"
"3684","sonoma","2020-06-02","  72","  871","  52","  7","  799","  45"
"3685","madera","2020-06-02","  10","  528","  19","  2","  518","  17"
"3686","san diego","2020-06-02"," 369"," 6143"," 301","158"," 5774"," 143"
"3687","tulare","2020-06-02","  34","  920","  25"," 12","  886","  13"
"3688","san luis obispo","2020-06-02","   4","  460","  23","  2","  456","  21"
"3689","nevada","2020-06-02","   1","  135","   7","  0","  134","   7"
"3690","sacramento","2020-06-02","  42"," 2405","  78"," 19"," 2363","  59"
"3691","mariposa","2020-06-02","   0","   30","   0","  0","   30","   0"
"3692","imperial","2020-06-02","  67","  237","   8"," 18","  170"," -10"
"3693","san benito","2020-06-02","   0","   25","   2","  0","   25","   2"
"3694","orange","2020-06-03"," 376"," 6993"," 387","134"," 6617"," 253"
"3695","san benito","2020-06-03","   0","   25","   2","  0","   25","   2"
"3696","placer","2020-06-03","  34","  753","  41","  4","  719","  37"
"3697","mariposa","2020-06-03","   0","   30","   0","  0","   30","   0"
"3698","san diego","2020-06-03"," 370"," 6214"," 288","158"," 5844"," 130"
"3699","butte","2020-06-03","   4","  448","  22","  0","  444","  22"
"3700","madera","2020-06-03","   0","  528","  19","  1","  528","  18"
"3701","fresno","2020-06-03","  97"," 2126","  88"," 19"," 2029","  69"
"3702","san mateo","2020-06-03","  66"," 1101","  36"," 21"," 1035","  15"
"3703","sutter","2020-06-03","   0","   14","   0","  0","   14","   0"
"3704","humboldt","2020-06-03","   6","  352","   7","  0","  346","   7"
"3705","kings","2020-06-03","  32","  199","   2","  7","  167","  -5"
"3706","contra costa","2020-06-03","  67"," 1628"," 101"," 16"," 1561","  85"
"3707","marin","2020-06-03","  11","  390","  19","  3","  379","  16"
"3708","inyo","2020-06-03","   0","   42","   4","  0","   42","   4"
"3709","glenn","2020-06-03","   0","   47","   0","  0","   47","   0"
"3710","shasta","2020-06-03","   1","  667","   4","  0","  666","   4"
"3711","sonoma","2020-06-03","  79","  871","  50"," 10","  792","  40"
"3712","ventura","2020-06-03","  43"," 1337","  34"," 13"," 1294","  21"
"3713","colusa","2020-06-03","   0","   88","   6","  0","   88","   6"
"3714","kern","2020-06-03","  75"," 1759","  74"," 36"," 1684","  38"
"3715","tehama","2020-06-03","   0","  106","   5","  0","  106","   5"
"3716","siskiyou","2020-06-03","   1","   65","   6","  1","   64","   5"
"3717","modoc","2020-06-03","   0","   41","   0","  0","   41","   0"
"3718","tulare","2020-06-03","  39","  920","   6","  8","  881","  -2"
"3719","san luis obispo","2020-06-03","   3","  466","  21","  3","  463","  18"
"3720","santa barbara","2020-06-03","  25","  717","  79"," 10","  692","  69"
"3721","stanislaus","2020-06-03","  41"," 1369","  75","  8"," 1328","  67"
"3722","napa","2020-06-03","   2","  387","   5","  0","  385","   5"
"3723","imperial","2020-06-03","  73","  237","   6"," 17","  164"," -11"
"3724","los angeles","2020-06-03","1990","23607","1239","513","21617"," 726"
"3725","merced","2020-06-03","   4","  242","   2","  3","  238","  -1"
"3726","san bernardino","2020-06-03"," 232"," 4821"," 178"," 85"," 4589","  93"
"3727","san francisco","2020-06-03","  71"," 2647","  80"," 21"," 2576","  59"
"3728","solano","2020-06-03","  23","  707","  48","  5","  684","  43"
"3729","lake","2020-06-03","   1","  110","   2","  0","  109","   2"
"3730","mono","2020-06-03","   0","   40","   1","  0","   40","   1"
"3731","plumas","2020-06-03","   0","   45","   0","  0","   45","   0"
"3732","trinity","2020-06-03","   2","   54","   0","  0","   52","   0"
"3733","sacramento","2020-06-03","  52"," 2418","  94"," 18"," 2366","  76"
"3734","riverside","2020-06-03"," 322"," 4001"," 137"," 85"," 3679","  52"
"3735","tuolumne","2020-06-03","   0","  151","   0","  0","  151","   0"
"3736","calaveras","2020-06-03","   1","   50","   8","  1","   49","   7"
"3737","monterey","2020-06-03","  12","  811","  96","  4","  799","  92"
"3738","santa cruz","2020-06-03","   3","  397","  12","  1","  394","  11"
"3739","lassen","2020-06-03","   1","   25","   0","  0","   24","   0"
"3740","santa clara","2020-06-03","  57"," 3318"," 184"," 14"," 3261"," 170"
"3741","amador","2020-06-03","   0","   51","   2","  0","   51","   2"
"3742","mendocino","2020-06-03","   1","  180","   3","  1","  179","   2"
"3743","san joaquin","2020-06-03","  60"," 1366","  21"," 15"," 1306","   6"
"3744","yuba","2020-06-03","   2","  445","  19","  0","  443","  19"
"3745","del norte","2020-06-03","   0","   51","   0","  0","   51","   0"
"3746","el dorado","2020-06-03","   7","  199","  10","  6","  192","   4"
"3747","yolo","2020-06-03","   0","  186","   3","  0","  186","   3"
"3748","nevada","2020-06-03","   0","  131","   6","  0","  131","   6"
"3749","alameda","2020-06-03"," 169"," 2968"," 144"," 38"," 2799"," 106"
"3750","mono","2020-06-04","   0","   40","   2","  0","   40","   2"
"3751","santa clara","2020-06-04","  75"," 3318"," 176"," 21"," 3243"," 155"
"3752","tehama","2020-06-04","   0","  106","   2","  0","  106","   2"
"3753","monterey","2020-06-04","  14","  811","  95","  3","  797","  92"
"3754","mendocino","2020-06-04","   1","  180","   2","  2","  179","   0"
"3755","amador","2020-06-04","   0","   51","   2","  0","   51","   2"
"3756","yolo","2020-06-04","   0","  186","   0","  0","  186","   0"
"3757","siskiyou","2020-06-04","   1","   65","   5","  0","   64","   5"
"3758","mariposa","2020-06-04","   0","   30","   0","  0","   30","   0"
"3759","glenn","2020-06-04","   0","   47","   0","  0","   47","   0"
"3760","san joaquin","2020-06-04","  55"," 1366","  18"," 15"," 1311","   3"
"3761","inyo","2020-06-04","   0","   42","   2","  0","   42","   2"
"3762","plumas","2020-06-04","   0","   45","   0","  0","   45","   0"
"3763","san francisco","2020-06-04","  62"," 2647","  87"," 19"," 2585","  68"
"3764","butte","2020-06-04","   4","  448","  22","  0","  444","  22"
"3765","santa barbara","2020-06-04","  38","  717","  65"," 11","  679","  54"
"3766","nevada","2020-06-04","   0","  125","   5","  0","  125","   5"
"3767","placer","2020-06-04","  46","  753","  47","  5","  707","  42"
"3768","sutter","2020-06-04","   0","   14","   0","  0","   14","   0"
"3769","san benito","2020-06-04","   0","   25","   2","  0","   25","   2"
"3770","stanislaus","2020-06-04","  45"," 1369","  78"," 10"," 1324","  68"
"3771","sacramento","2020-06-04","  61"," 2423"," 103"," 21"," 2362","  82"
"3772","madera","2020-06-04","   2","  528","  24","  1","  526","  23"
"3773","alameda","2020-06-04"," 174"," 2968"," 157"," 41"," 2794"," 116"
"3774","el dorado","2020-06-04","   6","  199","   7","  4","  193","   3"
"3775","tulare","2020-06-04","  41","  920","   3"," 10","  879","  -7"
"3776","orange","2020-06-04"," 410"," 6993"," 393","141"," 6583"," 252"
"3777","contra costa","2020-06-04","  88"," 1628"," 101"," 17"," 1540","  84"
"3778","riverside","2020-06-04"," 317"," 4025"," 122"," 93"," 3708","  29"
"3779","merced","2020-06-04","   7","  242","   4","  3","  235","   1"
"3780","napa","2020-06-04","   3","  397","   0","  1","  394","  -1"
"3781","lassen","2020-06-04","   1","   25","   0","  0","   24","   0"
"3782","modoc","2020-06-04","   0","   41","   0","  0","   41","   0"
"3783","del norte","2020-06-04","   0","   51","   1","  0","   51","   1"
"3784","yuba","2020-06-04","   3","  445","  14","  1","  442","  13"
"3785","colusa","2020-06-04","   0","   88","   6","  0","   88","   6"
"3786","tuolumne","2020-06-04","   1","  151","   0","  0","  150","   0"
"3787","los angeles","2020-06-04","2048","23715","1249","552","21667"," 697"
"3788","lake","2020-06-04","   4","  110","   1","  1","  106","   0"
"3789","san mateo","2020-06-04","  53"," 1101","  48"," 14"," 1048","  34"
"3790","trinity","2020-06-04","   1","   54","   0","  0","   53","   0"
"3791","kings","2020-06-04","  33","  199","   3","  7","  166","  -4"
"3792","humboldt","2020-06-04","   2","  352","   2","  2","  350","   0"
"3793","marin","2020-06-04","  10","  390","  13","  3","  380","  10"
"3794","ventura","2020-06-04","  50"," 1333","  34"," 12"," 1283","  22"
"3795","sonoma","2020-06-04","  58","  871","  51","  9","  813","  42"
"3796","imperial","2020-06-04","  77","  237","   4"," 18","  160"," -14"
"3797","san luis obispo","2020-06-04","   2","  464","  23","  2","  462","  21"
"3798","santa cruz","2020-06-04","   5","  397","  16","  1","  392","  15"
"3799","fresno","2020-06-04"," 101"," 2136","  95"," 19"," 2035","  76"
"3800","solano","2020-06-04","  31","  707","  48","  5","  676","  43"
"3801","shasta","2020-06-04","   2","  667","   5","  0","  665","   5"
"3802","kern","2020-06-04","  76"," 1756","  78"," 35"," 1680","  43"
"3803","san bernardino","2020-06-04"," 238"," 4821"," 169"," 81"," 4583","  88"
"3804","san diego","2020-06-04"," 379"," 6218"," 292","153"," 5839"," 139"
"3805","calaveras","2020-06-04","   0","   50","  10","  0","   50","  10"
"3806","colusa","2020-06-05","   0","   88","   6","  0","   88","   6"
"3807","san joaquin","2020-06-05","  59"," 1366","  14"," 17"," 1307","  -3"
"3808","butte","2020-06-05","   2","  448","  21","  1","  446","  20"
"3809","monterey","2020-06-05","  15","  811","  92","  3","  796","  89"
"3810","trinity","2020-06-05","   0","   54","   0","  0","   54","   0"
"3811","contra costa","2020-06-05","  63"," 1628"," 105"," 12"," 1565","  93"
"3812","merced","2020-06-05","   5","  242","   3","  2","  237","   1"
"3813","los angeles","2020-06-05","1998","23507","1210","548","21509"," 662"
"3814","santa barbara","2020-06-05","  37","  717","  82"," 12","  680","  70"
"3815","san mateo","2020-06-05","  54"," 1101","  47"," 10"," 1047","  37"
"3816","san diego","2020-06-05"," 368"," 6190"," 320","153"," 5822"," 167"
"3817","humboldt","2020-06-05","   1","  352","   1","  0","  351","   1"
"3818","shasta","2020-06-05","   0","  667","   4","  0","  667","   4"
"3819","kings","2020-06-05","  31","  199","   1","  7","  168","  -6"
"3820","kern","2020-06-05","  78"," 1756","  80"," 34"," 1678","  46"
"3821","madera","2020-06-05","   5","  528","  19","  3","  523","  16"
"3822","santa cruz","2020-06-05","   5","  397","   9","  1","  392","   8"
"3823","amador","2020-06-05","   0","   51","   2","  0","   51","   2"
"3824","yolo","2020-06-05","   0","  186","   3","  0","  186","   3"
"3825","mono","2020-06-05","   0","   40","   2","  0","   40","   2"
"3826","alameda","2020-06-05"," 150"," 2968"," 154"," 40"," 2818"," 114"
"3827","tulare","2020-06-05","  41","  920","   8","  7","  879","   1"
"3828","plumas","2020-06-05","   0","   45","   0","  0","   45","   0"
"3829","inyo","2020-06-05","   0","   42","   3","  0","   42","   3"
"3830","solano","2020-06-05","  33","  707","  45","  5","  674","  40"
"3831","san francisco","2020-06-05","  64"," 2658","  98"," 18"," 2594","  80"
"3832","siskiyou","2020-06-05","   1","   65","   6","  0","   64","   6"
"3833","sonoma","2020-06-05","  72","  871","  54"," 10","  799","  44"
"3834","tuolumne","2020-06-05","   1","  151","   2","  0","  150","   2"
"3835","tehama","2020-06-05","   0","  106","   4","  0","  106","   4"
"3836","napa","2020-06-05","   3","  397","   0","  1","  394","  -1"
"3837","fresno","2020-06-05","  97"," 2129","  91"," 19"," 2032","  72"
"3838","mariposa","2020-06-05","   0","   30","   0","  0","   30","   0"
"3839","yuba","2020-06-05","   3","  445","  13","  2","  442","  11"
"3840","ventura","2020-06-05","  50"," 1357","  45"," 12"," 1307","  33"
"3841","marin","2020-06-05","  11","  390","  16","  0","  379","  16"
"3842","sutter","2020-06-05","   0","   14","   0","  0","   14","   0"
"3843","san luis obispo","2020-06-05","   6","  483","  27","  2","  477","  25"
"3844","lake","2020-06-05","   1","  110","   2","  0","  109","   2"
"3845","calaveras","2020-06-05","   0","   50","  10","  0","   50","  10"
"3846","el dorado","2020-06-05","   5","  199","   8","  3","  194","   5"
"3847","sacramento","2020-06-05","  72"," 2424","  95"," 21"," 2352","  74"
"3848","stanislaus","2020-06-05","  39"," 1369","  76","  9"," 1330","  67"
"3849","san benito","2020-06-05","   0","   25","   1","  0","   25","   1"
"3850","placer","2020-06-05","  32","  753","  49","  7","  721","  42"
"3851","mendocino","2020-06-05","   1","  180","   2","  1","  179","   1"
"3852","glenn","2020-06-05","   0","   47","   0","  0","   47","   0"
"3853","modoc","2020-06-05","   0","   41","   0","  0","   41","   0"
"3854","santa clara","2020-06-05","  75"," 3375"," 206"," 24"," 3300"," 182"
"3855","imperial","2020-06-05","  82","  237","   7"," 15","  155","  -8"
"3856","orange","2020-06-05"," 395"," 6973"," 401","142"," 6578"," 259"
"3857","del norte","2020-06-05","   0","   51","   2","  0","   51","   2"
"3858","lassen","2020-06-05","   0","   25","   0","  0","   25","   0"
"3859","nevada","2020-06-05","   2","  130","   4","  0","  128","   4"
"3860","riverside","2020-06-05"," 326"," 4023"," 129"," 99"," 3697","  30"
"3861","san bernardino","2020-06-05"," 243"," 4821"," 140"," 75"," 4578","  65"
"3862","fresno","2020-06-06"," 111"," 2137","  88"," 19"," 2026","  69"
"3863","alameda","2020-06-06"," 155"," 2968"," 156"," 41"," 2813"," 115"
"3864","los angeles","2020-06-06","1981","23617","1233","506","21636"," 727"
"3865","imperial","2020-06-06","  83","  237","   7"," 19","  154"," -12"
"3866","mariposa","2020-06-06","   0","   30","   0","  0","   30","   0"
"3867","siskiyou","2020-06-06","   1","   65","   6","  0","   64","   6"
"3868","napa","2020-06-06","   4","  397","   0","  1","  393","  -1"
"3869","yuba","2020-06-06","   5","  445","  12","  2","  440","  10"
"3870","madera","2020-06-06","   8","  528","  22","  1","  520","  21"
"3871","san joaquin","2020-06-06","  64"," 1366","  16"," 16"," 1302","   0"
"3872","glenn","2020-06-06","   0","   47","   0","  0","   47","   0"
"3873","trinity","2020-06-06","   0","   54","   0","  0","   54","   0"
"3874","riverside","2020-06-06"," 309"," 3958"," 141"," 91"," 3649","  50"
"3875","san luis obispo","2020-06-06","   7","  449","  23","  3","  442","  20"
"3876","calaveras","2020-06-06","   0","   50","  10","  0","   50","  10"
"3877","tuolumne","2020-06-06","   0","  151","   2","  0","  151","   2"
"3878","plumas","2020-06-06","   0","   45","   0","  0","   45","   0"
"3879","modoc","2020-06-06","   0","   41","   0","  0","   41","   0"
"3880","butte","2020-06-06","   1","  448","  19","  1","  447","  18"
"3881","tulare","2020-06-06","  35","  920","  17","  9","  885","   8"
"3882","lake","2020-06-06","   2","  110","   3","  0","  108","   3"
"3883","solano","2020-06-06","  28","  707","  47","  5","  679","  42"
"3884","yolo","2020-06-06","   0","  186","   2","  0","  186","   2"
"3885","contra costa","2020-06-06","  61"," 1628"," 107"," 10"," 1567","  97"
"3886","placer","2020-06-06","  34","  753","  44","  7","  719","  37"
"3887","marin","2020-06-06","   9","  390","  18","  1","  381","  17"
"3888","san benito","2020-06-06","   0","   25","   3","  0","   25","   3"
"3889","ventura","2020-06-06","  61"," 1333","  40"," 17"," 1272","  23"
"3890","monterey","2020-06-06","  13","  811","  91","  3","  798","  88"
"3891","stanislaus","2020-06-06","  35"," 1369","  69","  9"," 1334","  60"
"3892","santa cruz","2020-06-06","   4","  397","  11","  1","  393","  10"
"3893","sonoma","2020-06-06","  75","  871","  52"," 11","  796","  41"
"3894","kern","2020-06-06"," 112"," 1756","  89"," 36"," 1644","  53"
"3895","santa clara","2020-06-06","  73"," 3375"," 202"," 23"," 3302"," 179"
"3896","kings","2020-06-06","  27","  199","   4"," 10","  172","  -6"
"3897","shasta","2020-06-06","   0","  667","   8","  0","  667","   8"
"3898","el dorado","2020-06-06","   5","  199","   8","  5","  194","   3"
"3899","san diego","2020-06-06"," 361"," 6170"," 319","146"," 5809"," 173"
"3900","merced","2020-06-06","   5","  242","   4","  2","  237","   2"
"3901","san francisco","2020-06-06","  65"," 2658","  98"," 19"," 2593","  79"
"3902","orange","2020-06-06"," 376"," 6973"," 396","148"," 6597"," 248"
"3903","humboldt","2020-06-06","   6","  352","   3","  0","  346","   3"
"3904","sacramento","2020-06-06","  61"," 2414","  90"," 22"," 2353","  68"
"3905","tehama","2020-06-06","   0","  106","   2","  0","  106","   2"
"3906","sutter","2020-06-06","   0","   14","   0","  0","   14","   0"
"3907","amador","2020-06-06","   0","   51","   4","  0","   51","   4"
"3908","lassen","2020-06-06","   0","   25","   0","  0","   25","   0"
"3909","santa barbara","2020-06-06","  33","  717","  69"," 10","  684","  59"
"3910","colusa","2020-06-06","   0","   88","   4","  2","   88","   2"
"3911","nevada","2020-06-06","   2","  130","   4","  0","  128","   4"
"3912","inyo","2020-06-06","   0","   42","   4","  0","   42","   4"
"3913","del norte","2020-06-06","   0","   51","   1","  0","   51","   1"
"3914","mendocino","2020-06-06","   1","  180","   2","  1","  179","   1"
"3915","san bernardino","2020-06-06"," 254"," 4821"," 147"," 84"," 4567","  63"
"3916","mono","2020-06-06","   0","   40","   2","  0","   40","   2"
"3917","san mateo","2020-06-06","  58"," 1101","  53","  7"," 1043","  46"
"3918","san bernardino","2020-06-07"," 221"," 4821"," 158"," 83"," 4600","  75"
"3919","siskiyou","2020-06-07","   0","   65","   5","  0","   65","   5"
"3920","mendocino","2020-06-07","   1","  180","   2","  1","  179","   1"
"3921","yolo","2020-06-07","   2","  186","   2","  2","  184","   0"
"3922","mariposa","2020-06-07","   0","   30","   0","  0","   30","   0"
"3923","santa clara","2020-06-07","  69"," 3375"," 216"," 21"," 3306"," 195"
"3924","humboldt","2020-06-07","   5","  352","   4","  0","  347","   4"
"3925","san francisco","2020-06-07","  48"," 2337","  88"," 14"," 2289","  74"
"3926","riverside","2020-06-07"," 296"," 3958"," 134"," 82"," 3662","  52"
"3927","glenn","2020-06-07","   0","   47","   0","  0","   47","   0"
"3928","san joaquin","2020-06-07","  63"," 1366","  18"," 16"," 1303","   2"
"3929","monterey","2020-06-07","  13","  811","  91","  3","  798","  88"
"3930","merced","2020-06-07","   7","  242","   4","  3","  235","   1"
"3931","plumas","2020-06-07","   0","   45","   0","  0","   45","   0"
"3932","sutter","2020-06-07","   0","   14","   0","  0","   14","   0"
"3933","amador","2020-06-07","   1","   51","   0","  0","   50","   0"
"3934","san diego","2020-06-07"," 359"," 5907"," 333","147"," 5548"," 186"
"3935","el dorado","2020-06-07","   6","  199","   9","  3","  193","   6"
"3936","alameda","2020-06-07"," 166"," 2968"," 152"," 40"," 2802"," 112"
"3937","sonoma","2020-06-07","  71","  871","  49"," 12","  800","  37"
"3938","nevada","2020-06-07","   1","  127","   6","  0","  126","   6"
"3939","napa","2020-06-07","   3","  397","   2","  1","  394","   1"
"3940","san mateo","2020-06-07","  57"," 1101","  55","  6"," 1044","  49"
"3941","fresno","2020-06-07"," 100"," 2139","  97"," 20"," 2039","  77"
"3942","calaveras","2020-06-07","   1","   50","  12","  0","   49","  12"
"3943","marin","2020-06-07","   7","  390","  16","  0","  383","  16"
"3944","shasta","2020-06-07","   0","  667","  12","  0","  667","  12"
"3945","stanislaus","2020-06-07","  37"," 1369","  73","  9"," 1332","  64"
"3946","san benito","2020-06-07","   0","   25","   2","  0","   25","   2"
"3947","lassen","2020-06-07","   0","   25","   0","  0","   25","   0"
"3948","madera","2020-06-07","  11","  528","  21","  2","  517","  19"
"3949","santa barbara","2020-06-07","  23","  717","  66","  7","  694","  59"
"3950","colusa","2020-06-07","   0","   88","   5","  1","   88","   4"
"3951","los angeles","2020-06-07","2011","23659","1247","519","21648"," 728"
"3952","tuolumne","2020-06-07","   0","  151","   3","  0","  151","   3"
"3953","yuba","2020-06-07","   5","  445","  10","  2","  440","   8"
"3954","kings","2020-06-07","  28","  199","   4"," 10","  171","  -6"
"3955","inyo","2020-06-07","   0","   42","   4","  0","   42","   4"
"3956","imperial","2020-06-07","  88","  237","   7"," 18","  149"," -11"
"3957","san luis obispo","2020-06-07","   5","  454","  25","  2","  449","  23"
"3958","del norte","2020-06-07","   1","   51","   1","  1","   50","   0"
"3959","orange","2020-06-07"," 399"," 6973"," 398","166"," 6574"," 232"
"3960","ventura","2020-06-07","  71"," 1329","  48"," 17"," 1258","  31"
"3961","kern","2020-06-07"," 107"," 1756","  82"," 38"," 1649","  44"
"3962","sacramento","2020-06-07","  59"," 2399","  90"," 22"," 2340","  68"
"3963","solano","2020-06-07","  30","  707","  46","  5","  677","  41"
"3964","lake","2020-06-07","   0","  110","   4","  0","  110","   4"
"3965","placer","2020-06-07","  34","  753","  46","  6","  719","  40"
"3966","tulare","2020-06-07","  28","  729","   4","  8","  701","  -4"
"3967","modoc","2020-06-07","   0","   41","   0","  0","   41","   0"
"3968","contra costa","2020-06-07","  67"," 1628"," 105"," 12"," 1561","  93"
"3969","trinity","2020-06-07","   0","   54","   0","  0","   54","   0"
"3970","santa cruz","2020-06-07","   4","  397","  11","  1","  393","  10"
"3971","butte","2020-06-07","   1","  448","  21","  1","  447","  20"
"3972","tehama","2020-06-07","   0","  106","   1","  0","  106","   1"
"3973","mono","2020-06-07","   0","   40","   2","  0","   40","   2"
"3974","solano","2020-06-08","  28","  707","  47","  5","  679","  42"
"3975","san joaquin","2020-06-08","  70"," 1366","  18"," 23"," 1296","  -5"
"3976","butte","2020-06-08","   4","  448","  19","  2","  444","  17"
"3977","san diego","2020-06-08"," 371"," 6122"," 332","166"," 5751"," 166"
"3978","alameda","2020-06-08"," 152"," 2968"," 144"," 43"," 2816"," 101"
"3979","glenn","2020-06-08","   0","   47","   0","  0","   47","   0"
"3980","plumas","2020-06-08","   0","   45","   0","  0","   45","   0"
"3981","amador","2020-06-08","   0","   51","   3","  0","   51","   3"
"3982","humboldt","2020-06-08","   7","  352","   3","  0","  345","   3"
"3983","merced","2020-06-08","   8","  242","   5","  3","  234","   2"
"3984","sutter","2020-06-08","   0","   14","   0","  0","   14","   0"
"3985","calaveras","2020-06-08","   0","   50","  10","  0","   50","  10"
"3986","trinity","2020-06-08","   3","   54","   0","  0","   51","   0"
"3987","san francisco","2020-06-08","  43"," 2647"," 106"," 15"," 2604","  91"
"3988","santa clara","2020-06-08","  61"," 3375"," 229"," 22"," 3314"," 207"
"3989","kings","2020-06-08","  25","  199","   2","  9","  174","  -7"
"3990","tehama","2020-06-08","   0","  106","   5","  0","  106","   5"
"3991","siskiyou","2020-06-08","   0","   65","   6","  0","   65","   6"
"3992","madera","2020-06-08","   9","  528","  20","  2","  519","  18"
"3993","tuolumne","2020-06-08","   0","  151","   5","  0","  151","   5"
"3994","fresno","2020-06-08"," 107"," 2132","  97"," 17"," 2025","  80"
"3995","el dorado","2020-06-08","   6","  235","  11","  3","  229","   8"
"3996","marin","2020-06-08","   2","  390","  16","  2","  388","  14"
"3997","sacramento","2020-06-08","  61"," 2425"," 103"," 23"," 2364","  80"
"3998","contra costa","2020-06-08","  55"," 1628"," 116"," 13"," 1573"," 103"
"3999","colusa","2020-06-08","   1","   88","   5","  1","   87","   4"
"4000","santa barbara","2020-06-08","  28","  717","  66"," 10","  689","  56"
"4001","ventura","2020-06-08","  69"," 1327","  47"," 22"," 1258","  25"
"4002","modoc","2020-06-08","   0","   41","   0","  0","   41","   0"
"4003","mendocino","2020-06-08","   1","  180","   2","  1","  179","   1"
"4004","lassen","2020-06-08","   0","   25","   0","  0","   25","   0"
"4005","nevada","2020-06-08","   2","  120","   4","  1","  118","   3"
"4006","placer","2020-06-08","  22","  753","  48","  5","  731","  43"
"4007","san mateo","2020-06-08","  39"," 1101","  54","  5"," 1062","  49"
"4008","napa","2020-06-08","   7","  397","   3","  2","  390","   1"
"4009","san benito","2020-06-08","   0","   25","   2","  0","   25","   2"
"4010","los angeles","2020-06-08","2053","23736","1301","521","21683"," 780"
"4011","riverside","2020-06-08"," 328"," 3987"," 128"," 89"," 3659","  39"
"4012","santa cruz","2020-06-08","   2","  397","  17","  0","  395","  17"
"4013","imperial","2020-06-08","  87","  237","   6"," 19","  150"," -13"
"4014","mono","2020-06-08","   0","   40","   2","  0","   40","   2"
"4015","inyo","2020-06-08","   1","   42","   4","  0","   41","   4"
"4016","san bernardino","2020-06-08"," 251"," 4821"," 156"," 86"," 4570","  70"
"4017","mariposa","2020-06-08","   0","   30","   0","  0","   30","   0"
"4018","lake","2020-06-08","   0","  110","   4","  0","  110","   4"
"4019","yuba","2020-06-08","   5","  445","  17","  2","  440","  15"
"4020","yolo","2020-06-08","   1","  186","   8","  1","  185","   7"
"4021","stanislaus","2020-06-08","  39"," 1369","  78"," 12"," 1330","  66"
"4022","monterey","2020-06-08","  12","  811","  93","  3","  799","  90"
"4023","del norte","2020-06-08","   0","   51","   1","  0","   51","   1"
"4024","sonoma","2020-06-08","  79","  871","  47"," 13","  792","  34"
"4025","shasta","2020-06-08","   1","  667","   9","  0","  666","   9"
"4026","orange","2020-06-08"," 391"," 6976"," 410","160"," 6585"," 250"
"4027","tulare","2020-06-08","  36","  743","  10","  8","  707","   2"
"4028","san luis obispo","2020-06-08","   3","  480","  26","  2","  477","  24"
"4029","kern","2020-06-08"," 113"," 1756","  81"," 34"," 1643","  47"
"4030","trinity","2020-06-09","   2","   54","   0","  0","   52","   0"
"4031","ventura","2020-06-09","  87"," 1350","  41"," 21"," 1263","  20"
"4032","sonoma","2020-06-09","  75","  871","  49","  7","  796","  42"
"4033","stanislaus","2020-06-09","  42"," 1369","  78"," 17"," 1327","  61"
"4034","orange","2020-06-09"," 384"," 6976"," 390","165"," 6592"," 225"
"4035","modoc","2020-06-09","   0","   41","   0","  0","   41","   0"
"4036","inyo","2020-06-09","   1","   42","   4","  0","   41","   4"
"4037","contra costa","2020-06-09","  61"," 1628"," 106"," 14"," 1567","  92"
"4038","san joaquin","2020-06-09","  76"," 1366","  17"," 25"," 1290","  -8"
"4039","calaveras","2020-06-09","   0","   50","   9","  0","   50","   9"
"4040","santa barbara","2020-06-09","  32","  717","  64","  9","  685","  55"
"4041","san diego","2020-06-09"," 373"," 6182"," 330","153"," 5809"," 177"
"4042","humboldt","2020-06-09","   9","  352","   4","  1","  343","   3"
"4043","monterey","2020-06-09","  13","  811","  92","  3","  798","  89"
"4044","colusa","2020-06-09","   0","   88","   6","  0","   88","   6"
"4045","yuba","2020-06-09","   4","  445","  14","  2","  441","  12"
"4046","san bernardino","2020-06-09"," 276"," 4821"," 136"," 94"," 4545","  42"
"4047","shasta","2020-06-09","   1","  667","   9","  0","  666","   9"
"4048","riverside","2020-06-09"," 333"," 3987"," 134"," 91"," 3654","  43"
"4049","los angeles","2020-06-09","2111","23627","1258","507","21516"," 751"
"4050","san mateo","2020-06-09","  44"," 1101","  47","  9"," 1057","  38"
"4051","amador","2020-06-09","   0","   51","   0","  0","   51","   0"
"4052","merced","2020-06-09","   4","  242","   4","  2","  238","   2"
"4053","siskiyou","2020-06-09","   1","   65","   5","  1","   64","   4"
"4054","tehama","2020-06-09","   0","  106","   5","  0","  106","   5"
"4055","kern","2020-06-09"," 105"," 1742","  75"," 34"," 1637","  41"
"4056","lake","2020-06-09","   1","  110","   1","  1","  109","   0"
"4057","del norte","2020-06-09","   0","   51","   1","  0","   51","   1"
"4058","sutter","2020-06-09","   0","   14","   0","  0","   14","   0"
"4059","sacramento","2020-06-09","  52"," 2413","  87"," 20"," 2361","  67"
"4060","san francisco","2020-06-09","  49"," 2647"," 100"," 13"," 2598","  87"
"4061","butte","2020-06-09","   6","  448","  16","  3","  442","  13"
"4062","alameda","2020-06-09"," 146"," 2968"," 137"," 41"," 2822","  96"
"4063","san benito","2020-06-09","   0","   25","   2","  0","   25","   2"
"4064","tuolumne","2020-06-09","   0","  151","   3","  0","  151","   3"
"4065","mono","2020-06-09","   0","   40","   2","  0","   40","   2"
"4066","glenn","2020-06-09","   1","   47","   0","  0","   46","   0"
"4067","kings","2020-06-09","  30","  199","   0","  8","  169","  -8"
"4068","yolo","2020-06-09","   1","  186","   2","  2","  185","   0"
"4069","mariposa","2020-06-09","   0","   30","   0","  0","   30","   0"
"4070","marin","2020-06-09","  10","  390","  11","  4","  380","   7"
"4071","madera","2020-06-09","  11","  528","  20","  1","  517","  19"
"4072","fresno","2020-06-09"," 104"," 2132","  92"," 16"," 2028","  76"
"4073","tulare","2020-06-09","  44","  743","  12","  7","  699","   5"
"4074","plumas","2020-06-09","   0","   45","   0","  0","   45","   0"
"4075","placer","2020-06-09","  22","  753","  49","  4","  731","  45"
"4076","santa clara","2020-06-09","  59"," 3375"," 213"," 21"," 3316"," 192"
"4077","santa cruz","2020-06-09","   4","  397","  11","  0","  393","  11"
"4078","san luis obispo","2020-06-09","   5","  453","  24","  2","  448","  22"
"4079","mendocino","2020-06-09","   1","  180","   1","  1","  179","   0"
"4080","lassen","2020-06-09","   0","   25","   0","  0","   25","   0"
"4081","napa","2020-06-09","   6","  397","   1","  0","  391","   1"
"4082","nevada","2020-06-09","   3","  125","   7","  2","  122","   5"
"4083","el dorado","2020-06-09","   3","  235","  13","  0","  232","  13"
"4084","solano","2020-06-09","  42","  707","  44","  7","  665","  37"
"4085","imperial","2020-06-09","  85","  212","   2"," 18","  127"," -16"
"4086","modoc","2020-06-10","   0","   41","   0","  0","   41","   0"
"4087","tuolumne","2020-06-10","   1","  151","   3","  1","  150","   2"
"4088","calaveras","2020-06-10","   0","   50","   9","  0","   50","   9"
"4089","imperial","2020-06-10","  79","  212","   2"," 16","  133"," -14"
"4090","san diego","2020-06-10"," 362"," 6186"," 330","151"," 5824"," 179"
"4091","sonoma","2020-06-10","  62","  871","  47","  7","  809","  40"
"4092","kern","2020-06-10"," 112"," 1742","  77"," 42"," 1630","  35"
"4093","contra costa","2020-06-10","  43"," 1628"," 111"," 16"," 1585","  95"
"4094","tulare","2020-06-10","  43","  780","  10","  8","  737","   2"
"4095","trinity","2020-06-10","   1","   54","   0","  0","   53","   0"
"4096","el dorado","2020-06-10","   1","  235","   9","  0","  234","   9"
"4097","yuba","2020-06-10","   6","  445","  10","  2","  439","   8"
"4098","fresno","2020-06-10"," 102"," 2144","  84"," 23"," 2042","  61"
"4099","colusa","2020-06-10","   0","   88","   6","  0","   88","   6"
"4100","santa barbara","2020-06-10","  31","  717","  68","  6","  686","  62"
"4101","solano","2020-06-10","  33","  707","  46","  5","  674","  41"
"4102","madera","2020-06-10","  11","  528","  14","  3","  517","  11"
"4103","yolo","2020-06-10","   0","  186","   3","  0","  186","   3"
"4104","merced","2020-06-10","   7","  242","   5","  3","  235","   2"
"4105","del norte","2020-06-10","   0","   51","   1","  0","   51","   1"
"4106","glenn","2020-06-10","   1","   47","   0","  0","   46","   0"
"4107","plumas","2020-06-10","   0","   45","   0","  0","   45","   0"
"4108","tehama","2020-06-10","   0","  106","   7","  0","  106","   7"
"4109","inyo","2020-06-10","   1","   42","   4","  0","   41","   4"
"4110","san benito","2020-06-10","   0","   25","   1","  0","   25","   1"
"4111","shasta","2020-06-10","   1","  667","   4","  5","  666","  -1"
"4112","orange","2020-06-10"," 384"," 6976"," 392","153"," 6592"," 239"
"4113","santa cruz","2020-06-10","   6","  397","  10","  0","  391","  10"
"4114","san bernardino","2020-06-10"," 247"," 4821"," 132"," 92"," 4574","  40"
"4115","riverside","2020-06-10"," 333"," 3987"," 127"," 86"," 3654","  41"
"4116","marin","2020-06-10","  11","  390","  10","  3","  379","   7"
"4117","nevada","2020-06-10","   2","  130","   4","  2","  128","   2"
"4118","mendocino","2020-06-10","   1","  180","   3","  1","  179","   2"
"4119","lassen","2020-06-10","   0","   25","   0","  0","   25","   0"
"4120","napa","2020-06-10","   6","  397","   0","  1","  391","  -1"
"4121","mono","2020-06-10","   0","   40","   2","  0","   40","   2"
"4122","humboldt","2020-06-10","  15","  352","   5","  1","  337","   4"
"4123","alameda","2020-06-10"," 134"," 2968"," 147"," 43"," 2834"," 104"
"4124","san mateo","2020-06-10","  40"," 1049","  50","  9"," 1009","  41"
"4125","mariposa","2020-06-10","   0","   30","   0","  0","   30","   0"
"4126","amador","2020-06-10","   0","   51","   3","  0","   51","   3"
"4127","lake","2020-06-10","   2","  110","   1","  0","  108","   1"
"4128","sutter","2020-06-10","   0","   14","   0","  0","   14","   0"
"4129","santa clara","2020-06-10","  62"," 3375"," 220"," 21"," 3313"," 199"
"4130","kings","2020-06-10","  31","  199","   2"," 10","  168","  -8"
"4131","siskiyou","2020-06-10","   0","   65","   4","  0","   65","   4"
"4132","los angeles","2020-06-10","1953","23634","1258","512","21681"," 746"
"4133","stanislaus","2020-06-10","  41"," 1369","  83"," 15"," 1328","  68"
"4134","sacramento","2020-06-10","  62"," 2471","  97"," 18"," 2409","  79"
"4135","san luis obispo","2020-06-10","   5","  456","  23","  2","  451","  21"
"4136","monterey","2020-06-10","  16","  811","  87","  3","  795","  84"
"4137","butte","2020-06-10","  30","  448","  17","  9","  418","   8"
"4138","ventura","2020-06-10"," 100"," 1347","  56"," 17"," 1247","  39"
"4139","san francisco","2020-06-10","  50"," 2647","  95"," 14"," 2597","  81"
"4140","san joaquin","2020-06-10","  83"," 1366","  17"," 21"," 1283","  -4"
"4141","placer","2020-06-10","  23","  753","  45","  4","  730","  41"
"4142","mariposa","2020-06-11","   0","   30","   0","  0","   30","   0"
"4143","sonoma","2020-06-11","  27","  871","  49","  4","  844","  45"
"4144","mono","2020-06-11","   1","   40","   2","  0","   39","   2"
"4145","sacramento","2020-06-11","  62"," 2501"," 105"," 18"," 2439","  87"
"4146","tulare","2020-06-11","  41","  780","  11","  7","  739","   4"
"4147","tuolumne","2020-06-11","   0","  151","   0","  0","  151","   0"
"4148","san bernardino","2020-06-11"," 271"," 4821"," 133"," 89"," 4550","  44"
"4149","los angeles","2020-06-11","1973","23666","1220","512","21693"," 708"
"4150","contra costa","2020-06-11","  51"," 1628"," 112"," 15"," 1577","  97"
"4151","imperial","2020-06-11","  87","  237","   0"," 18","  150"," -18"
"4152","alameda","2020-06-11"," 124"," 2968"," 145"," 39"," 2844"," 106"
"4153","san francisco","2020-06-11","  51"," 2647","  86"," 15"," 2596","  71"
"4154","riverside","2020-06-11"," 306"," 4018"," 131"," 83"," 3712","  48"
"4155","solano","2020-06-11","  31","  707","  43","  8","  676","  35"
"4156","humboldt","2020-06-11","   9","  352","   2","  0","  343","   2"
"4157","kern","2020-06-11"," 109"," 1742","  83"," 31"," 1633","  52"
"4158","santa barbara","2020-06-11","  37","  717","  64","  8","  680","  56"
"4159","monterey","2020-06-11","  17","  811","  85","  5","  794","  80"
"4160","yuba","2020-06-11","   6","  445","   6","  2","  439","   4"
"4161","san joaquin","2020-06-11","  67"," 1366","  17"," 17"," 1299","   0"
"4162","san diego","2020-06-11"," 352"," 6187"," 325","149"," 5835"," 176"
"4163","tehama","2020-06-11","   0","  106","   7","  0","  106","   7"
"4164","marin","2020-06-11","  10","  390","  13","  3","  380","  10"
"4165","siskiyou","2020-06-11","   0","   65","   4","  0","   65","   4"
"4166","del norte","2020-06-11","   1","   51","   3","  0","   50","   3"
"4167","plumas","2020-06-11","   0","   45","   0","  0","   45","   0"
"4168","lake","2020-06-11","   0","  110","   2","  0","  110","   2"
"4169","santa cruz","2020-06-11","   6","  397","  11","  0","  391","  11"
"4170","butte","2020-06-11","  42","  448","  15"," 10","  406","   5"
"4171","nevada","2020-06-11","   2","  127","   4","  2","  125","   2"
"4172","orange","2020-06-11"," 392"," 6976"," 368","172"," 6584"," 196"
"4173","madera","2020-06-11","  11","  528","   5","  4","  517","   1"
"4174","el dorado","2020-06-11","   1","  235","  10","  1","  234","   9"
"4175","sutter","2020-06-11","   0","   14","   0","  0","   14","   0"
"4176","san benito","2020-06-11","   0","   25","   1","  0","   25","   1"
"4177","merced","2020-06-11","   5","  242","   3","  3","  237","   0"
"4178","fresno","2020-06-11","  99"," 2142","  79"," 18"," 2043","  61"
"4179","yolo","2020-06-11","   1","  186","   2","  0","  185","   2"
"4180","placer","2020-06-11","  18","  753","  48","  4","  735","  44"
"4181","kings","2020-06-11","  31","  199","   5","  8","  168","  -3"
"4182","trinity","2020-06-11","   0","   54","   0","  0","   54","   0"
"4183","amador","2020-06-11","   0","   51","   2","  0","   51","   2"
"4184","colusa","2020-06-11","   0","   88","   6","  0","   88","   6"
"4185","inyo","2020-06-11","   1","   42","   2","  0","   41","   2"
"4186","napa","2020-06-11","   3","  397","   3","  0","  394","   3"
"4187","modoc","2020-06-11","   0","   41","   0","  0","   41","   0"
"4188","stanislaus","2020-06-11","  47"," 1369","  82"," 14"," 1322","  68"
"4189","shasta","2020-06-11","   2","  667","   8","  0","  665","   8"
"4190","lassen","2020-06-11","   0","   25","   0","  0","   25","   0"
"4191","san mateo","2020-06-11","  33"," 1089","  50","  7"," 1056","  43"
"4192","glenn","2020-06-11","   1","   47","   0","  0","   46","   0"
"4193","santa clara","2020-06-11","  57"," 3375"," 215"," 20"," 3318"," 195"
"4194","calaveras","2020-06-11","   0","   50","   8","  0","   50","   8"
"4195","mendocino","2020-06-11","   0","  180","   3","  0","  180","   3"
"4196","ventura","2020-06-11","  90"," 1360","  46"," 21"," 1270","  25"
"4197","san luis obispo","2020-06-11","   5","  481","  24","  3","  476","  21"
"4198","napa","2020-06-12","   8","  397","   1","  1","  389","   0"
"4199","el dorado","2020-06-12","   3","  235","  14","  3","  232","  11"
"4200","san joaquin","2020-06-12","  68"," 1366","  16"," 17"," 1298","  -1"
"4201","mono","2020-06-12","   0","   40","   2","  0","   40","   2"
"4202","tuolumne","2020-06-12","   0","  151","   2","  0","  151","   2"
"4203","mariposa","2020-06-12","   0","   30","   0","  0","   30","   0"
"4204","lake","2020-06-12","   2","  110","   0","  2","  108","  -2"
"4205","tulare","2020-06-12","  25","  780","  25","  8","  755","  17"
"4206","san francisco","2020-06-12","  52"," 2647","  91"," 16"," 2595","  75"
"4207","fresno","2020-06-12"," 102"," 2140","  87"," 20"," 2038","  67"
"4208","marin","2020-06-12","  11","  390","  12","  4","  379","   8"
"4209","alameda","2020-06-12"," 126"," 2968"," 120"," 41"," 2842","  79"
"4210","contra costa","2020-06-12","  42"," 1628"," 111"," 13"," 1586","  98"
"4211","placer","2020-06-12","  15","  753","  46","  2","  738","  44"
"4212","amador","2020-06-12","   0","   51","   0","  0","   51","   0"
"4213","stanislaus","2020-06-12","  68"," 1369","  84"," 16"," 1301","  68"
"4214","shasta","2020-06-12","   1","  667","   7","  0","  666","   7"
"4215","santa clara","2020-06-12","  60"," 3375"," 223"," 20"," 3315"," 203"
"4216","plumas","2020-06-12","   0","   45","   0","  0","   45","   0"
"4217","glenn","2020-06-12","   1","   47","   0","  0","   46","   0"
"4218","lassen","2020-06-12","   0","   25","   0","  0","   25","   0"
"4219","solano","2020-06-12","  27","  707","  46","  8","  680","  38"
"4220","trinity","2020-06-12","   0","   54","   0","  0","   54","   0"
"4221","santa cruz","2020-06-12","  10","  397","  15","  0","  387","  15"
"4222","monterey","2020-06-12","  15","  811","  87","  2","  796","  85"
"4223","siskiyou","2020-06-12","   1","   65","   5","  1","   64","   4"
"4224","kern","2020-06-12"," 111"," 1742","  72"," 37"," 1631","  35"
"4225","merced","2020-06-12","   6","  242","   3","  3","  236","   0"
"4226","yolo","2020-06-12","   0","  186","   4","  0","  186","   4"
"4227","sonoma","2020-06-12","  42","  871","  42","  6","  829","  36"
"4228","calaveras","2020-06-12","   0","   50","  10","  0","   50","  10"
"4229","kings","2020-06-12","  34","  199","   5"," 10","  165","  -5"
"4230","butte","2020-06-12","   5","  448","  20","  3","  443","  17"
"4231","santa barbara","2020-06-12","  34","  717","  58","  9","  683","  49"
"4232","san mateo","2020-06-12","  32"," 1089","  51","  8"," 1057","  43"
"4233","ventura","2020-06-12"," 109"," 1361","  42"," 23"," 1252","  19"
"4234","sacramento","2020-06-12","  67"," 2474","  91"," 21"," 2407","  70"
"4235","sutter","2020-06-12","   0","   14","   0","  0","   14","   0"
"4236","tehama","2020-06-12","   1","  106","   6","  1","  105","   5"
"4237","colusa","2020-06-12","   0","   88","   6","  0","   88","   6"
"4238","nevada","2020-06-12","   0","  136","   6","  0","  136","   6"
"4239","madera","2020-06-12","   9","  528","  14","  2","  519","  12"
"4240","yuba","2020-06-12","   6","  445","   9","  2","  439","   7"
"4241","san benito","2020-06-12","   0","   25","   1","  0","   25","   1"
"4242","orange","2020-06-12"," 428"," 6976"," 384","177"," 6548"," 207"
"4243","los angeles","2020-06-12","1870","23655","1228","492","21785"," 736"
"4244","inyo","2020-06-12","   1","   42","   3","  0","   41","   3"
"4245","imperial","2020-06-12","  82","  237","   2"," 16","  155"," -14"
"4246","san luis obispo","2020-06-12","   5","  471","  24","  2","  466","  22"
"4247","riverside","2020-06-12"," 319"," 4018"," 139"," 88"," 3699","  51"
"4248","modoc","2020-06-12","   0","   41","   0","  0","   41","   0"
"4249","del norte","2020-06-12","   0","   51","   4","  0","   51","   4"
"4250","humboldt","2020-06-12","  14","  352","   0","  2","  338","  -2"
"4251","mendocino","2020-06-12","   0","  180","   5","  0","  180","   5"
"4252","san diego","2020-06-12"," 316"," 6210"," 328","144"," 5894"," 184"
"4253","san bernardino","2020-06-12"," 283"," 4821"," 138"," 93"," 4538","  45"
"4254","butte","2020-06-13","   3","  448","  20","  4","  445","  16"
"4255","napa","2020-06-13","   5","  397","   3","  0","  392","   3"
"4256","tuolumne","2020-06-13","   0","  151","   0","  0","  151","   0"
"4257","san luis obispo","2020-06-13","   8","  449","  23","  3","  441","  20"
"4258","sacramento","2020-06-13","  51"," 2444","  84"," 16"," 2393","  68"
"4259","merced","2020-06-13","   4","  242","   5","  2","  238","   3"
"4260","del norte","2020-06-13","   0","   51","   2","  0","   51","   2"
"4261","san benito","2020-06-13","   0","   25","   0","  0","   25","   0"
"4262","glenn","2020-06-13","   1","   47","   0","  0","   46","   0"
"4263","humboldt","2020-06-13","  14","  352","   0","  2","  338","  -2"
"4264","trinity","2020-06-13","   1","   54","   0","  0","   53","   0"
"4265","colusa","2020-06-13","   0","   88","   6","  0","   88","   6"
"4266","san bernardino","2020-06-13"," 285"," 4821"," 129","101"," 4536","  28"
"4267","lake","2020-06-13","   1","  110","   0","  1","  109","  -1"
"4268","inyo","2020-06-13","   1","   42","   2","  0","   41","   2"
"4269","san francisco","2020-06-13","  50"," 2647","  94"," 14"," 2597","  80"
"4270","kings","2020-06-13","  34","  199","   6"," 10","  165","  -4"
"4271","monterey","2020-06-13","  18","  811","  91","  2","  793","  89"
"4272","kern","2020-06-13"," 107"," 1742","  78"," 37"," 1635","  41"
"4273","santa clara","2020-06-13","  49"," 3423"," 211"," 15"," 3374"," 196"
"4274","contra costa","2020-06-13","  47"," 1628"," 108"," 14"," 1581","  94"
"4275","sutter","2020-06-13","   0","   14","   0","  0","   14","   0"
"4276","mendocino","2020-06-13","   0","  180","   5","  0","  180","   5"
"4277","tulare","2020-06-13","  36","  780","   6","  8","  744","  -2"
"4278","alameda","2020-06-13"," 114"," 2968"," 150"," 36"," 2854"," 114"
"4279","fresno","2020-06-13","  98"," 2140","  83"," 24"," 2042","  59"
"4280","mariposa","2020-06-13","   0","   30","   0","  0","   30","   0"
"4281","madera","2020-06-13","   8","  528","   8","  2","  520","   6"
"4282","marin","2020-06-13","  12","  390","  12","  3","  378","   9"
"4283","lassen","2020-06-13","   0","   25","   0","  0","   25","   0"
"4284","santa barbara","2020-06-13","  42","  717","  58"," 10","  675","  48"
"4285","ventura","2020-06-13","  94"," 1354","  51"," 21"," 1260","  30"
"4286","san joaquin","2020-06-13","  71"," 1366","  10"," 20"," 1295"," -10"
"4287","modoc","2020-06-13","   0","   41","   0","  0","   41","   0"
"4288","san mateo","2020-06-13","  27"," 1089","  55","  8"," 1062","  47"
"4289","imperial","2020-06-13","  86","  237","   0"," 18","  151"," -18"
"4290","sonoma","2020-06-13","  11","  871","  47","  2","  860","  45"
"4291","solano","2020-06-13","  22","  707","  49","  7","  685","  42"
"4292","placer","2020-06-13","  13","  753","  50","  4","  740","  46"
"4293","siskiyou","2020-06-13","   1","   65","   3","  1","   64","   2"
"4294","tehama","2020-06-13","   0","  106","   6","  0","  106","   6"
"4295","san diego","2020-06-13"," 342"," 6195"," 324","136"," 5853"," 188"
"4296","yuba","2020-06-13","   6","  445","  14","  2","  439","  12"
"4297","riverside","2020-06-13"," 336"," 3992"," 137"," 85"," 3656","  52"
"4298","los angeles","2020-06-13","1768","23688","1262","483","21920"," 779"
"4299","santa cruz","2020-06-13","   9","  397","  10","  0","  388","  10"
"4300","shasta","2020-06-13","   1","  667","   6","  0","  666","   6"
"4301","orange","2020-06-13"," 406"," 6976"," 402","164"," 6570"," 238"
"4302","plumas","2020-06-13","   0","   45","   0","  0","   45","   0"
"4303","nevada","2020-06-13","   0","  128","   4","  0","  128","   4"
"4304","mono","2020-06-13","   0","   40","   2","  0","   40","   2"
"4305","el dorado","2020-06-13","   3","  235","  11","  3","  232","   8"
"4306","amador","2020-06-13","   0","   51","   3","  0","   51","   3"
"4307","yolo","2020-06-13","   0","  186","   2","  2","  186","   0"
"4308","calaveras","2020-06-13","   0","   50","  12","  0","   50","  12"
"4309","stanislaus","2020-06-13","  62"," 1369","  86"," 20"," 1307","  66"
"4310","stanislaus","2020-06-14","  56"," 1369","  87"," 17"," 1313","  70"
"4311","lake","2020-06-14","   1","  110","   0","  1","  109","  -1"
"4312","lassen","2020-06-14","   0","   25","   0","  0","   25","   0"
"4313","madera","2020-06-14","   5","  528","   8","  2","  523","   6"
"4314","inyo","2020-06-14","   0","   42","   3","  0","   42","   3"
"4315","san luis obispo","2020-06-14","  12","  449","  20","  6","  437","  14"
"4316","fresno","2020-06-14","  93"," 2135","  79"," 24"," 2042","  55"
"4317","san mateo","2020-06-14","  29"," 1089","  51"," 10"," 1060","  41"
"4318","alameda","2020-06-14"," 124"," 2968"," 149"," 42"," 2844"," 107"
"4319","kern","2020-06-14"," 103"," 1742","  76"," 35"," 1639","  41"
"4320","marin","2020-06-14","  11","  390","  12","  3","  379","   9"
"4321","del norte","2020-06-14","   0","   51","   0","  0","   51","   0"
"4322","napa","2020-06-14","   3","  397","   2","  1","  394","   1"
"4323","san diego","2020-06-14"," 366"," 6145"," 323","132"," 5779"," 191"
"4324","santa cruz","2020-06-14","   9","  397","  12","  0","  388","  12"
"4325","los angeles","2020-06-14","1797","23703","1283","477","21906"," 806"
"4326","san bernardino","2020-06-14"," 295"," 4821"," 140"," 95"," 4526","  45"
"4327","mendocino","2020-06-14","   0","  180","   4","  0","  180","   4"
"4328","amador","2020-06-14","   0","   51","   1","  0","   51","   1"
"4329","santa barbara","2020-06-14","  41","  717","  59"," 10","  676","  49"
"4330","sacramento","2020-06-14","  51"," 2441","  90"," 17"," 2390","  73"
"4331","humboldt","2020-06-14","   4","  352","   3","  0","  348","   3"
"4332","plumas","2020-06-14","   0","   45","   0","  0","   45","   0"
"4333","shasta","2020-06-14","   0","  667","   7","  0","  667","   7"
"4334","trinity","2020-06-14","   0","   54","   0","  0","   54","   0"
"4335","colusa","2020-06-14","   0","   88","   6","  0","   88","   6"
"4336","tulare","2020-06-14","  40","  780","  23","  7","  740","  16"
"4337","sutter","2020-06-14","   0","   14","   0","  0","   14","   0"
"4338","mariposa","2020-06-14","   0","   30","   0","  0","   30","   0"
"4339","ventura","2020-06-14","  89"," 1354","  55"," 19"," 1265","  36"
"4340","orange","2020-06-14"," 421"," 6976"," 414","164"," 6555"," 250"
"4341","solano","2020-06-14","  21","  707","  49","  7","  686","  42"
"4342","butte","2020-06-14","   3","  448","  19","  3","  445","  16"
"4343","glenn","2020-06-14","   1","   47","   0","  0","   46","   0"
"4344","mono","2020-06-14","   0","   40","   2","  0","   40","   2"
"4345","riverside","2020-06-14"," 320"," 3992"," 120"," 89"," 3672","  31"
"4346","nevada","2020-06-14","   1","  128","   4","  1","  127","   3"
"4347","contra costa","2020-06-14","  42"," 1628"," 121"," 12"," 1586"," 109"
"4348","siskiyou","2020-06-14","   1","   65","   3","  1","   64","   2"
"4349","kings","2020-06-14","  40","  199","   3","  9","  159","  -6"
"4350","placer","2020-06-14","  13","  753","  49","  4","  740","  45"
"4351","san joaquin","2020-06-14","  74"," 1366","  10"," 18"," 1292","  -8"
"4352","tuolumne","2020-06-14","   0","  151","   0","  0","  151","   0"
"4353","calaveras","2020-06-14","   0","   50","  10","  0","   50","  10"
"4354","san francisco","2020-06-14","  49"," 2647","  96"," 15"," 2598","  81"
"4355","san benito","2020-06-14","   0","   25","   0","  0","   25","   0"
"4356","monterey","2020-06-14","  15","  811","  95","  1","  796","  94"
"4357","yuba","2020-06-14","   7","  445","  13","  3","  438","  10"
"4358","tehama","2020-06-14","   0","  106","   6","  0","  106","   6"
"4359","modoc","2020-06-14","   0","   41","   0","  0","   41","   0"
"4360","yolo","2020-06-14","   0","  186","   2","  2","  186","   0"
"4361","el dorado","2020-06-14","   4","  235","  10","  4","  231","   6"
"4362","merced","2020-06-14","   4","  242","   5","  2","  238","   3"
"4363","santa clara","2020-06-14","  54"," 3423"," 204"," 15"," 3369"," 189"
"4364","imperial","2020-06-14","  90","  237","   0"," 20","  147"," -20"
"4365","sonoma","2020-06-14","  34","  871","  52","  2","  837","  50"
"4366","humboldt","2020-06-15","   5","  352","   2","  1","  347","   1"
"4367","butte","2020-06-15","   5","  448","  14","  4","  443","  10"
"4368","tulare","2020-06-15","  49","  780","  12","  9","  731","   3"
"4369","napa","2020-06-15","   6","  397","   5","  2","  391","   3"
"4370","kings","2020-06-15","  39","  199","   2"," 10","  160","  -8"
"4371","mariposa","2020-06-15","   0","   30","   0","  0","   30","   0"
"4372","imperial","2020-06-15","  82","  237","   2"," 19","  155"," -17"
"4373","santa cruz","2020-06-15","   5","  397","   8","  0","  392","   8"
"4374","del norte","2020-06-15","   0","   51","   0","  0","   51","   0"
"4375","solano","2020-06-15","  23","  707","  44","  7","  684","  37"
"4376","lake","2020-06-15","   0","  110","   0","  0","  110","   0"
"4377","mono","2020-06-15","   0","   40","   2","  0","   40","   2"
"4378","san bernardino","2020-06-15"," 295"," 4821"," 149"," 95"," 4526","  54"
"4379","merced","2020-06-15","   3","  242","   5","  2","  239","   3"
"4380","sacramento","2020-06-15","  48"," 2428"," 104"," 20"," 2380","  84"
"4381","monterey","2020-06-15","  16","  811","  93","  1","  795","  92"
"4382","sonoma","2020-06-15","  36","  871","  46","  3","  835","  43"
"4383","el dorado","2020-06-15","   2","  235","   6","  2","  233","   4"
"4384","calaveras","2020-06-15","   0","   50","   9","  0","   50","   9"
"4385","sutter","2020-06-15","   0","   14","   0","  0","   14","   0"
"4386","amador","2020-06-15","   1","   51","   0","  0","   50","   0"
"4387","colusa","2020-06-15","   0","   88","   6","  0","   88","   6"
"4388","glenn","2020-06-15","   1","   47","   0","  0","   46","   0"
"4389","inyo","2020-06-15","   0","   42","   2","  0","   42","   2"
"4390","plumas","2020-06-15","   0","   45","   0","  0","   45","   0"
"4391","mendocino","2020-06-15","   1","  180","   5","  1","  179","   4"
"4392","contra costa","2020-06-15","  33"," 1628"," 115","  9"," 1595"," 106"
"4393","stanislaus","2020-06-15","  61"," 1364","  88"," 16"," 1303","  72"
"4394","san diego","2020-06-15"," 360"," 6129"," 356","133"," 5769"," 223"
"4395","san luis obispo","2020-06-15","   4","  447","  26","  2","  443","  24"
"4396","lassen","2020-06-15","   0","   25","   0","  0","   25","   0"
"4397","san joaquin","2020-06-15","  59"," 1376","  16"," 20"," 1317","  -4"
"4398","santa barbara","2020-06-15","  49","  717","  63","  9","  668","  54"
"4399","riverside","2020-06-15"," 335"," 4071"," 136"," 81"," 3736","  55"
"4400","yolo","2020-06-15","   0","  186","   3","  0","  186","   3"
"4401","nevada","2020-06-15","   2","  131","   5","  2","  129","   3"
"4402","santa clara","2020-06-15","  54"," 3423"," 239"," 15"," 3369"," 224"
"4403","kern","2020-06-15"," 107"," 1742","  78"," 41"," 1635","  37"
"4404","tuolumne","2020-06-15","   0","  151","   2","  0","  151","   2"
"4405","marin","2020-06-15","   9","  390","  15","  1","  381","  14"
"4406","trinity","2020-06-15","   0","   54","   0","  0","   54","   0"
"4407","shasta","2020-06-15","   0","  667","   9","  0","  667","   9"
"4408","orange","2020-06-15"," 425"," 6976"," 417","159"," 6551"," 258"
"4409","san mateo","2020-06-15","  22"," 1089","  50","  7"," 1067","  43"
"4410","san francisco","2020-06-15","  45"," 2647","  94"," 10"," 2602","  84"
"4411","siskiyou","2020-06-15","   0","   65","   0","  0","   65","   0"
"4412","tehama","2020-06-15","   0","  106","   7","  0","  106","   7"
"4413","san benito","2020-06-15","   0","   25","   0","  0","   25","   0"
"4414","alameda","2020-06-15"," 129"," 2968"," 148"," 46"," 2839"," 102"
"4415","modoc","2020-06-15","   0","   41","   0","  0","   41","   0"
"4416","madera","2020-06-15","   7","  528","   7","  2","  521","   5"
"4417","placer","2020-06-15","  13","  753","  48","  5","  740","  43"
"4418","ventura","2020-06-15","  83"," 1350","  55"," 20"," 1267","  35"
"4419","yuba","2020-06-15","   6","  445","  16","  2","  439","  14"
"4420","los angeles","2020-06-15","1956","23659","1333","492","21703"," 841"
"4421","fresno","2020-06-15","  86"," 2111","  86"," 24"," 2025","  62"
"4422","los angeles","2020-06-16","1947","23667","1175","499","21720"," 676"
"4423","riverside","2020-06-16"," 341"," 4071"," 136"," 83"," 3730","  53"
"4424","shasta","2020-06-16","   0","  667","   9","  0","  667","   9"
"4425","trinity","2020-06-16","   0","   54","   0","  0","   54","   0"
"4426","solano","2020-06-16","  25","  707","  45","  7","  682","  38"
"4427","del norte","2020-06-16","   0","   51","   2","  0","   51","   2"
"4428","imperial","2020-06-16","  85","  237","   0"," 21","  152"," -21"
"4429","san diego","2020-06-16"," 343"," 6168"," 320","142"," 5825"," 178"
"4430","sonoma","2020-06-16","  18","  871","  51","  3","  853","  48"
"4431","san joaquin","2020-06-16","  61"," 1376","  20"," 20"," 1315","   0"
"4432","san mateo","2020-06-16","  28"," 1089","  54","  7"," 1061","  47"
"4433","tehama","2020-06-16","   0","  106","   4","  0","  106","   4"
"4434","monterey","2020-06-16","  17","  824","  93","  2","  807","  91"
"4435","lassen","2020-06-16","   0","   25","   0","  0","   25","   0"
"4436","plumas","2020-06-16","   0","   45","   0","  0","   45","   0"
"4437","butte","2020-06-16","   3","  448","  10","  3","  445","   7"
"4438","el dorado","2020-06-16","   1","  235","   7","  1","  234","   6"
"4439","amador","2020-06-16","   1","   51","   3","  0","   50","   3"
"4440","mendocino","2020-06-16","   0","  180","   4","  0","  180","   4"
"4441","santa cruz","2020-06-16","   4","  397","   7","  0","  393","   7"
"4442","mono","2020-06-16","   0","   40","   2","  0","   40","   2"
"4443","modoc","2020-06-16","   0","   41","   0","  0","   41","   0"
"4444","lake","2020-06-16","   2","  110","   0","  1","  108","  -1"
"4445","tulare","2020-06-16","  53","  780","  24"," 11","  727","  13"
"4446","alameda","2020-06-16"," 133"," 2968"," 142"," 48"," 2835","  94"
"4447","inyo","2020-06-16","   0","   42","   2","  0","   42","   2"
"4448","ventura","2020-06-16","  92"," 1347","  58"," 22"," 1255","  36"
"4449","placer","2020-06-16","  18","  753","  51","  5","  735","  46"
"4450","kern","2020-06-16"," 110"," 1742","  80"," 41"," 1632","  39"
"4451","nevada","2020-06-16","   1","  134","   7","  0","  133","   7"
"4452","orange","2020-06-16"," 429"," 6976"," 455","169"," 6547"," 286"
"4453","stanislaus","2020-06-16","  64"," 1369","  89"," 19"," 1305","  70"
"4454","siskiyou","2020-06-16","   1","   65","   4","  1","   64","   3"
"4455","madera","2020-06-16","   8","  528","  11","  3","  520","   8"
"4456","yuba","2020-06-16","   6","  445","  17","  2","  439","  15"
"4457","humboldt","2020-06-16","   8","  352","   0","  1","  344","  -1"
"4458","marin","2020-06-16","   9","  390","  14","  1","  381","  13"
"4459","santa barbara","2020-06-16","  50","  717","  57"," 14","  667","  43"
"4460","san bernardino","2020-06-16"," 293"," 4821"," 156"," 90"," 4528","  66"
"4461","san francisco","2020-06-16","  42"," 2647","  91","  8"," 2605","  83"
"4462","calaveras","2020-06-16","   0","   50","   9","  0","   50","   9"
"4463","yolo","2020-06-16","   1","  186","   6","  0","  185","   6"
"4464","santa clara","2020-06-16","  48"," 3423"," 228"," 15"," 3375"," 213"
"4465","fresno","2020-06-16"," 103"," 2129","  86"," 24"," 2026","  62"
"4466","colusa","2020-06-16","   1","   88","   6","  0","   87","   6"
"4467","merced","2020-06-16","   8","  242","   5","  3","  234","   2"
"4468","sacramento","2020-06-16","  57"," 2457","  87"," 21"," 2400","  66"
"4469","contra costa","2020-06-16","  40"," 1628"," 108"," 13"," 1588","  95"
"4470","mariposa","2020-06-16","   0","   30","   0","  0","   30","   0"
"4471","napa","2020-06-16","  10","  397","   6","  1","  387","   5"
"4472","tuolumne","2020-06-16","   0","  151","   0","  0","  151","   0"
"4473","kings","2020-06-16","  47","  199","   2"," 10","  152","  -8"
"4474","san luis obispo","2020-06-16","  13","  471","  27","  7","  458","  20"
"4475","sutter","2020-06-16","   0","   14","   0","  0","   14","   0"
"4476","san benito","2020-06-16","   0","   25","   0","  0","   25","   0"
"4477","glenn","2020-06-16","   1","   47","   0","  0","   46","   0"
"4478","yuba","2020-06-17","   5","  445","  18","  1","  440","  17"
"4479","marin","2020-06-17","   8","  390","   9","  3","  382","   6"
"4480","sutter","2020-06-17","   0","   14","   0","  0","   14","   0"
"4481","mono","2020-06-17","   0","   40","   2","  0","   40","   2"
"4482","plumas","2020-06-17","   0","   45","   0","  0","   45","   0"
"4483","inyo","2020-06-17","   0","   42","   3","  0","   42","   3"
"4484","shasta","2020-06-17","   0","  667","  12","  0","  667","  12"
"4485","santa barbara","2020-06-17","  48","  717","  35"," 15","  669","  20"
"4486","san diego","2020-06-17"," 343"," 6235"," 324","147"," 5892"," 177"
"4487","lassen","2020-06-17","   0","   25","   0","  0","   25","   0"
"4488","contra costa","2020-06-17","  32"," 1628","  96"," 13"," 1596","  83"
"4489","tuolumne","2020-06-17","   0","  151","   0","  0","  151","   0"
"4490","monterey","2020-06-17","  17","  824","  85","  3","  807","  82"
"4491","kern","2020-06-17"," 123"," 1412","  31"," 45"," 1289"," -14"
"4492","humboldt","2020-06-17","   3","  352","   0","  1","  349","  -1"
"4493","mendocino","2020-06-17","   0","  180","   4","  0","  180","   4"
"4494","tehama","2020-06-17","   0","  106","   6","  0","  106","   6"
"4495","ventura","2020-06-17"," 101"," 1368","  45"," 23"," 1267","  22"
"4496","mariposa","2020-06-17","   0","   30","   0","  0","   30","   0"
"4497","san joaquin","2020-06-17","  61"," 1376","  23"," 19"," 1315","   4"
"4498","san francisco","2020-06-17","  44"," 2647","  86"," 11"," 2603","  75"
"4499","napa","2020-06-17","   9","  397","   6","  0","  388","   6"
"4500","san benito","2020-06-17","   0","   25","   0","  0","   25","   0"
"4501","los angeles","2020-06-17","1958","23646","1151","475","21688"," 676"
"4502","glenn","2020-06-17","   1","   47","   0","  0","   46","   0"
"4503","san bernardino","2020-06-17"," 297"," 4821"," 146"," 88"," 4524","  58"
"4504","stanislaus","2020-06-17","  74"," 1369","  84"," 17"," 1295","  67"
"4505","fresno","2020-06-17"," 103"," 2138","  81"," 17"," 2035","  64"
"4506","madera","2020-06-17","   7","  528","   7","  5","  521","   2"
"4507","san luis obispo","2020-06-17","   7","  365","  73","  3","  358","  70"
"4508","lake","2020-06-17","   1","  110","   0","  0","  109","   0"
"4509","kings","2020-06-17","  49","  199","   4"," 10","  150","  -6"
"4510","riverside","2020-06-17"," 379"," 4071","  91"," 94"," 3692","  -3"
"4511","orange","2020-06-17"," 425"," 6976"," 407","165"," 6551"," 242"
"4512","santa clara","2020-06-17","  55"," 3438"," 204"," 15"," 3383"," 189"
"4513","siskiyou","2020-06-17","   4","   65","   2","  1","   61","   1"
"4514","yolo","2020-06-17","   2","  186","   6","  0","  184","   6"
"4515","merced","2020-06-17","  10","  242","   3","  3","  232","   0"
"4516","tulare","2020-06-17","  49","  780","  23"," 11","  731","  12"
"4517","alameda","2020-06-17"," 137"," 2968"," 135"," 49"," 2831","  86"
"4518","san mateo","2020-06-17","  20"," 1089","  50","  7"," 1069","  43"
"4519","butte","2020-06-17","   3","  448","   4","  3","  445","   1"
"4520","modoc","2020-06-17","   0","   41","   0","  0","   41","   0"
"4521","trinity","2020-06-17","   2","   54","   0","  0","   52","   0"
"4522","colusa","2020-06-17","   0","   88","   6","  0","   88","   6"
"4523","nevada","2020-06-17","   2","  145","   9","  0","  143","   9"
"4524","placer","2020-06-17","  16","  753","  51","  3","  737","  48"
"4525","el dorado","2020-06-17","   2","   88","  11","  0","   86","  11"
"4526","solano","2020-06-17","  19","  707","  52","  4","  688","  48"
"4527","sonoma","2020-06-17","  19","  871","  47","  5","  852","  42"
"4528","imperial","2020-06-17","  89","  237","   0"," 20","  148"," -20"
"4529","santa cruz","2020-06-17","   7","  397","   9","  3","  390","   6"
"4530","calaveras","2020-06-17","   0","   50","   9","  0","   50","   9"
"4531","del norte","2020-06-17","   0","   51","   2","  0","   51","   2"
"4532","sacramento","2020-06-17","  52"," 2395","  77"," 19"," 2343","  58"
"4533","amador","2020-06-17","   1","   51","   1","  0","   50","   1"
"4534","modoc","2020-06-18","   0","   41","   0","  0","   41","   0"
"4535","yuba","2020-06-18","   4","  445","   8","  1","  441","   7"
"4536","mono","2020-06-18","   0","   40","   2","  0","   40","   2"
"4537","butte","2020-06-18","   4","  448","   6","  2","  444","   4"
"4538","alameda","2020-06-18"," 130"," 2968"," 195"," 54"," 2838"," 141"
"4539","san joaquin","2020-06-18","  76"," 1376","  23"," 27"," 1300","  -4"
"4540","trinity","2020-06-18","   2","   54","   0","  0","   52","   0"
"4541","tehama","2020-06-18","   0","  106","   4","  0","  106","   4"
"4542","siskiyou","2020-06-18","   1","   65","   4","  1","   64","   3"
"4543","colusa","2020-06-18","   0","   88","   6","  0","   88","   6"
"4544","sutter","2020-06-18","   0","   14","   0","  0","   14","   0"
"4545","san mateo","2020-06-18","  24"," 1089","  59","  8"," 1065","  51"
"4546","san francisco","2020-06-18","  45"," 2647"," 155"," 10"," 2602"," 145"
"4547","mendocino","2020-06-18","   0","  180","   4","  0","  180","   4"
"4548","sonoma","2020-06-18","  16","  871","  64","  4","  855","  60"
"4549","santa cruz","2020-06-18","   4","  397","  10","  1","  393","   9"
"4550","nevada","2020-06-18","   3","  123","   9","  0","  120","   9"
"4551","inyo","2020-06-18","   0","   42","   2","  0","   42","   2"
"4552","kings","2020-06-18","  50","  199","   1"," 10","  149","  -9"
"4553","yolo","2020-06-18","   3","  186","   4","  0","  183","   4"
"4554","calaveras","2020-06-18","   1","   50","   8","  0","   49","   8"
"4555","amador","2020-06-18","   2","   51","   1","  1","   49","   0"
"4556","san bernardino","2020-06-18"," 313"," 4821"," 156"," 95"," 4508","  61"
"4557","ventura","2020-06-18","  77"," 1372","  39"," 23"," 1295","  16"
"4558","san luis obispo","2020-06-18","   8","  450","  19","  3","  442","  16"
"4559","santa clara","2020-06-18","  49"," 3438"," 205"," 19"," 3389"," 186"
"4560","shasta","2020-06-18","   1","  667","   8","  0","  666","   8"
"4561","tulare","2020-06-18","  51","  780","  11","  8","  729","   3"
"4562","humboldt","2020-06-18","   3","  352","   4","  1","  349","   3"
"4563","lake","2020-06-18","   2","  110","   1","  0","  108","   1"
"4564","plumas","2020-06-18","   0","   45","   0","  0","   45","   0"
"4565","solano","2020-06-18","  29","  707","  53","  5","  678","  48"
"4566","lassen","2020-06-18","   0","   25","   0","  0","   25","   0"
"4567","san benito","2020-06-18","   0","   25","   1","  0","   25","   1"
"4568","monterey","2020-06-18","  21","  824","  89","  5","  803","  84"
"4569","madera","2020-06-18","  16","  528","  11","  6","  512","   5"
"4570","merced","2020-06-18","  17","  242","   6","  3","  225","   3"
"4571","mariposa","2020-06-18","   0","   30","   0","  0","   30","   0"
"4572","fresno","2020-06-18","  98"," 2131","  70"," 13"," 2033","  57"
"4573","tuolumne","2020-06-18","   0","  151","   0","  0","  151","   0"
"4574","riverside","2020-06-18"," 421"," 4017","  97"," 97"," 3596","   0"
"4575","san diego","2020-06-18"," 351"," 6190"," 313","151"," 5839"," 162"
"4576","del norte","2020-06-18","   0","   51","   2","  0","   51","   2"
"4577","kern","2020-06-18"," 103"," 1742","  87"," 41"," 1639","  46"
"4578","napa","2020-06-18","   7","  397","   5","  0","  390","   5"
"4579","santa barbara","2020-06-18","  48","  717","  33"," 15","  669","  18"
"4580","el dorado","2020-06-18","   3","  227","   8","  3","  224","   5"
"4581","glenn","2020-06-18","   1","   47","   0","  0","   46","   0"
"4582","marin","2020-06-18","   6","  390","   9","  2","  384","   7"
"4583","imperial","2020-06-18","  73","  237","   6"," 16","  164"," -10"
"4584","los angeles","2020-06-18","1900","23644","1195","491","21744"," 704"
"4585","orange","2020-06-18"," 422"," 6976"," 412","156"," 6554"," 256"
"4586","stanislaus","2020-06-18","  93"," 1369","  88"," 24"," 1276","  64"
"4587","sacramento","2020-06-18","  47"," 2462"," 180"," 14"," 2415"," 166"
"4588","placer","2020-06-18","  19","  753","  60","  5","  734","  55"
"4589","contra costa","2020-06-18","  43"," 1628"," 146"," 14"," 1585"," 132"
"4590","san bernardino","2020-06-19"," 318"," 4821"," 147"," 99"," 4503","  48"
"4591","nevada","2020-06-19","   5","  123","   5","  0","  118","   5"
"4592","colusa","2020-06-19","   0","   88","   6","  0","   88","   6"
"4593","lassen","2020-06-19","   0","   25","   0","  0","   25","   0"
"4594","tehama","2020-06-19","   0","  106","   1","  0","  106","   1"
"4595","glenn","2020-06-19","   0","   47","   0","  0","   47","   0"
"4596","solano","2020-06-19","  24","  707","  49","  6","  683","  43"
"4597","mariposa","2020-06-19","   0","   30","   0","  0","   30","   0"
"4598","tuolumne","2020-06-19","   0","  151","   2","  0","  151","   2"
"4599","el dorado","2020-06-19","   3","  235","   9","  3","  232","   6"
"4600","placer","2020-06-19","  22","  753","  65","  5","  731","  60"
"4601","inyo","2020-06-19","   0","   42","   2","  0","   42","   2"
"4602","mono","2020-06-19","   0","   40","   2","  0","   40","   2"
"4603","orange","2020-06-19"," 410"," 6976"," 420","149"," 6566"," 271"
"4604","merced","2020-06-19","  10","  242","   5","  3","  232","   2"
"4605","san francisco","2020-06-19","  39"," 2647"," 151"," 12"," 2608"," 139"
"4606","butte","2020-06-19","   5","  448","   9","  3","  443","   6"
"4607","sonoma","2020-06-19","   8","  871","  57","  4","  863","  53"
"4608","siskiyou","2020-06-19","   1","   65","   3","  1","   64","   2"
"4609","sacramento","2020-06-19","  54"," 2479"," 180"," 21"," 2425"," 159"
"4610","amador","2020-06-19","   0","   51","   2","  0","   51","   2"
"4611","san luis obispo","2020-06-19","   7","  440","  15","  3","  433","  12"
"4612","alameda","2020-06-19"," 137"," 2968"," 192"," 56"," 2831"," 136"
"4613","los angeles","2020-06-19","1920","23649","1197","481","21729"," 716"
"4614","monterey","2020-06-19","  19","  824","  87","  5","  805","  82"
"4615","san benito","2020-06-19","   0","   25","   2","  0","   25","   2"
"4616","imperial","2020-06-19","  80","  237","   5"," 17","  157"," -12"
"4617","lake","2020-06-19","   0","  110","   1","  0","  110","   1"
"4618","humboldt","2020-06-19","   1","  352","   1","  1","  351","   0"
"4619","del norte","2020-06-19","   0","   51","   5","  0","   51","   5"
"4620","marin","2020-06-19","   5","  390","  12","  3","  385","   9"
"4621","yolo","2020-06-19","   2","  186","   4","  0","  184","   4"
"4622","sutter","2020-06-19","   0","   14","   0","  0","   14","   0"
"4623","madera","2020-06-19","  11","  528","  11","  5","  517","   6"
"4624","ventura","2020-06-19","  81"," 1348","  39"," 20"," 1267","  19"
"4625","santa clara","2020-06-19","  60"," 3438"," 209"," 21"," 3378"," 188"
"4626","san diego","2020-06-19"," 359"," 6214"," 302","153"," 5855"," 149"
"4627","tulare","2020-06-19","  50","  780","   9"," 12","  730","  -3"
"4628","contra costa","2020-06-19","  41"," 1628"," 150"," 10"," 1587"," 140"
"4629","plumas","2020-06-19","   0","   45","   0","  0","   45","   0"
"4630","shasta","2020-06-19","   1","  667","   1","  1","  666","   0"
"4631","modoc","2020-06-19","   0","   41","   0","  0","   41","   0"
"4632","trinity","2020-06-19","   4","   54","   0","  0","   50","   0"
"4633","yuba","2020-06-19","   4","  445","   7","  1","  441","   6"
"4634","kings","2020-06-19","  50","  199","   4"," 10","  149","  -6"
"4635","fresno","2020-06-19"," 101"," 2135","  72"," 18"," 2034","  54"
"4636","santa barbara","2020-06-19","  50","  717","  53"," 18","  667","  35"
"4637","riverside","2020-06-19"," 386"," 4013","  91"," 97"," 3627","  -6"
"4638","santa cruz","2020-06-19","   8","  397","   7","  3","  389","   4"
"4639","san mateo","2020-06-19","  20"," 1089","  61","  5"," 1069","  56"
"4640","mendocino","2020-06-19","   4","  180","   4","  0","  176","   4"
"4641","kern","2020-06-19"," 103"," 1742","  87"," 38"," 1639","  49"
"4642","san joaquin","2020-06-19","  74"," 1376","  56"," 21"," 1302","  35"
"4643","calaveras","2020-06-19","   1","   50","   9","  0","   49","   9"
"4644","napa","2020-06-19","  11","  397","   4","  0","  386","   4"
"4645","stanislaus","2020-06-19","  93"," 1364","  86"," 27"," 1271","  59"
"4646","contra costa","2020-06-20","  51"," 1628"," 145"," 14"," 1577"," 131"
"4647","lassen","2020-06-20","   0","   25","   0","  0","   25","   0"
"4648","modoc","2020-06-20","   0","   41","   0","  0","   41","   0"
"4649","trinity","2020-06-20","   4","   54","   0","  0","   50","   0"
"4650","marin","2020-06-20","   5","  390","   9","  3","  385","   6"
"4651","san francisco","2020-06-20","  56"," 2647"," 140"," 15"," 2591"," 125"
"4652","plumas","2020-06-20","   0","   45","   0","  0","   45","   0"
"4653","calaveras","2020-06-20","   2","   50","   9","  1","   48","   8"
"4654","el dorado","2020-06-20","   2","  235","   9","  2","  233","   7"
"4655","sutter","2020-06-20","   0","   14","   0","  0","   14","   0"
"4656","colusa","2020-06-20","   0","   88","   6","  0","   88","   6"
"4657","riverside","2020-06-20"," 366"," 3959"," 113","100"," 3593","  13"
"4658","orange","2020-06-20"," 446"," 6976"," 410","167"," 6530"," 243"
"4659","mono","2020-06-20","   0","   40","   2","  0","   40","   2"
"4660","san bernardino","2020-06-20"," 330"," 4821"," 149"," 99"," 4491","  50"
"4661","solano","2020-06-20","  32","  707","  47","  7","  675","  40"
"4662","santa cruz","2020-06-20","   7","  397","   9","  2","  390","   7"
"4663","mariposa","2020-06-20","   0","   30","   0","  0","   30","   0"
"4664","placer","2020-06-20","  21","  753","  62","  4","  732","  58"
"4665","nevada","2020-06-20","   6","  123","   4","  1","  117","   3"
"4666","napa","2020-06-20","  10","  397","   5","  0","  387","   5"
"4667","tuolumne","2020-06-20","   0","  151","   4","  0","  151","   4"
"4668","fresno","2020-06-20"," 115"," 2134","  80"," 17"," 2019","  63"
"4669","merced","2020-06-20","  10","  242","   3","  4","  232","  -1"
"4670","alameda","2020-06-20"," 121"," 2968"," 203"," 45"," 2847"," 158"
"4671","los angeles","2020-06-20","1969","23631","1276","495","21662"," 781"
"4672","san benito","2020-06-20","   0","   25","   3","  0","   25","   3"
"4673","san diego","2020-06-20"," 330"," 6169"," 308","148"," 5839"," 160"
"4674","sonoma","2020-06-20","   5","  871","  92","  3","  866","  89"
"4675","mendocino","2020-06-20","   0","  180","   6","  0","  180","   6"
"4676","lake","2020-06-20","   0","  110","   1","  0","  110","   1"
"4677","humboldt","2020-06-20","   1","  352","   4","  1","  351","   3"
"4678","stanislaus","2020-06-20","  97"," 1364","  97"," 27"," 1267","  70"
"4679","del norte","2020-06-20","   0","   51","   5","  0","   51","   5"
"4680","kern","2020-06-20"," 116"," 1742","  89"," 42"," 1626","  47"
"4681","tulare","2020-06-20","  49","  780","   8"," 11","  731","  -3"
"4682","tehama","2020-06-20","   0","  106","   2","  0","  106","   2"
"4683","shasta","2020-06-20","   1","  667","   3","  1","  666","   2"
"4684","imperial","2020-06-20","  89","  237","   4"," 20","  148"," -16"
"4685","glenn","2020-06-20","   0","   47","   0","  0","   47","   0"
"4686","inyo","2020-06-20","   0","   42","   3","  0","   42","   3"
"4687","butte","2020-06-20","   3","  448","  11","  3","  445","   8"
"4688","yuba","2020-06-20","   3","  445","  11","  1","  442","  10"
"4689","kings","2020-06-20","  44","  199","   2","  8","  155","  -6"
"4690","san luis obispo","2020-06-20","   9","  464","  22","  3","  455","  19"
"4691","santa barbara","2020-06-20","  57","  717","  46"," 17","  660","  29"
"4692","monterey","2020-06-20","  19","  824","  81","  5","  805","  76"
"4693","san mateo","2020-06-20","  21"," 1089","  62","  7"," 1068","  55"
"4694","santa clara","2020-06-20","  55"," 3438"," 212"," 21"," 3383"," 191"
"4695","sacramento","2020-06-20","  53"," 2452"," 171"," 23"," 2399"," 148"
"4696","amador","2020-06-20","   0","   51","   1","  0","   51","   1"
"4697","san joaquin","2020-06-20","  87"," 1376","  61"," 28"," 1289","  33"
"4698","yolo","2020-06-20","   3","  186","   3","  1","  183","   2"
"4699","madera","2020-06-20","  10","  528","   8","  3","  518","   5"
"4700","ventura","2020-06-20","  73"," 1352","  40"," 16"," 1279","  24"
"4701","siskiyou","2020-06-20","   1","   65","   4","  1","   64","   3"
"4702","san mateo","2020-06-21","  27"," 1089","  63","  9"," 1062","  54"
"4703","napa","2020-06-21","   8","  397","   5","  0","  389","   5"
"4704","imperial","2020-06-21","  95","  237","   1"," 21","  142"," -20"
"4705","alameda","2020-06-21"," 119"," 2968"," 203"," 42"," 2849"," 161"
"4706","humboldt","2020-06-21","   1","  352","   3","  1","  351","   2"
"4707","mendocino","2020-06-21","   0","  180","  10","  0","  180","  10"
"4708","yolo","2020-06-21","   4","  186","   0","  2","  182","  -2"
"4709","glenn","2020-06-21","   0","   47","   0","  0","   47","   0"
"4710","tehama","2020-06-21","   0","  106","   5","  0","  106","   5"
"4711","trinity","2020-06-21","   3","   54","   0","  0","   51","   0"
"4712","riverside","2020-06-21"," 405"," 3960"," 105","110"," 3555","  -5"
"4713","kings","2020-06-21","  45","  199","   3","  7","  154","  -4"
"4714","siskiyou","2020-06-21","   1","   65","   4","  1","   64","   3"
"4715","san francisco","2020-06-21","  44"," 2647"," 149"," 13"," 2603"," 136"
"4716","santa clara","2020-06-21","  61"," 3438"," 229"," 21"," 3377"," 208"
"4717","san luis obispo","2020-06-21","   6","  461","  26","  2","  455","  24"
"4718","mariposa","2020-06-21","   0","   30","   0","  0","   30","   0"
"4719","monterey","2020-06-21","  18","  824","  82","  6","  806","  76"
"4720","placer","2020-06-21","  20","  753","  56","  2","  733","  54"
"4721","inyo","2020-06-21","   0","   42","   3","  0","   42","   3"
"4722","nevada","2020-06-21","   7","  123","   3","  2","  116","   1"
"4723","yuba","2020-06-21","   3","  445","  11","  2","  442","   9"
"4724","colusa","2020-06-21","   1","   88","   6","  0","   87","   6"
"4725","modoc","2020-06-21","   0","   41","   0","  0","   41","   0"
"4726","plumas","2020-06-21","   0","   45","   0","  0","   45","   0"
"4727","contra costa","2020-06-21","  51"," 1628"," 147"," 17"," 1577"," 130"
"4728","tulare","2020-06-21","  54","  780","  13"," 11","  726","   2"
"4729","marin","2020-06-21","  11","  390","  10","  3","  379","   7"
"4730","del norte","2020-06-21","   0","   51","   6","  0","   51","   6"
"4731","sonoma","2020-06-21","   7","  871","  62","  3","  864","  59"
"4732","santa cruz","2020-06-21","   9","  397","  11","  2","  388","   9"
"4733","san benito","2020-06-21","   0","   25","   3","  0","   25","   3"
"4734","orange","2020-06-21"," 446"," 6976"," 406","171"," 6530"," 235"
"4735","fresno","2020-06-21"," 104"," 2126","  83"," 20"," 2022","  63"
"4736","stanislaus","2020-06-21","  91"," 1369","  96"," 27"," 1278","  69"
"4737","calaveras","2020-06-21","   1","   50","  10","  0","   49","  10"
"4738","sacramento","2020-06-21","  61"," 2450"," 184"," 28"," 2389"," 156"
"4739","lake","2020-06-21","   1","  110","   2","  0","  109","   2"
"4740","el dorado","2020-06-21","   2","  235","   8","  2","  233","   6"
"4741","san joaquin","2020-06-21"," 102"," 1376","  58"," 26"," 1274","  32"
"4742","tuolumne","2020-06-21","   0","  151","   5","  0","  151","   5"
"4743","madera","2020-06-21","   7","  528","  12","  3","  521","   9"
"4744","santa barbara","2020-06-21","  54","  717","  43"," 21","  663","  22"
"4745","los angeles","2020-06-21","2001","23624","1316","492","21623"," 824"
"4746","ventura","2020-06-21","  88"," 1345","  37"," 24"," 1257","  13"
"4747","mono","2020-06-21","   0","   40","   2","  0","   40","   2"
"4748","shasta","2020-06-21","   3","  667","   2","  2","  664","   0"
"4749","merced","2020-06-21","  12","  242","   3","  3","  230","   0"
"4750","butte","2020-06-21","   6","  448","  10","  5","  442","   5"
"4751","amador","2020-06-21","   1","   51","   0","  1","   50","  -1"
"4752","san diego","2020-06-21"," 326"," 6088"," 330","152"," 5762"," 178"
"4753","solano","2020-06-21","  29","  707","  45","  9","  678","  36"
"4754","kern","2020-06-21"," 125"," 1742","  90"," 41"," 1617","  49"
"4755","san bernardino","2020-06-21"," 344"," 4821"," 159","108"," 4477","  51"
"4756","sutter","2020-06-21","   0","   14","   0","  0","   14","   0"
"4757","lassen","2020-06-21","   0","   25","   0","  0","   25","   0"
"4758","monterey","2020-06-22","  21","  824","  91","  7","  803","  84"
"4759","tuolumne","2020-06-22","   0","  151","   4","  0","  151","   4"
"4760","el dorado","2020-06-22","   1","  235","   7","  1","  234","   6"
"4761","placer","2020-06-22","  20","  753","  58","  2","  733","  56"
"4762","amador","2020-06-22","   0","   51","   0","  0","   51","   0"
"4763","sacramento","2020-06-22","  54"," 2458"," 181"," 20"," 2404"," 161"
"4764","kern","2020-06-22"," 129"," 1742","  89"," 44"," 1613","  45"
"4765","inyo","2020-06-22","   0","   42","   3","  0","   42","   3"
"4766","yuba","2020-06-22","   4","  445","   6","  3","  441","   3"
"4767","mariposa","2020-06-22","   0","   30","   0","  0","   30","   0"
"4768","ventura","2020-06-22"," 105"," 1342","  38"," 27"," 1237","  11"
"4769","san mateo","2020-06-22","  23"," 1089","  60"," 10"," 1066","  50"
"4770","plumas","2020-06-22","   0","   45","   0","  0","   45","   0"
"4771","modoc","2020-06-22","   0","   41","   0","  0","   41","   0"
"4772","trinity","2020-06-22","   2","   54","   0","  0","   52","   0"
"4773","san francisco","2020-06-22","  47"," 2337"," 140"," 14"," 2290"," 126"
"4774","riverside","2020-06-22"," 423"," 3960"," 104","109"," 3537","  -5"
"4775","marin","2020-06-22","  13","  390","  14","  4","  377","  10"
"4776","santa clara","2020-06-22","  64"," 3438"," 229"," 25"," 3374"," 204"
"4777","los angeles","2020-06-22","2090","23612","1398","482","21522"," 916"
"4778","santa barbara","2020-06-22","  58","  717","  36"," 21","  659","  15"
"4779","siskiyou","2020-06-22","   1","   65","   4","  1","   64","   3"
"4780","merced","2020-06-22","   9","  242","   4","  3","  233","   1"
"4781","mono","2020-06-22","   0","   40","   2","  0","   40","   2"
"4782","nevada","2020-06-22","   6","  128","   3","  3","  122","   0"
"4783","san bernardino","2020-06-22"," 385"," 4821"," 128","123"," 4436","   5"
"4784","sutter","2020-06-22","   0","   14","   0","  0","   14","   0"
"4785","kings","2020-06-22","  47","  199","   1","  8","  152","  -7"
"4786","colusa","2020-06-22","   1","   88","   6","  0","   87","   6"
"4787","lassen","2020-06-22","   0","   25","   0","  0","   25","   0"
"4788","imperial","2020-06-22","  95","  237","   0"," 17","  142"," -17"
"4789","shasta","2020-06-22","   2","  667","   4","  1","  665","   3"
"4790","madera","2020-06-22","   7","  528","  15","  2","  521","  13"
"4791","napa","2020-06-22","  10","  397","   6","  2","  387","   4"
"4792","yolo","2020-06-22","   1","  186","   0","  1","  185","  -1"
"4793","tehama","2020-06-22","   0","  106","   4","  0","  106","   4"
"4794","del norte","2020-06-22","   0","   51","   6","  0","   51","   6"
"4795","san luis obispo","2020-06-22","   7","  445","  21","  4","  438","  17"
"4796","orange","2020-06-22"," 466"," 6976"," 413","176"," 6510"," 237"
"4797","santa cruz","2020-06-22","  10","  397","  13","  2","  387","  11"
"4798","san benito","2020-06-22","   0","   25","   1","  0","   25","   1"
"4799","san diego","2020-06-22"," 346"," 6067"," 357","155"," 5721"," 202"
"4800","sonoma","2020-06-22","   7","  871","  58","  5","  864","  53"
"4801","san joaquin","2020-06-22"," 141"," 1376","  58"," 27"," 1235","  31"
"4802","lake","2020-06-22","   0","  110","   2","  0","  110","   2"
"4803","stanislaus","2020-06-22","  92"," 1374","  86"," 29"," 1282","  57"
"4804","mendocino","2020-06-22","   0","  180","  10","  0","  180","  10"
"4805","glenn","2020-06-22","   0","   47","   0","  0","   47","   0"
"4806","contra costa","2020-06-22","  51"," 1579"," 164"," 13"," 1528"," 151"
"4807","butte","2020-06-22","   9","  448","  11","  5","  439","   6"
"4808","humboldt","2020-06-22","   1","  352","   3","  0","  351","   3"
"4809","fresno","2020-06-22"," 122"," 2125","  82"," 19"," 2003","  63"
"4810","alameda","2020-06-22"," 112"," 2968"," 196"," 38"," 2856"," 158"
"4811","tulare","2020-06-22","  57","  780","   6"," 10","  723","  -4"
"4812","solano","2020-06-22","  26","  707","  46","  8","  681","  38"
"4813","calaveras","2020-06-22","   0","   50","  10","  0","   50","  10"
"4814","sonoma","2020-06-23","  14","  871","  56"," 10","  857","  46"
"4815","kern","2020-06-23"," 133"," 1742","  87"," 44"," 1609","  43"
"4816","fresno","2020-06-23"," 139"," 2133","  83"," 22"," 1994","  61"
"4817","san diego","2020-06-23"," 370"," 6183"," 338","157"," 5813"," 181"
"4818","los angeles","2020-06-23","2259","23601","1301","516","21342"," 785"
"4819","mariposa","2020-06-23","   0","   30","   0","  0","   30","   0"
"4820","marin","2020-06-23","  14","  390","  15","  4","  376","  11"
"4821","monterey","2020-06-23","  23","  824","  88","  7","  801","  81"
"4822","stanislaus","2020-06-23","  98"," 1374","  84"," 29"," 1276","  55"
"4823","inyo","2020-06-23","   0","   42","   3","  0","   42","   3"
"4824","merced","2020-06-23","  12","  242","   4","  3","  230","   1"
"4825","butte","2020-06-23","   7","  448","  12","  4","  441","   8"
"4826","san luis obispo","2020-06-23","   7","  461","  19","  3","  454","  16"
"4827","lassen","2020-06-23","   0","   25","   0","  0","   25","   0"
"4828","san mateo","2020-06-23","  27"," 1089","  62"," 10"," 1062","  52"
"4829","sacramento","2020-06-23","  65"," 2477"," 171"," 18"," 2412"," 153"
"4830","tehama","2020-06-23","   0","  106","   5","  0","  106","   5"
"4831","tulare","2020-06-23","  61","  780","  16"," 11","  719","   5"
"4832","sutter","2020-06-23","   0","   14","   0","  0","   14","   0"
"4833","yolo","2020-06-23","   1","  186","   2","  1","  185","   1"
"4834","modoc","2020-06-23","   0","   41","   0","  0","   41","   0"
"4835","orange","2020-06-23"," 485"," 6976"," 395","174"," 6491"," 221"
"4836","san bernardino","2020-06-23"," 441"," 4821"," 130","133"," 4380","  -3"
"4837","san francisco","2020-06-23","  53"," 2647"," 145"," 18"," 2594"," 127"
"4838","shasta","2020-06-23","   3","  667","   5","  1","  664","   4"
"4839","plumas","2020-06-23","   0","   45","   0","  0","   45","   0"
"4840","madera","2020-06-23","   7","  528","  15","  1","  521","  14"
"4841","contra costa","2020-06-23","  52"," 1579"," 159"," 10"," 1527"," 149"
"4842","san benito","2020-06-23","   0","   25","   1","  0","   25","   1"
"4843","kings","2020-06-23","  51","  199","   1","  9","  148","  -8"
"4844","el dorado","2020-06-23","   3","  235","   6","  3","  232","   3"
"4845","alameda","2020-06-23"," 128"," 2968"," 196"," 44"," 2840"," 152"
"4846","solano","2020-06-23","  26","  707","  46","  7","  681","  39"
"4847","riverside","2020-06-23"," 434"," 4010","  98","115"," 3576"," -17"
"4848","santa clara","2020-06-23","  72"," 3438"," 225"," 31"," 3366"," 194"
"4849","nevada","2020-06-23","   5","  126","   4","  2","  121","   2"
"4850","yuba","2020-06-23","   7","  445","  10","  1","  438","   9"
"4851","napa","2020-06-23","  14","  397","   3","  1","  383","   2"
"4852","mono","2020-06-23","   0","   40","   2","  0","   40","   2"
"4853","amador","2020-06-23","   0","   51","   0","  0","   51","   0"
"4854","tuolumne","2020-06-23","   1","  151","   5","  0","  150","   5"
"4855","colusa","2020-06-23","   1","   88","   6","  0","   87","   6"
"4856","mendocino","2020-06-23","   0","  180","   7","  0","  180","   7"
"4857","santa cruz","2020-06-23","   9","  397","  12","  1","  388","  11"
"4858","del norte","2020-06-23","   1","   51","   4","  1","   50","   3"
"4859","ventura","2020-06-23","  94"," 1350","  40"," 23"," 1256","  17"
"4860","lake","2020-06-23","   1","  110","   0","  1","  109","  -1"
"4861","santa barbara","2020-06-23","  61","  717","  33"," 24","  656","   9"
"4862","siskiyou","2020-06-23","   1","   65","   2","  1","   64","   1"
"4863","glenn","2020-06-23","   0","   47","   0","  0","   47","   0"
"4864","imperial","2020-06-23","  93","  237","   2"," 18","  144"," -16"
"4865","calaveras","2020-06-23","   1","   50","  12","  0","   49","  12"
"4866","placer","2020-06-23","  13","  753","  62","  2","  740","  60"
"4867","trinity","2020-06-23","   1","   54","   0","  0","   53","   0"
"4868","humboldt","2020-06-23","   2","  352","   1","  1","  350","   0"
"4869","san joaquin","2020-06-23"," 109"," 1376","  61"," 26"," 1267","  35"
"4870","santa barbara","2020-06-24","  57","  717","  53"," 21","  660","  32"
"4871","sutter","2020-06-24","   0","   14","   0","  0","   14","   0"
"4872","ventura","2020-06-24","  86"," 1360","  53"," 23"," 1274","  30"
"4873","inyo","2020-06-24","   1","   42","   4","  0","   41","   4"
"4874","imperial","2020-06-24","  82","  237","   2"," 14","  155"," -12"
"4875","orange","2020-06-24"," 543"," 6976"," 385","186"," 6433"," 199"
"4876","san bernardino","2020-06-24"," 432"," 4821"," 131","125"," 4389","   6"
"4877","san luis obispo","2020-06-24","  11","  484","  37","  3","  473","  34"
"4878","alameda","2020-06-24"," 130"," 2968"," 147"," 40"," 2838"," 107"
"4879","mendocino","2020-06-24","   0","  180","   6","  0","  180","   6"
"4880","lassen","2020-06-24","   0","   25","   0","  0","   25","   0"
"4881","napa","2020-06-24","   7","  397","   0","  5","  390","  -5"
"4882","butte","2020-06-24","   7","  448","   8","  5","  441","   3"
"4883","san mateo","2020-06-24","  29"," 1089","  50"," 11"," 1060","  39"
"4884","kings","2020-06-24","  54","  199","   0","  9","  145","  -9"
"4885","placer","2020-06-24","  16","  753","  54","  3","  737","  51"
"4886","santa cruz","2020-06-24","   9","  397","  12","  1","  388","  11"
"4887","el dorado","2020-06-24","   1","  235","   7","  1","  234","   6"
"4888","modoc","2020-06-24","   0","   41","   0","  0","   41","   0"
"4889","san joaquin","2020-06-24"," 122"," 1376","  52"," 28"," 1254","  24"
"4890","madera","2020-06-24","  13","  528","  15","  2","  515","  13"
"4891","yolo","2020-06-24","   5","  186","   0","  4","  181","  -4"
"4892","yuba","2020-06-24","   5","  445","   7","  1","  440","   6"
"4893","plumas","2020-06-24","   0","   45","   0","  0","   45","   0"
"4894","glenn","2020-06-24","   0","   47","   0","  0","   47","   0"
"4895","sacramento","2020-06-24","  77"," 2491","  97"," 18"," 2414","  79"
"4896","colusa","2020-06-24","   1","   88","   6","  0","   87","   6"
"4897","tulare","2020-06-24","  59","  780","   6","  9","  721","  -3"
"4898","humboldt","2020-06-24","   3","  352","   2","  2","  349","   0"
"4899","marin","2020-06-24","  16","  390","   9","  5","  374","   4"
"4900","siskiyou","2020-06-24","   1","   65","   3","  1","   64","   2"
"4901","mono","2020-06-24","   0","   40","   2","  0","   40","   2"
"4902","tehama","2020-06-24","   0","  106","   5","  0","  106","   5"
"4903","monterey","2020-06-24","  25","  824","  81","  9","  799","  72"
"4904","san francisco","2020-06-24","  55"," 2647"," 105"," 20"," 2592","  85"
"4905","los angeles","2020-06-24","2283","23580","1259","523","21297"," 736"
"4906","santa clara","2020-06-24","  78"," 3438"," 215"," 31"," 3360"," 184"
"4907","sonoma","2020-06-24","   8","  871","  55","  5","  863","  50"
"4908","shasta","2020-06-24","   3","  667","   7","  1","  664","   6"
"4909","san diego","2020-06-24"," 383"," 6195"," 335","167"," 5812"," 168"
"4910","stanislaus","2020-06-24"," 102"," 1374","  81"," 31"," 1272","  50"
"4911","mariposa","2020-06-24","   0","   30","   0","  0","   30","   0"
"4912","fresno","2020-06-24"," 139"," 2113","  86"," 24"," 1974","  62"
"4913","san benito","2020-06-24","   0","   25","   1","  0","   25","   1"
"4914","calaveras","2020-06-24","   0","   50","  11","  0","   50","  11"
"4915","trinity","2020-06-24","   2","   54","   0","  0","   52","   0"
"4916","amador","2020-06-24","   0","   51","   1","  0","   51","   1"
"4917","del norte","2020-06-24","   1","   51","   0","  1","   50","  -1"
"4918","merced","2020-06-24","  17","  242","   2","  4","  225","  -2"
"4919","tuolumne","2020-06-24","   0","  151","   5","  0","  151","   5"
"4920","kern","2020-06-24"," 132"," 1742","  80"," 46"," 1610","  34"
"4921","nevada","2020-06-24","   3","  139","   4","  3","  136","   1"
"4922","solano","2020-06-24","  28","  707","  44","  6","  679","  38"
"4923","contra costa","2020-06-24","  58"," 1579"," 165"," 13"," 1521"," 152"
"4924","lake","2020-06-24","   1","  110","   0","  0","  109","   0"
"4925","riverside","2020-06-24"," 437"," 4010"," 100","122"," 3573"," -22"
"4926","butte","2020-06-25","   6","  448","   5","  2","  442","   3"
"4927","contra costa","2020-06-25","  60"," 1579"," 147"," 15"," 1519"," 132"
"4928","mendocino","2020-06-25","   0","  180","   4","  0","  180","   4"
"4929","monterey","2020-06-25","  24","  824","  78"," 11","  800","  67"
"4930","yuba","2020-06-25","   6","  445","   8","  2","  439","   6"
"4931","riverside","2020-06-25"," 460"," 4010","  86","128"," 3550"," -42"
"4932","trinity","2020-06-25","   2","   54","   0","  0","   52","   0"
"4933","stanislaus","2020-06-25"," 114"," 1374","  94"," 35"," 1260","  59"
"4934","alameda","2020-06-25"," 140"," 2968"," 147"," 44"," 2828"," 103"
"4935","san benito","2020-06-25","   0","   25","   1","  0","   25","   1"
"4936","tulare","2020-06-25","  59","  835","   7"," 11","  776","  -4"
"4937","shasta","2020-06-25","   5","  667","   1","  2","  662","  -1"
"4938","yolo","2020-06-25","   6","  186","   1","  4","  180","  -3"
"4939","solano","2020-06-25","  29","  707","  45","  8","  678","  37"
"4940","mono","2020-06-25","   0","   40","   2","  0","   40","   2"
"4941","nevada","2020-06-25","   4","  121","   3","  4","  117","  -1"
"4942","el dorado","2020-06-25","   1","  235","  11","  1","  234","  10"
"4943","inyo","2020-06-25","   0","   42","   4","  0","   42","   4"
"4944","sonoma","2020-06-25","  11","  871","  54","  6","  860","  48"
"4945","amador","2020-06-25","   0","   51","   1","  0","   51","   1"
"4946","kings","2020-06-25","  57","  199","   4","  8","  142","  -4"
"4947","lake","2020-06-25","   2","  110","   1","  2","  108","  -1"
"4948","glenn","2020-06-25","   0","   47","   0","  0","   47","   0"
"4949","mariposa","2020-06-25","   0","   30","   0","  0","   30","   0"
"4950","santa barbara","2020-06-25","  59","  717","  50"," 26","  658","  24"
"4951","imperial","2020-06-25","  77","  237","   6"," 16","  160"," -10"
"4952","fresno","2020-06-25"," 147"," 2022","  74"," 26"," 1875","  48"
"4953","madera","2020-06-25","  13","  528","  10","  3","  515","   7"
"4954","colusa","2020-06-25","   1","   88","   6","  0","   87","   6"
"4955","tuolumne","2020-06-25","   1","  151","   1","  0","  150","   1"
"4956","lassen","2020-06-25","   0","   25","   0","  0","   25","   0"
"4957","santa cruz","2020-06-25","  13","  397","   9","  2","  384","   7"
"4958","santa clara","2020-06-25","  82"," 3438"," 186"," 26"," 3356"," 160"
"4959","marin","2020-06-25","  16","  390","  13","  6","  374","   7"
"4960","san luis obispo","2020-06-25","   8","  477","  35","  4","  469","  31"
"4961","san joaquin","2020-06-25"," 137"," 1384","  50"," 32"," 1247","  18"
"4962","tehama","2020-06-25","   0","  106","   5","  0","  106","   5"
"4963","ventura","2020-06-25","  98"," 1357","  57"," 22"," 1259","  35"
"4964","siskiyou","2020-06-25","   1","   65","   5","  1","   64","   4"
"4965","san bernardino","2020-06-25"," 436"," 4821"," 119","127"," 4385","  -8"
"4966","san diego","2020-06-25"," 425"," 6148"," 294","168"," 5723"," 126"
"4967","los angeles","2020-06-25","2237","23520","1234","518","21283"," 716"
"4968","humboldt","2020-06-25","   3","  352","   1","  3","  349","  -2"
"4969","plumas","2020-06-25","   0","   45","   0","  0","   45","   0"
"4970","san mateo","2020-06-25","  27"," 1089","  49"," 11"," 1062","  38"
"4971","calaveras","2020-06-25","   2","   50","   9","  1","   48","   8"
"4972","sutter","2020-06-25","   0","   14","   0","  0","   14","   0"
"4973","merced","2020-06-25","  14","  242","   1","  6","  228","  -5"
"4974","modoc","2020-06-25","   0","   41","   0","  0","   41","   0"
"4975","san francisco","2020-06-25","  54"," 2647"," 104"," 17"," 2593","  87"
"4976","del norte","2020-06-25","   1","   51","   1","  1","   50","   0"
"4977","napa","2020-06-25","   5","  397","   5","  4","  392","   1"
"4978","orange","2020-06-25"," 546"," 6976"," 383","189"," 6430"," 194"
"4979","placer","2020-06-25","  16","  753","  50","  3","  737","  47"
"4980","kern","2020-06-25"," 137"," 1742","  78"," 51"," 1605","  27"
"4981","sacramento","2020-06-25","  97"," 2491","  93"," 24"," 2394","  69"
"4982","imperial","2020-06-26","  74","  237","  10"," 15","  163","  -5"
"4983","tehama","2020-06-26","   0","  106","   5","  0","  106","   5"
"4984","shasta","2020-06-26","   6","  667","   3","  2","  661","   1"
"4985","napa","2020-06-26","   7","  397","   6","  5","  390","   1"
"4986","nevada","2020-06-26","   6","  124","   4","  2","  118","   2"
"4987","tulare","2020-06-26","  66","  835","  11"," 12","  769","  -1"
"4988","sacramento","2020-06-26","  83"," 2510","  78"," 21"," 2427","  57"
"4989","humboldt","2020-06-26","   5","  352","   2","  0","  347","   2"
"4990","siskiyou","2020-06-26","   0","   65","   3","  0","   65","   3"
"4991","santa barbara","2020-06-26","  59","  717","  74"," 21","  658","  53"
"4992","del norte","2020-06-26","   1","   51","   2","  1","   50","   1"
"4993","yolo","2020-06-26","   6","  186","   3","  4","  180","  -1"
"4994","modoc","2020-06-26","   1","   41","   0","  0","   40","   0"
"4995","mono","2020-06-26","   0","   40","   1","  0","   40","   1"
"4996","colusa","2020-06-26","   1","   88","   6","  0","   87","   6"
"4997","yuba","2020-06-26","   6","  445","  15","  1","  439","  14"
"4998","kern","2020-06-26"," 147"," 1742","  73"," 48"," 1595","  25"
"4999","butte","2020-06-26","   6","  448","  11","  1","  442","  10"
"5000","merced","2020-06-26","  15","  242","   4","  5","  227","  -1"
"5001","fresno","2020-06-26"," 157"," 2018","  73"," 28"," 1861","  45"
"5002","glenn","2020-06-26","   1","   47","   0","  0","   46","   0"
"5003","kings","2020-06-26","  58","  199","   6","  6","  141","   0"
"5004","san benito","2020-06-26","   0","   25","   1","  0","   25","   1"
"5005","sutter","2020-06-26","   0","   14","   0","  0","   14","   0"
"5006","alameda","2020-06-26"," 133"," 2968"," 123"," 44"," 2835","  79"
"5007","santa clara","2020-06-26","  82"," 3438"," 188"," 26"," 3356"," 162"
"5008","plumas","2020-06-26","   0","   45","   0","  0","   45","   0"
"5009","mendocino","2020-06-26","   0","  180","   6","  0","  180","   6"
"5010","san joaquin","2020-06-26"," 152"," 1430","  44"," 35"," 1278","   9"
"5011","inyo","2020-06-26","   0","   42","   4","  0","   42","   4"
"5012","san francisco","2020-06-26","  68"," 2647","  89"," 22"," 2579","  67"
"5013","placer","2020-06-26","  13","  753","  33","  3","  740","  30"
"5014","calaveras","2020-06-26","   2","   50","  10","  1","   48","   9"
"5015","mariposa","2020-06-26","   0","   30","   0","  0","   30","   0"
"5016","lake","2020-06-26","   1","  110","   1","  1","  109","   0"
"5017","santa cruz","2020-06-26","  14","  397","   9","  1","  383","   8"
"5018","san bernardino","2020-06-26"," 446"," 4821"," 115","133"," 4375"," -18"
"5019","sonoma","2020-06-26","  12","  871","  50","  5","  859","  45"
"5020","san diego","2020-06-26"," 427"," 6176"," 310","171"," 5749"," 139"
"5021","riverside","2020-06-26"," 474"," 4028"," 103","117"," 3554"," -14"
"5022","stanislaus","2020-06-26"," 122"," 1369","  84"," 37"," 1247","  47"
"5023","monterey","2020-06-26","  19","  824","  81"," 10","  805","  71"
"5024","lassen","2020-06-26","   0","   25","   0","  0","   25","   0"
"5025","ventura","2020-06-26"," 100"," 1355","  57"," 24"," 1255","  33"
"5026","amador","2020-06-26","   0","   51","   0","  0","   51","   0"
"5027","madera","2020-06-26","  13","  528","  15","  0","  515","  15"
"5028","tuolumne","2020-06-26","   1","  151","   2","  0","  150","   2"
"5029","trinity","2020-06-26","   1","   54","   0","  0","   53","   0"
"5030","los angeles","2020-06-26","2296","23565","1289","525","21269"," 764"
"5031","orange","2020-06-26"," 560"," 6976"," 396","199"," 6416"," 197"
"5032","el dorado","2020-06-26","   1","  235","   9","  1","  234","   8"
"5033","marin","2020-06-26","  21","  390","  13","  5","  369","   8"
"5034","san luis obispo","2020-06-26","   8","  471","  36","  2","  463","  34"
"5035","solano","2020-06-26","  33","  707","  39","  8","  674","  31"
"5036","san mateo","2020-06-26","  21"," 1089","  55","  8"," 1068","  47"
"5037","contra costa","2020-06-26","  65"," 1579"," 132"," 12"," 1514"," 120"
"5038","stanislaus","2020-06-27"," 129"," 1364","  86"," 35"," 1235","  51"
"5039","lassen","2020-06-27","   0","   25","   0","  0","   25","   0"
"5040","contra costa","2020-06-27","  63"," 1579"," 130"," 13"," 1516"," 117"
"5041","kern","2020-06-27"," 176"," 1742","  70"," 52"," 1566","  18"
"5042","shasta","2020-06-27","   5","  667","   3","  1","  662","   2"
"5043","madera","2020-06-27","  22","  528","  15","  0","  506","  15"
"5044","amador","2020-06-27","   0","   51","   0","  0","   51","   0"
"5045","mendocino","2020-06-27","   0","  180","   5","  0","  180","   5"
"5046","yolo","2020-06-27","   6","  186","   4","  2","  180","   2"
"5047","del norte","2020-06-27","   1","   51","   0","  0","   50","   0"
"5048","tuolumne","2020-06-27","   2","  151","   3","  1","  149","   2"
"5049","marin","2020-06-27","  14","  390","  16","  5","  376","  11"
"5050","fresno","2020-06-27"," 164"," 2016","  73"," 29"," 1852","  44"
"5051","san joaquin","2020-06-27"," 154"," 1430","  47"," 37"," 1276","  10"
"5052","alameda","2020-06-27"," 139"," 2968"," 115"," 47"," 2829","  68"
"5053","napa","2020-06-27","   8","  397","   1","  5","  389","  -4"
"5054","mono","2020-06-27","   0","   40","   2","  0","   40","   2"
"5055","modoc","2020-06-27","   0","   41","   0","  0","   41","   0"
"5056","solano","2020-06-27","  36","  707","  39","  9","  671","  30"
"5057","san luis obispo","2020-06-27","  11","  470","  38","  2","  459","  36"
"5058","inyo","2020-06-27","   0","   42","   3","  0","   42","   3"
"5059","san francisco","2020-06-27","  72"," 2647"," 103"," 25"," 2575","  78"
"5060","glenn","2020-06-27","   1","   47","   0","  0","   46","   0"
"5061","los angeles","2020-06-27","2316","23683","1244","523","21367"," 721"
"5062","merced","2020-06-27","  15","  242","   3","  6","  227","  -3"
"5063","lake","2020-06-27","   3","  110","   0","  2","  107","  -2"
"5064","el dorado","2020-06-27","   2","  235","   9","  2","  233","   7"
"5065","imperial","2020-06-27","  79","  237","   8"," 17","  158","  -9"
"5066","placer","2020-06-27","  14","  753","  36","  3","  739","  33"
"5067","plumas","2020-06-27","   0","   45","   0","  0","   45","   0"
"5068","santa cruz","2020-06-27","  15","  397","   4","  1","  382","   3"
"5069","riverside","2020-06-27"," 485"," 3980","  88","131"," 3495"," -43"
"5070","nevada","2020-06-27","   4","  126","   7","  2","  122","   5"
"5071","san diego","2020-06-27"," 437"," 5950"," 320","168"," 5513"," 152"
"5072","sonoma","2020-06-27","  13","  871","  49","  8","  858","  41"
"5073","tehama","2020-06-27","   0","  106","   3","  0","  106","   3"
"5074","santa clara","2020-06-27","  95"," 3438"," 185"," 29"," 3343"," 156"
"5075","orange","2020-06-27"," 595"," 6976"," 401","192"," 6381"," 209"
"5076","colusa","2020-06-27","   2","   88","   6","  0","   86","   6"
"5077","sacramento","2020-06-27","  94"," 2438","  79"," 28"," 2344","  51"
"5078","san bernardino","2020-06-27"," 432"," 4821"," 124","139"," 4389"," -15"
"5079","mariposa","2020-06-27","   0","   30","   0","  0","   30","   0"
"5080","siskiyou","2020-06-27","   0","   65","   5","  0","   65","   5"
"5081","sutter","2020-06-27","   0","   14","   0","  0","   14","   0"
"5082","kings","2020-06-27","  55","  199","   5","  6","  144","  -1"
"5083","yuba","2020-06-27","   6","  445","   8","  1","  439","   7"
"5084","san benito","2020-06-27","   0","   25","   2","  0","   25","   2"
"5085","san mateo","2020-06-27","  27"," 1089","  54","  9"," 1062","  45"
"5086","trinity","2020-06-27","   1","   54","   0","  0","   53","   0"
"5087","monterey","2020-06-27","  21","  824","  84"," 11","  803","  73"
"5088","ventura","2020-06-27"," 106"," 1348","  46"," 25"," 1242","  21"
"5089","tulare","2020-06-27","  61","  835","  13"," 10","  774","   3"
"5090","calaveras","2020-06-27","   1","   50","   9","  1","   49","   8"
"5091","humboldt","2020-06-27","   4","  352","   1","  1","  348","   0"
"5092","butte","2020-06-27","   5","  448","   5","  2","  443","   3"
"5093","santa barbara","2020-06-27","  65","  717","  70"," 22","  652","  48"
"5094","orange","2020-06-28"," 595"," 6976"," 417","193"," 6381"," 224"
"5095","san diego","2020-06-28"," 458"," 5865"," 314","178"," 5407"," 136"
"5096","san mateo","2020-06-28","  32"," 1089","  54"," 11"," 1057","  43"
"5097","santa clara","2020-06-28"," 105"," 3438"," 187"," 33"," 3333"," 154"
"5098","sonoma","2020-06-28","  12","  871","  48","  7","  859","  41"
"5099","mariposa","2020-06-28","   0","   30","   0","  0","   30","   0"
"5100","madera","2020-06-28","  16","  528","  15","  1","  512","  14"
"5101","kern","2020-06-28"," 155"," 1742","  75"," 54"," 1587","  21"
"5102","lassen","2020-06-28","   0","   25","   0","  0","   25","   0"
"5103","colusa","2020-06-28","   0","   88","   6","  0","   88","   6"
"5104","stanislaus","2020-06-28"," 136"," 1365","  83"," 38"," 1229","  45"
"5105","san francisco","2020-06-28","  69"," 2647"," 103"," 25"," 2578","  78"
"5106","santa barbara","2020-06-28","  69","  717","  73"," 21","  648","  52"
"5107","san luis obispo","2020-06-28","  10","  458","  38","  2","  448","  36"
"5108","monterey","2020-06-28","  26","  824","  79"," 10","  798","  69"
"5109","marin","2020-06-28","  19","  390","  16","  5","  371","  11"
"5110","kings","2020-06-28","  54","  199","   1","  6","  145","  -5"
"5111","modoc","2020-06-28","   0","   41","   0","  0","   41","   0"
"5112","san joaquin","2020-06-28"," 160"," 1430","  52"," 40"," 1270","  12"
"5113","calaveras","2020-06-28","   2","   50","  10","  1","   48","   9"
"5114","contra costa","2020-06-28","  50"," 1579"," 130"," 18"," 1529"," 112"
"5115","butte","2020-06-28","   5","  448","   4","  2","  443","   2"
"5116","tehama","2020-06-28","   0","  106","   2","  0","  106","   2"
"5117","yolo","2020-06-28","   4","  186","   1","  2","  182","  -1"
"5118","fresno","2020-06-28"," 166"," 2012","  68"," 31"," 1846","  37"
"5119","inyo","2020-06-28","   0","   42","   3","  0","   42","   3"
"5120","humboldt","2020-06-28","   4","  352","   1","  1","  348","   0"
"5121","san bernardino","2020-06-28"," 459"," 4821"," 124","147"," 4362"," -23"
"5122","santa cruz","2020-06-28","  19","  397","   7","  0","  378","   7"
"5123","glenn","2020-06-28","   1","   47","   0","  0","   46","   0"
"5124","ventura","2020-06-28","  98"," 1348","  62"," 29"," 1250","  33"
"5125","sacramento","2020-06-28"," 106"," 2435","  70"," 30"," 2329","  40"
"5126","riverside","2020-06-28"," 482"," 3976","  96","124"," 3494"," -28"
"5127","tulare","2020-06-28","  71","  835","   5"," 12","  764","  -7"
"5128","imperial","2020-06-28","  74","  237","   1"," 17","  163"," -16"
"5129","mendocino","2020-06-28","   0","  180","   5","  0","  180","   5"
"5130","lake","2020-06-28","   2","  110","   1","  2","  108","  -1"
"5131","plumas","2020-06-28","   0","   45","   0","  0","   45","   0"
"5132","solano","2020-06-28","  35","  707","  39","  7","  672","  32"
"5133","yuba","2020-06-28","   7","  445","  17","  1","  438","  16"
"5134","napa","2020-06-28","  10","  397","   6","  7","  387","  -1"
"5135","sutter","2020-06-28","   0","   14","   0","  0","   14","   0"
"5136","merced","2020-06-28","  19","  242","   2","  6","  223","  -4"
"5137","nevada","2020-06-28","   4","  125","   2","  3","  121","  -1"
"5138","tuolumne","2020-06-28","   1","  151","   1","  0","  150","   1"
"5139","del norte","2020-06-28","   2","   51","   0","  2","   49","  -2"
"5140","placer","2020-06-28","  18","  753","  33","  4","  735","  29"
"5141","alameda","2020-06-28"," 141"," 2968"," 124"," 45"," 2827","  79"
"5142","el dorado","2020-06-28","   4","  235","   6","  4","  231","   2"
"5143","san benito","2020-06-28","   0","   25","   3","  0","   25","   3"
"5144","trinity","2020-06-28","   4","   54","   0","  0","   50","   0"
"5145","amador","2020-06-28","   0","   51","   0","  0","   51","   0"
"5146","shasta","2020-06-28","  10","  667","   7","  1","  657","   6"
"5147","los angeles","2020-06-28","2465","23562","1320","566","21097"," 754"
"5148","siskiyou","2020-06-28","   0","   65","   4","  0","   65","   4"
"5149","mono","2020-06-28","   0","   40","   2","  0","   40","   2"
"5150","modoc","2020-06-29","   0","   41","   0","  0","   41","   0"
"5151","imperial","2020-06-29","  72","  237","   5"," 16","  165"," -11"
"5152","trinity","2020-06-29","   5","   54","   0","  0","   49","   0"
"5153","sutter","2020-06-29","   0","   14","   0","  0","   14","   0"
"5154","siskiyou","2020-06-29","   0","   65","   4","  0","   65","   4"
"5155","alameda","2020-06-29"," 146"," 2968"," 138"," 44"," 2822","  94"
"5156","del norte","2020-06-29","   1","   51","   0","  1","   50","  -1"
"5157","humboldt","2020-06-29","   3","  352","   2","  1","  349","   1"
"5158","sonoma","2020-06-29","  12","  871","  50","  8","  859","  42"
"5159","stanislaus","2020-06-29"," 142"," 1363","  74"," 38"," 1221","  36"
"5160","shasta","2020-06-29","  12","  667","   7","  1","  655","   6"
"5161","san francisco","2020-06-29","  79"," 2647"," 120"," 26"," 2568","  94"
"5162","tulare","2020-06-29","  80","  835","  12"," 13","  755","  -1"
"5163","napa","2020-06-29","  10","  397","   0","  8","  387","  -8"
"5164","solano","2020-06-29","  44","  707","  42","  8","  663","  34"
"5165","san benito","2020-06-29","   0","   25","   1","  0","   25","   1"
"5166","monterey","2020-06-29","  35","  824","  84","  8","  789","  76"
"5167","santa clara","2020-06-29"," 105"," 3438"," 190"," 33"," 3333"," 157"
"5168","los angeles","2020-06-29","2511","23622","1239","595","21111"," 644"
"5169","placer","2020-06-29","  22","  753","  33","  5","  731","  28"
"5170","sacramento","2020-06-29"," 130"," 2430","  80"," 34"," 2300","  46"
"5171","el dorado","2020-06-29","   2","  235","   9","  2","  233","   7"
"5172","yuba","2020-06-29","   8","  445","  11","  3","  437","   8"
"5173","lassen","2020-06-29","   0","   25","   0","  0","   25","   0"
"5174","butte","2020-06-29","   7","  448","   9","  3","  441","   6"
"5175","lake","2020-06-29","   2","  110","   1","  2","  108","  -1"
"5176","santa cruz","2020-06-29","  16","  397","  12","  1","  381","  11"
"5177","orange","2020-06-29"," 624"," 6976"," 410","200"," 6352"," 210"
"5178","santa barbara","2020-06-29","  70","  717","  79"," 21","  647","  58"
"5179","madera","2020-06-29","  15","  528","  16","  0","  513","  16"
"5180","merced","2020-06-29","  18","  242","   3","  6","  224","  -3"
"5181","fresno","2020-06-29"," 170"," 2005","  76"," 32"," 1835","  44"
"5182","amador","2020-06-29","   1","   51","   1","  1","   50","   0"
"5183","riverside","2020-06-29"," 507"," 4001"," 111","130"," 3494"," -19"
"5184","plumas","2020-06-29","   0","   45","   0","  0","   45","   0"
"5185","inyo","2020-06-29","   0","   42","   2","  0","   42","   2"
"5186","nevada","2020-06-29","   7","  127","   1","  3","  120","  -2"
"5187","tuolumne","2020-06-29","   1","  151","   0","  0","  150","   0"
"5188","colusa","2020-06-29","   0","   88","   6","  0","   88","   6"
"5189","tehama","2020-06-29","   0","  106","   1","  0","  106","   1"
"5190","san diego","2020-06-29"," 493"," 5848"," 324","182"," 5355"," 142"
"5191","glenn","2020-06-29","   0","   47","   0","  0","   47","   0"
"5192","san mateo","2020-06-29","  41"," 1089","  55"," 16"," 1048","  39"
"5193","kern","2020-06-29"," 160"," 1742","  74"," 55"," 1582","  19"
"5194","marin","2020-06-29","  29","  390","   8","  9","  361","  -1"
"5195","mendocino","2020-06-29","   0","  180","   3","  0","  180","   3"
"5196","san luis obispo","2020-06-29","  15","  455","  42","  3","  440","  39"
"5197","mariposa","2020-06-29","   0","   30","   0","  0","   30","   0"
"5198","yolo","2020-06-29","   4","  186","   1","  1","  182","   0"
"5199","san joaquin","2020-06-29"," 159"," 1430","  53"," 38"," 1271","  15"
"5200","mono","2020-06-29","   0","   40","   2","  0","   40","   2"
"5201","calaveras","2020-06-29","   2","   50","  10","  1","   48","   9"
"5202","ventura","2020-06-29"," 111"," 1346","  45"," 30"," 1235","  15"
"5203","kings","2020-06-29","  56","  199","   2","  6","  143","  -4"
"5204","contra costa","2020-06-29","  61"," 1579"," 142"," 19"," 1518"," 123"
"5205","san bernardino","2020-06-29"," 478"," 4821"," 140","148"," 4343","  -8"
"5206","inyo","2020-06-30","   0","   42","   3","  0","   42","   3"
"5207","orange","2020-06-30"," 662"," 6976"," 386","212"," 6314"," 174"
"5208","lake","2020-06-30","   5","  110","   1","  3","  105","  -2"
"5209","kern","2020-06-30"," 175"," 1742","  69"," 61"," 1567","   8"
"5210","alameda","2020-06-30"," 157"," 2968"," 143"," 49"," 2811","  94"
"5211","siskiyou","2020-06-30","   0","   65","   6","  0","   65","   6"
"5212","colusa","2020-06-30","   3","   88","   6","  0","   85","   6"
"5213","yuba","2020-06-30","   5","  445","   8","  3","  440","   5"
"5214","san bernardino","2020-06-30"," 491"," 4821"," 120","163"," 4330"," -43"
"5215","mendocino","2020-06-30","   0","  180","   4","  0","  180","   4"
"5216","riverside","2020-06-30"," 531"," 4001"," 105","138"," 3470"," -33"
"5217","santa cruz","2020-06-30","  16","  397","  15","  1","  381","  14"
"5218","humboldt","2020-06-30","   4","  352","   1","  1","  348","   0"
"5219","marin","2020-06-30","  29","  390","   5"," 11","  361","  -6"
"5220","tuolumne","2020-06-30","   1","  151","   1","  0","  150","   1"
"5221","amador","2020-06-30","   2","   51","   0","  1","   49","  -1"
"5222","sacramento","2020-06-30"," 127"," 2451","  86"," 31"," 2324","  55"
"5223","san joaquin","2020-06-30"," 196"," 1430","  42"," 45"," 1234","  -3"
"5224","glenn","2020-06-30","   0","   47","   0","  0","   47","   0"
"5225","fresno","2020-06-30"," 171"," 2016","  74"," 37"," 1845","  37"
"5226","madera","2020-06-30","  10","  528","  17","  0","  518","  17"
"5227","modoc","2020-06-30","   0","   41","   0","  0","   41","   0"
"5228","calaveras","2020-06-30","   3","   50","  10","  2","   47","   8"
"5229","solano","2020-06-30","  46","  707","  36"," 13","  661","  23"
"5230","mariposa","2020-06-30","   0","   30","   0","  0","   30","   0"
"5231","ventura","2020-06-30"," 119"," 1346","  43"," 34"," 1227","   9"
"5232","santa clara","2020-06-30","  93"," 3438"," 177"," 34"," 3345"," 143"
"5233","sonoma","2020-06-30","  15","  871","  50","  8","  856","  42"
"5234","yolo","2020-06-30","   5","  186","   0","  2","  181","  -2"
"5235","merced","2020-06-30","  16","  242","   3","  5","  226","  -2"
"5236","santa barbara","2020-06-30","  70","  717","  73"," 21","  647","  52"
"5237","plumas","2020-06-30","   0","   45","   0","  0","   45","   0"
"5238","lassen","2020-06-30","   0","   25","   0","  0","   25","   0"
"5239","san benito","2020-06-30","   1","   25","   0","  0","   24","   0"
"5240","san diego","2020-06-30"," 453"," 6164"," 335","173"," 5711"," 162"
"5241","el dorado","2020-06-30","   4","  235","   3","  2","  231","   1"
"5242","imperial","2020-06-30","  74","  237","   3"," 18","  163"," -15"
"5243","shasta","2020-06-30","  12","  667","   9","  2","  655","   7"
"5244","napa","2020-06-30","   9","  397","   1","  8","  388","  -7"
"5245","tulare","2020-06-30","  79","  835","  11"," 14","  756","  -3"
"5246","san mateo","2020-06-30","  47"," 1089","  49"," 19"," 1042","  30"
"5247","trinity","2020-06-30","   0","   54","   0","  0","   54","   0"
"5248","nevada","2020-06-30","   7","  121","   4","  2","  114","   2"
"5249","san francisco","2020-06-30","  80"," 2647"," 113"," 33"," 2567","  80"
"5250","monterey","2020-06-30","  41","  824","  89","  7","  783","  82"
"5251","los angeles","2020-06-30","2538","23639","1170","628","21101"," 542"
"5252","san luis obispo","2020-06-30","  12","  456","  42","  4","  444","  38"
"5253","del norte","2020-06-30","   1","   51","   0","  1","   50","  -1"
"5254","placer","2020-06-30","  24","  753","  35","  5","  729","  30"
"5255","contra costa","2020-06-30","  61"," 1579"," 140"," 23"," 1518"," 117"
"5256","mono","2020-06-30","   0","   40","   2","  0","   40","   2"
"5257","sutter","2020-06-30","   0","   14","   0","  0","   14","   0"
"5258","kings","2020-06-30","  41","  199","   2","  4","  158","  -2"
"5259","butte","2020-06-30","   6","  448","   9","  2","  442","   7"
"5260","stanislaus","2020-06-30"," 170"," 1363","  78"," 39"," 1193","  39"
"5261","tehama","2020-06-30","   0","  106","   1","  0","  106","   1"
"5262","sonoma","2020-07-01","  17","  871","  51","  5","  854","  46"
"5263","inyo","2020-07-01","   0","   42","   4","  0","   42","   4"
"5264","sutter","2020-07-01","   0","   14","   0","  0","   14","   0"
"5265","stanislaus","2020-07-01"," 182"," 1372","  82"," 44"," 1190","  38"
"5266","san joaquin","2020-07-01"," 163"," 1430","  47"," 44"," 1267","   3"
"5267","tuolumne","2020-07-01","   3","  151","   0","  1","  148","  -1"
"5268","orange","2020-07-01"," 705"," 5725"," 346","227"," 5020"," 119"
"5269","tehama","2020-07-01","   0","  106","   4","  0","  106","   4"
"5270","sacramento","2020-07-01"," 136"," 2491","  89"," 38"," 2355","  51"
"5271","mono","2020-07-01","   0","   40","   2","  0","   40","   2"
"5272","lake","2020-07-01","   3","  110","   1","  1","  107","   0"
"5273","napa","2020-07-01","   8","  397","  41","  8","  389","  33"
"5274","marin","2020-07-01","  32","  390","   5"," 12","  358","  -7"
"5275","alameda","2020-07-01"," 170"," 2968"," 141"," 55"," 2798","  86"
"5276","plumas","2020-07-01","   0","   45","   0","  0","   45","   0"
"5277","lassen","2020-07-01","   0","   25","   0","  0","   25","   0"
"5278","nevada","2020-07-01","   6","  122","   4","  2","  116","   2"
"5279","yuba","2020-07-01","   9","  445","   7","  3","  436","   4"
"5280","colusa","2020-07-01","   2","   88","   6","  0","   86","   6"
"5281","butte","2020-07-01","   9","  428","   3","  3","  419","   0"
"5282","contra costa","2020-07-01","  71"," 1579"," 143"," 26"," 1508"," 117"
"5283","tulare","2020-07-01","  83","  835","   9"," 15","  752","  -6"
"5284","humboldt","2020-07-01","   4","  352","   2","  2","  348","   0"
"5285","riverside","2020-07-01"," 547"," 4014"," 106","143"," 3467"," -37"
"5286","mendocino","2020-07-01","   0","  180","   4","  0","  180","   4"
"5287","imperial","2020-07-01","  81","  237","   6"," 19","  156"," -13"
"5288","fresno","2020-07-01"," 149"," 2028","  80"," 37"," 1879","  43"
"5289","el dorado","2020-07-01","   6","  235","   4","  5","  229","  -1"
"5290","placer","2020-07-01","  33","  753","  28","  5","  720","  23"
"5291","amador","2020-07-01","   2","   51","   0","  1","   49","  -1"
"5292","san diego","2020-07-01"," 462"," 6183"," 319","175"," 5721"," 144"
"5293","shasta","2020-07-01","   8","  667","   6","  2","  659","   4"
"5294","san bernardino","2020-07-01"," 516"," 4564","  95","170"," 4048"," -75"
"5295","kings","2020-07-01","  41","  199","   3","  7","  158","  -4"
"5296","merced","2020-07-01","  26","  242","   5","  6","  216","  -1"
"5297","ventura","2020-07-01"," 117"," 1328","  47"," 32"," 1211","  15"
"5298","los angeles","2020-07-01","2580","21731","1092","632","19151"," 460"
"5299","siskiyou","2020-07-01","   0","   65","   3","  0","   65","   3"
"5300","santa clara","2020-07-01"," 100"," 3438"," 168"," 40"," 3338"," 128"
"5301","santa barbara","2020-07-01","  66","  717","  62"," 24","  651","  38"
"5302","san luis obispo","2020-07-01","  14","  472","  40","  4","  458","  36"
"5303","madera","2020-07-01","  22","  528","  17","  6","  506","  11"
"5304","calaveras","2020-07-01","   2","   50","   8","  2","   48","   6"
"5305","yolo","2020-07-01","   5","  186","   1","  2","  181","  -1"
"5306","mariposa","2020-07-01","   0","   30","   0","  0","   30","   0"
"5307","trinity","2020-07-01","   0","   54","   0","  0","   54","   0"
"5308","monterey","2020-07-01","  43","  824","  81"," 10","  781","  71"
"5309","del norte","2020-07-01","   1","   51","   0","  0","   50","   0"
"5310","santa cruz","2020-07-01","  10","  397","  21","  1","  387","  20"
"5311","kern","2020-07-01"," 178"," 1742","  70"," 58"," 1564","  12"
"5312","glenn","2020-07-01","   0","   47","   0","  0","   47","   0"
"5313","san benito","2020-07-01","   1","   25","   1","  0","   24","   1"
"5314","solano","2020-07-01","  57","  707","  36"," 13","  650","  23"
"5315","san francisco","2020-07-01","  85"," 2647"," 110"," 33"," 2562","  77"
"5316","san mateo","2020-07-01","  55"," 1089","  51"," 21"," 1034","  30"
"5317","modoc","2020-07-01","   2","   41","   0","  0","   39","   0"
"5318","san francisco","2020-07-02","  82"," 2647"," 102"," 31"," 2565","  71"
"5319","siskiyou","2020-07-02","   0","   65","   0","  0","   65","   0"
"5320","tehama","2020-07-02","   0","  106","   1","  0","  106","   1"
"5321","yuba","2020-07-02","  11","  445","  16","  3","  434","  13"
"5322","colusa","2020-07-02","   2","   88","   6","  0","   86","   6"
"5323","san mateo","2020-07-02","  56"," 1089","  49"," 15"," 1033","  34"
"5324","placer","2020-07-02","  39","  753","  24","  4","  714","  20"
"5325","riverside","2020-07-02"," 576"," 4014","  92","137"," 3438"," -45"
"5326","kings","2020-07-02","  39","  199","   1","  8","  160","  -7"
"5327","nevada","2020-07-02","   6","  114","   4","  3","  108","   1"
"5328","trinity","2020-07-02","   0","   54","   0","  0","   54","   0"
"5329","amador","2020-07-02","   1","   51","   0","  1","   50","  -1"
"5330","butte","2020-07-02","  12","  428","   3","  6","  416","  -3"
"5331","modoc","2020-07-02","   0","   41","   0","  0","   41","   0"
"5332","alameda","2020-07-02"," 193"," 2968"," 129"," 55"," 2775","  74"
"5333","kern","2020-07-02"," 206"," 1742","  67"," 57"," 1536","  10"
"5334","solano","2020-07-02","  48","  707","  38"," 14","  659","  24"
"5335","san benito","2020-07-02","   1","   25","   1","  0","   24","   1"
"5336","los angeles","2020-07-02","2612","23057","1153","632","20445"," 521"
"5337","ventura","2020-07-02"," 122"," 1363","  54"," 40"," 1241","  14"
"5338","merced","2020-07-02","  23","  242","   2","  5","  219","  -3"
"5339","calaveras","2020-07-02","   3","   50","   9","  2","   47","   7"
"5340","san joaquin","2020-07-02"," 193"," 1430","  54"," 43"," 1237","  11"
"5341","el dorado","2020-07-02","   5","  235","   7","  3","  230","   4"
"5342","yolo","2020-07-02","   9","  186","   4","  0","  177","   4"
"5343","sacramento","2020-07-02"," 149"," 2492","  82"," 40"," 2343","  42"
"5344","inyo","2020-07-02","   0","   42","   3","  0","   42","   3"
"5345","lassen","2020-07-02","   1","   25","   0","  0","   24","   0"
"5346","fresno","2020-07-02"," 145"," 2029","  68"," 35"," 1884","  33"
"5347","tuolumne","2020-07-02","   4","  151","   1","  1","  147","   0"
"5348","santa clara","2020-07-02"," 107"," 3438"," 172"," 35"," 3331"," 137"
"5349","imperial","2020-07-02","  89","  237","   6"," 18","  148"," -12"
"5350","del norte","2020-07-02","   1","   51","   1","  0","   50","   1"
"5351","san bernardino","2020-07-02"," 529"," 4793","  85","169"," 4264"," -84"
"5352","mariposa","2020-07-02","   0","   30","   0","  0","   30","   0"
"5353","stanislaus","2020-07-02"," 209"," 1372","  83"," 48"," 1163","  35"
"5354","mono","2020-07-02","   0","   40","   2","  0","   40","   2"
"5355","san diego","2020-07-02"," 459"," 6182"," 337","159"," 5723"," 178"
"5356","monterey","2020-07-02","  37","  824","  84"," 10","  787","  74"
"5357","marin","2020-07-02","  30","  390","  12","  8","  360","   4"
"5358","santa barbara","2020-07-02","  70","  717","  61"," 25","  647","  36"
"5359","san luis obispo","2020-07-02","  15","  475","  40","  4","  460","  36"
"5360","madera","2020-07-02","  18","  528","  21","  2","  510","  19"
"5361","tulare","2020-07-02","  79","  835","  23"," 12","  756","  11"
"5362","mendocino","2020-07-02","   0","  180","   2","  0","  180","   2"
"5363","orange","2020-07-02"," 716"," 6694"," 326","208"," 5978"," 118"
"5364","lake","2020-07-02","   4","  110","   1","  1","  106","   0"
"5365","sonoma","2020-07-02","  15","  871","  50","  4","  856","  46"
"5366","humboldt","2020-07-02","   1","  352","   2","  1","  351","   1"
"5367","contra costa","2020-07-02","  76"," 1579"," 140"," 24"," 1503"," 116"
"5368","plumas","2020-07-02","   0","   45","   0","  0","   45","   0"
"5369","shasta","2020-07-02","   8","  667","   8","  2","  659","   6"
"5370","santa cruz","2020-07-02","  13","  397","  28","  3","  384","  25"
"5371","sutter","2020-07-02","   0","   14","   0","  0","   14","   0"
"5372","glenn","2020-07-02","   1","   47","   0","  0","   46","   0"
"5373","napa","2020-07-02","   9","  397","  43","  3","  388","  40"
"5374","tehama","2020-07-03","   0","  106","   1","  0","  106","   1"
"5375","alameda","2020-07-03"," 208"," 2968"," 126"," 55"," 2760","  71"
"5376","marin","2020-07-03","  31","  392","  11","  8","  361","   3"
"5377","stanislaus","2020-07-03"," 210"," 1367","  78"," 42"," 1157","  36"
"5378","solano","2020-07-03","  47","  707","  35"," 15","  660","  20"
"5379","contra costa","2020-07-03","  75"," 1579"," 141"," 23"," 1504"," 118"
"5380","imperial","2020-07-03","  85","  298","  17"," 18","  213","  -1"
"5381","san francisco","2020-07-03","  85"," 2647"," 107"," 29"," 2562","  78"
"5382","kings","2020-07-03","  40","  199","   0","  8","  159","  -8"
"5383","glenn","2020-07-03","   1","   47","   0","  0","   46","   0"
"5384","mendocino","2020-07-03","   0","  180","   1","  0","  180","   1"
"5385","amador","2020-07-03","   1","   51","   1","  1","   50","   0"
"5386","madera","2020-07-03","  19","  528","   8","  6","  509","   2"
"5387","sacramento","2020-07-03"," 144"," 2486","  80"," 39"," 2342","  41"
"5388","merced","2020-07-03","  26","  242","   3","  5","  216","  -2"
"5389","santa barbara","2020-07-03","  75","  763","  68"," 22","  688","  46"
"5390","napa","2020-07-03","   8","  397","  43","  4","  389","  39"
"5391","shasta","2020-07-03","   9","  667","   7","  2","  658","   5"
"5392","trinity","2020-07-03","   0","   54","   0","  0","   54","   0"
"5393","nevada","2020-07-03","   5","   96","   7","  3","   91","   4"
"5394","inyo","2020-07-03","   0","   42","   4","  0","   42","   4"
"5395","kern","2020-07-03"," 203"," 1832","  80"," 67"," 1629","  13"
"5396","lassen","2020-07-03","   1","   65","   0","  0","   64","   0"
"5397","siskiyou","2020-07-03","   0","   65","   2","  0","   65","   2"
"5398","santa clara","2020-07-03"," 100"," 3438"," 171"," 38"," 3338"," 133"
"5399","santa cruz","2020-07-03","  17","  397","  26","  3","  380","  23"
"5400","san diego","2020-07-03"," 435"," 6316"," 318","157"," 5881"," 161"
"5401","ventura","2020-07-03"," 123"," 1549","  56"," 31"," 1426","  25"
"5402","mono","2020-07-03","   0","   40","   2","  0","   40","   2"
"5403","monterey","2020-07-03","  36","  845","  85","  8","  809","  77"
"5404","modoc","2020-07-03","   0","   41","   0","  0","   41","   0"
"5405","san benito","2020-07-03","   1","   25","   0","  0","   24","   0"
"5406","del norte","2020-07-03","   1","   51","   0","  0","   50","   0"
"5407","plumas","2020-07-03","   0","   45","   0","  0","   45","   0"
"5408","san bernardino","2020-07-03"," 539"," 4834","  87","169"," 4295"," -82"
"5409","riverside","2020-07-03"," 571"," 4103"," 107","132"," 3532"," -25"
"5410","butte","2020-07-03","   9","  428","   6","  4","  419","   2"
"5411","san mateo","2020-07-03","  60"," 1119","  57"," 17"," 1059","  40"
"5412","tulare","2020-07-03","  78","  835","  25"," 12","  757","  13"
"5413","humboldt","2020-07-03","   1","  352","   2","  1","  351","   1"
"5414","sonoma","2020-07-03","  18","  862","  48","  4","  844","  44"
"5415","lake","2020-07-03","   3","  110","   2","  1","  107","   1"
"5416","tuolumne","2020-07-03","   1","  151","   0","  1","  150","  -1"
"5417","colusa","2020-07-03","   0","   88","   6","  0","   88","   6"
"5418","san luis obispo","2020-07-03","  11","  476","  39","  4","  465","  35"
"5419","los angeles","2020-07-03","2643","23965","1189","650","21322"," 539"
"5420","yuba","2020-07-03","  10","  445","  17","  3","  435","  14"
"5421","sutter","2020-07-03","   0","   14","   0","  0","   14","   0"
"5422","placer","2020-07-03","  45","  753","  29","  3","  708","  26"
"5423","el dorado","2020-07-03","   4","  235","   8","  3","  231","   5"
"5424","calaveras","2020-07-03","   0","   50","  12","  0","   50","  12"
"5425","yolo","2020-07-03","   9","  186","   1","  2","  177","  -1"
"5426","orange","2020-07-03"," 744"," 7401"," 320","217"," 6657"," 103"
"5427","fresno","2020-07-03"," 154"," 2092","  77"," 37"," 1938","  40"
"5428","san joaquin","2020-07-03"," 206"," 1430","  45"," 44"," 1224","   1"
"5429","mariposa","2020-07-03","   0","   30","   0","  0","   30","   0"
"5430","mendocino","2020-07-04","   1","  180","   2","  0","  179","   2"
"5431","contra costa","2020-07-04","  81"," 1562"," 135"," 29"," 1481"," 106"
"5432","san mateo","2020-07-04","  50"," 1057","  63"," 16"," 1007","  47"
"5433","kings","2020-07-04","  48","  199","   2","  8","  151","  -6"
"5434","tuolumne","2020-07-04","   1","  151","   6","  0","  150","   6"
"5435","los angeles","2020-07-04","2574","23943","1336","624","21369"," 712"
"5436","sutter","2020-07-04","   0","   14","   0","  0","   14","   0"
"5437","sonoma","2020-07-04","  26","  862","  51","  6","  836","  45"
"5438","lake","2020-07-04","   4","  110","   2","  1","  106","   1"
"5439","shasta","2020-07-04","   9","  667","   7","  3","  658","   4"
"5440","plumas","2020-07-04","   0","   45","   0","  0","   45","   0"
"5441","glenn","2020-07-04","   1","   47","   0","  0","   46","   0"
"5442","amador","2020-07-04","   1","   51","   0","  1","   50","  -1"
"5443","san francisco","2020-07-04","  82"," 2647"," 102"," 27"," 2565","  75"
"5444","tehama","2020-07-04","   0","  106","   0","  0","  106","   0"
"5445","colusa","2020-07-04","   0","   88","   6","  0","   88","   6"
"5446","santa cruz","2020-07-04","  15","  397","  25","  2","  382","  23"
"5447","monterey","2020-07-04","  39","  845","  88","  8","  806","  80"
"5448","inyo","2020-07-04","   0","   42","   4","  0","   42","   4"
"5449","tulare","2020-07-04","  80","  835","  17"," 11","  755","   6"
"5450","napa","2020-07-04","   7","  397","   0","  4","  390","  -4"
"5451","nevada","2020-07-04","   7","   93","   3","  2","   86","   1"
"5452","trinity","2020-07-04","   0","   54","   0","  0","   54","   0"
"5453","san benito","2020-07-04","   1","   25","   0","  0","   24","   0"
"5454","sacramento","2020-07-04"," 167"," 2465","  87"," 50"," 2298","  37"
"5455","san bernardino","2020-07-04"," 557"," 4834"," 117","174"," 4277"," -57"
"5456","humboldt","2020-07-04","   1","  352","   2","  1","  351","   1"
"5457","san luis obispo","2020-07-04","  12","  476","  38","  5","  464","  33"
"5458","san diego","2020-07-04"," 445"," 6267"," 344","167"," 5822"," 177"
"5459","mariposa","2020-07-04","   0","   30","   0","  0","   30","   0"
"5460","merced","2020-07-04","  24","  242","   4","  3","  218","   1"
"5461","fresno","2020-07-04"," 162"," 2094","  78"," 38"," 1932","  40"
"5462","stanislaus","2020-07-04"," 222"," 1367","  85"," 44"," 1145","  41"
"5463","san joaquin","2020-07-04"," 194"," 1430","  50"," 51"," 1236","  -1"
"5464","marin","2020-07-04","  30","  392","   9","  8","  362","   1"
"5465","madera","2020-07-04","  27","  528","  21","  2","  501","  19"
"5466","alameda","2020-07-04"," 190"," 2968"," 137"," 52"," 2778","  85"
"5467","riverside","2020-07-04"," 600"," 4070"," 120","140"," 3470"," -20"
"5468","imperial","2020-07-04","  91","  298","  16"," 19","  207","  -3"
"5469","santa clara","2020-07-04"," 101"," 3438"," 186"," 38"," 3337"," 148"
"5470","ventura","2020-07-04"," 104"," 1549","  50"," 35"," 1445","  15"
"5471","santa barbara","2020-07-04","  76","  763","  73"," 24","  687","  49"
"5472","siskiyou","2020-07-04","   0","   65","   3","  0","   65","   3"
"5473","el dorado","2020-07-04","   4","  235","   7","  4","  231","   3"
"5474","modoc","2020-07-04","   0","   41","   0","  0","   41","   0"
"5475","lassen","2020-07-04","   1","   65","   0","  0","   64","   0"
"5476","butte","2020-07-04","   8","  408","   4","  5","  400","  -1"
"5477","kern","2020-07-04"," 220"," 1832","  80"," 67"," 1612","  13"
"5478","del norte","2020-07-04","   1","   51","   0","  0","   50","   0"
"5479","orange","2020-07-04"," 772"," 7401"," 403","215"," 6629"," 188"
"5480","yolo","2020-07-04","   9","  186","   1","  2","  177","  -1"
"5481","solano","2020-07-04","  45","  707","  44"," 11","  662","  33"
"5482","mono","2020-07-04","   0","   40","   2","  0","   40","   2"
"5483","placer","2020-07-04","  46","  753","  37","  4","  707","  33"
"5484","calaveras","2020-07-04","   1","   50","  11","  0","   49","  11"
"5485","yuba","2020-07-04","  12","  445","  13","  6","  433","   7"
"5486","contra costa","2020-07-05","  88"," 1579"," 150"," 28"," 1491"," 122"
"5487","san mateo","2020-07-05","  53"," 1050","  67"," 15","  997","  52"
"5488","mendocino","2020-07-05","   0","  180","   2","  0","  180","   2"
"5489","alameda","2020-07-05"," 183"," 2968"," 134"," 58"," 2785","  76"
"5490","riverside","2020-07-05"," 614"," 4065"," 130","148"," 3451"," -18"
"5491","plumas","2020-07-05","   0","   45","   0","  0","   45","   0"
"5492","glenn","2020-07-05","   1","   47","   0","  0","   46","   0"
"5493","shasta","2020-07-05","   7","  667","   5","  3","  660","   2"
"5494","lassen","2020-07-05","   1","   65","   0","  0","   64","   0"
"5495","santa cruz","2020-07-05","  19","  397","  30","  2","  378","  28"
"5496","los angeles","2020-07-05","2645","23936","1295","629","21291"," 666"
"5497","orange","2020-07-05"," 792"," 7401"," 418","226"," 6609"," 192"
"5498","madera","2020-07-05","  21","  528","  18","  4","  507","  14"
"5499","merced","2020-07-05","  24","  242","   3","  4","  218","  -1"
"5500","fresno","2020-07-05"," 163"," 2090","  81"," 40"," 1927","  41"
"5501","yolo","2020-07-05","   8","  186","   0","  2","  178","  -2"
"5502","amador","2020-07-05","   1","   51","   0","  1","   50","  -1"
"5503","nevada","2020-07-05","   9","   89","   3","  2","   80","   1"
"5504","san bernardino","2020-07-05"," 565"," 4834"," 112","175"," 4269"," -63"
"5505","kings","2020-07-05","  47","  199","   5","  8","  152","  -3"
"5506","santa barbara","2020-07-05","  73","  763","  72"," 21","  690","  51"
"5507","yuba","2020-07-05","  16","  445","   6","  7","  429","  -1"
"5508","tulare","2020-07-05","  80","  835","  17","  9","  755","   8"
"5509","mariposa","2020-07-05","   0","   30","   0","  0","   30","   0"
"5510","tuolumne","2020-07-05","   0","  151","   2","  0","  151","   2"
"5511","stanislaus","2020-07-05"," 213"," 1367","  88"," 50"," 1154","  38"
"5512","el dorado","2020-07-05","   2","  235","   7","  2","  233","   5"
"5513","napa","2020-07-05","   7","  397","   5","  4","  390","   1"
"5514","modoc","2020-07-05","   0","   41","   0","  0","   41","   0"
"5515","tehama","2020-07-05","   0","  106","   1","  0","  106","   1"
"5516","san francisco","2020-07-05","  84"," 2647"," 122"," 26"," 2563","  96"
"5517","san luis obispo","2020-07-05","  17","  451","  41","  5","  434","  36"
"5518","kern","2020-07-05"," 222"," 1832","  74"," 64"," 1610","  10"
"5519","sacramento","2020-07-05"," 169"," 2428","  89"," 46"," 2259","  43"
"5520","san joaquin","2020-07-05"," 188"," 1430","  45"," 41"," 1242","   4"
"5521","placer","2020-07-05","  41","  753","  35","  8","  712","  27"
"5522","sonoma","2020-07-05","  30","  862","  52","  9","  832","  43"
"5523","marin","2020-07-05","  40","  392","   7"," 11","  352","  -4"
"5524","imperial","2020-07-05","  93","  298","  15"," 20","  205","  -5"
"5525","siskiyou","2020-07-05","   1","   65","   5","  0","   64","   5"
"5526","santa clara","2020-07-05"," 110"," 3438"," 198"," 35"," 3328"," 163"
"5527","calaveras","2020-07-05","   2","   50","  10","  1","   48","   9"
"5528","ventura","2020-07-05"," 103"," 1549","  39"," 33"," 1446","   6"
"5529","sutter","2020-07-05","   0","   14","   0","  0","   14","   0"
"5530","san diego","2020-07-05"," 441"," 6250"," 350","174"," 5809"," 176"
"5531","mono","2020-07-05","   0","   40","   2","  0","   40","   2"
"5532","trinity","2020-07-05","   0","   54","   0","  0","   54","   0"
"5533","inyo","2020-07-05","   1","   42","   3","  1","   41","   2"
"5534","colusa","2020-07-05","   0","   88","   6","  0","   88","   6"
"5535","butte","2020-07-05","  10","  408","   1","  6","  398","  -5"
"5536","del norte","2020-07-05","   1","   51","   2","  0","   50","   2"
"5537","humboldt","2020-07-05","   2","  352","   2","  1","  350","   1"
"5538","lake","2020-07-05","   4","  110","   2","  0","  106","   2"
"5539","solano","2020-07-05","  47","  707","  40"," 12","  660","  28"
"5540","san benito","2020-07-05","   0","   25","   0","  0","   25","   0"
"5541","monterey","2020-07-05","  40","  845","  91","  6","  805","  85"
"5542","orange","2020-07-06"," 839"," 7416"," 406","250"," 6577"," 156"
"5543","san luis obispo","2020-07-06","  13","  453","  40","  5","  440","  35"
"5544","mariposa","2020-07-06","   0","   30","   0","  0","   30","   0"
"5545","santa cruz","2020-07-06","  13","  397","  29","  2","  384","  27"
"5546","san benito","2020-07-06","   0","   25","   0","  0","   25","   0"
"5547","del norte","2020-07-06","   1","   51","   2","  0","   50","   2"
"5548","marin","2020-07-06","  39","  392","   9","  8","  353","   1"
"5549","solano","2020-07-06","  43","  707","  35"," 16","  664","  19"
"5550","siskiyou","2020-07-06","   0","   65","   4","  0","   65","   4"
"5551","mono","2020-07-06","   0","   40","   2","  0","   40","   2"
"5552","alameda","2020-07-06"," 187"," 2968"," 132"," 60"," 2781","  72"
"5553","fresno","2020-07-06"," 162"," 2094","  89"," 32"," 1932","  57"
"5554","sacramento","2020-07-06"," 172"," 2589","  87"," 46"," 2417","  41"
"5555","santa clara","2020-07-06"," 104"," 3438"," 195"," 35"," 3334"," 160"
"5556","imperial","2020-07-06","  91","  298","  18"," 20","  207","  -2"
"5557","modoc","2020-07-06","   0","   41","   0","  0","   41","   0"
"5558","monterey","2020-07-06","  37","  845","  84","  9","  808","  75"
"5559","ventura","2020-07-06"," 120"," 1549","  47"," 38"," 1429","   9"
"5560","madera","2020-07-06","  32","  528","  22","  4","  496","  18"
"5561","plumas","2020-07-06","   1","   45","   0","  0","   44","   0"
"5562","el dorado","2020-07-06","   2","  235","   5","  2","  233","   3"
"5563","los angeles","2020-07-06","2670","23927","1334","632","21257"," 702"
"5564","sonoma","2020-07-06","  33","  862","  48"," 13","  829","  35"
"5565","calaveras","2020-07-06","   3","   50","   8","  2","   47","   6"
"5566","butte","2020-07-06","  13","  466","   1","  8","  453","  -7"
"5567","san bernardino","2020-07-06"," 574"," 4834"," 129","170"," 4260"," -41"
"5568","riverside","2020-07-06"," 658"," 4110"," 124","146"," 3452"," -22"
"5569","colusa","2020-07-06","   0","   88","   6","  0","   88","   6"
"5570","tulare","2020-07-06","  86","  835","   8"," 13","  749","  -5"
"5571","mendocino","2020-07-06","   0","  180","   6","  0","  180","   6"
"5572","yuba","2020-07-06","  21","  445","  14","  8","  424","   6"
"5573","inyo","2020-07-06","   1","   42","   3","  1","   41","   2"
"5574","sutter","2020-07-06","   0","   14","   0","  0","   14","   0"
"5575","kings","2020-07-06","  52","  199","   0","  8","  147","  -8"
"5576","tuolumne","2020-07-06","   1","  151","   3","  0","  150","   3"
"5577","san diego","2020-07-06"," 456"," 6614"," 339","175"," 6158"," 164"
"5578","shasta","2020-07-06","   6","  671","   9","  3","  665","   6"
"5579","san mateo","2020-07-06","  55"," 1052","  72"," 15","  997","  57"
"5580","humboldt","2020-07-06","   3","  352","   4","  1","  349","   3"
"5581","santa barbara","2020-07-06","  80","  763","  68"," 23","  683","  45"
"5582","stanislaus","2020-07-06"," 206"," 1372","  99"," 46"," 1166","  53"
"5583","amador","2020-07-06","   1","   51","   2","  1","   50","   1"
"5584","placer","2020-07-06","  41","  753","  30"," 10","  712","  20"
"5585","san joaquin","2020-07-06"," 242"," 1430","  46"," 47"," 1188","  -1"
"5586","merced","2020-07-06","  24","  242","   4","  6","  218","  -2"
"5587","kern","2020-07-06"," 223"," 1832","  85"," 61"," 1609","  24"
"5588","nevada","2020-07-06","   6","  114","   6","  1","  108","   5"
"5589","trinity","2020-07-06","   0","   54","   0","  0","   54","   0"
"5590","tehama","2020-07-06","   0","  106","   1","  0","  106","   1"
"5591","lassen","2020-07-06","   1","   65","   0","  0","   64","   0"
"5592","glenn","2020-07-06","   1","   47","   0","  0","   46","   0"
"5593","san francisco","2020-07-06","  80"," 2647"," 120"," 28"," 2567","  92"
"5594","contra costa","2020-07-06","  84"," 1579"," 143"," 30"," 1495"," 113"
"5595","napa","2020-07-06","   7","  397","   5","  6","  390","  -1"
"5596","lake","2020-07-06","   6","  110","   2","  1","  104","   1"
"5597","yolo","2020-07-06","   9","  186","   0","  2","  177","  -2"
"5598","siskiyou","2020-07-07","   0","   65","   6","  0","   65","   6"
"5599","colusa","2020-07-07","   1","   88","   6","  0","   87","   6"
"5600","san bernardino","2020-07-07"," 579"," 4832"," 160","175"," 4253"," -15"
"5601","san francisco","2020-07-07","  88"," 2647"," 107"," 26"," 2559","  81"
"5602","fresno","2020-07-07"," 177"," 2090","  71"," 38"," 1913","  33"
"5603","yolo","2020-07-07","   8","  186","   0","  3","  178","  -3"
"5604","kings","2020-07-07","  54","  199","   7","  7","  145","   0"
"5605","inyo","2020-07-07","   1","   42","   3","  1","   41","   2"
"5606","trinity","2020-07-07","   0","   54","   0","  0","   54","   0"
"5607","contra costa","2020-07-07","  86"," 1579"," 142"," 26"," 1493"," 116"
"5608","sutter","2020-07-07","   0","   14","   0","  0","   14","   0"
"5609","tehama","2020-07-07","   0","  106","   2","  0","  106","   2"
"5610","nevada","2020-07-07","   2","   82","   6","  1","   80","   5"
"5611","kern","2020-07-07"," 223"," 1832","  86"," 58"," 1609","  28"
"5612","placer","2020-07-07","  55","  753","  27","  5","  698","  22"
"5613","tuolumne","2020-07-07","   2","  151","   5","  0","  149","   5"
"5614","madera","2020-07-07","  28","  340","  17","  6","  312","  11"
"5615","santa clara","2020-07-07"," 114"," 3438"," 172"," 44"," 3324"," 128"
"5616","monterey","2020-07-07","  39","  845","  90"," 10","  806","  80"
"5617","imperial","2020-07-07","  93","  298","  16"," 20","  205","  -4"
"5618","sonoma","2020-07-07","  33","  862","  43"," 11","  829","  32"
"5619","mendocino","2020-07-07","   0","  180","   3","  0","  180","   3"
"5620","humboldt","2020-07-07","   3","  352","   3","  0","  349","   3"
"5621","amador","2020-07-07","   2","   51","   3","  1","   49","   2"
"5622","del norte","2020-07-07","   1","   51","   2","  0","   50","   2"
"5623","lake","2020-07-07","   1","  110","   2","  0","  109","   2"
"5624","glenn","2020-07-07","   1","   47","   0","  0","   46","   0"
"5625","mono","2020-07-07","   0","   40","   2","  0","   40","   2"
"5626","sacramento","2020-07-07"," 173"," 2875","  79"," 49"," 2702","  30"
"5627","el dorado","2020-07-07","   3","  235","   9","  3","  232","   6"
"5628","san joaquin","2020-07-07"," 209"," 1430","  52"," 48"," 1221","   4"
"5629","san luis obispo","2020-07-07","  19","  457","  41","  3","  438","  38"
"5630","santa barbara","2020-07-07","  89","  763","  66"," 25","  674","  41"
"5631","san diego","2020-07-07"," 479"," 6649"," 311","166"," 6170"," 145"
"5632","san mateo","2020-07-07","  60"," 1052","  66"," 13","  992","  53"
"5633","plumas","2020-07-07","   1","   45","   0","  0","   44","   0"
"5634","shasta","2020-07-07","   5","  671","   8","  3","  666","   5"
"5635","merced","2020-07-07","  23","  242","   4","  5","  219","  -1"
"5636","marin","2020-07-07","  44","  392","  16","  8","  348","   8"
"5637","napa","2020-07-07","   8","  397","   1","  7","  389","  -6"
"5638","san benito","2020-07-07","   1","   25","   0","  0","   24","   0"
"5639","ventura","2020-07-07"," 116"," 1549","  48"," 38"," 1433","  10"
"5640","stanislaus","2020-07-07"," 215"," 1372","  89"," 51"," 1157","  38"
"5641","los angeles","2020-07-07","2829","23880","1368","630","21051"," 738"
"5642","modoc","2020-07-07","   0","   41","   0","  0","   41","   0"
"5643","lassen","2020-07-07","   0","   65","   0","  0","   65","   0"
"5644","orange","2020-07-07"," 817"," 7416"," 401","251"," 6599"," 150"
"5645","calaveras","2020-07-07","   0","   50","   9","  0","   50","   9"
"5646","santa cruz","2020-07-07","  16","  397","  26","  3","  381","  23"
"5647","solano","2020-07-07","  44","  707","  39"," 17","  663","  22"
"5648","tulare","2020-07-07","  85","  835","  17"," 11","  750","   6"
"5649","alameda","2020-07-07"," 190"," 2968"," 133"," 64"," 2778","  69"
"5650","butte","2020-07-07","  15","  466","   3","  7","  451","  -4"
"5651","riverside","2020-07-07"," 651"," 4110"," 124","136"," 3459"," -12"
"5652","yuba","2020-07-07","  22","  445","  17","  6","  423","  11"
"5653","mariposa","2020-07-07","   0","   30","   0","  0","   30","   0"
"5654","san benito","2020-07-08","   2","   25","   0","  0","   23","   0"
"5655","amador","2020-07-08","   1","   51","   3","  1","   50","   2"
"5656","mariposa","2020-07-08","   0","   30","   0","  0","   30","   0"
"5657","santa clara","2020-07-08"," 125"," 3438"," 192"," 51"," 3313"," 141"
"5658","los angeles","2020-07-08","2817","23875","1311","625","21058"," 686"
"5659","mendocino","2020-07-08","   0","  180","   3","  0","  180","   3"
"5660","plumas","2020-07-08","   0","   45","   0","  0","   45","   0"
"5661","orange","2020-07-08"," 815"," 7416"," 373","253"," 6601"," 120"
"5662","colusa","2020-07-08","   1","   88","   6","  0","   87","   6"
"5663","sonoma","2020-07-08","  35","  862","  50","  7","  827","  43"
"5664","marin","2020-07-08","  43","  392","  15","  9","  349","   6"
"5665","el dorado","2020-07-08","   3","  235","   6","  3","  232","   3"
"5666","tulare","2020-07-08","  80","  835","  22"," 10","  755","  12"
"5667","ventura","2020-07-08"," 111"," 1549","  44"," 37"," 1438","   7"
"5668","del norte","2020-07-08","   0","   51","   1","  0","   51","   1"
"5669","humboldt","2020-07-08","   0","  352","   6","  0","  352","   6"
"5670","san luis obispo","2020-07-08","  18","  460","  39","  3","  442","  36"
"5671","alameda","2020-07-08"," 188"," 2968"," 127"," 63"," 2780","  64"
"5672","shasta","2020-07-08","   7","  671","  10","  3","  664","   7"
"5673","imperial","2020-07-08","  85","  298","   4"," 18","  213"," -14"
"5674","nevada","2020-07-08","   2","  101","   6","  1","   99","   5"
"5675","kings","2020-07-08","  52","  199","   0","  6","  147","  -6"
"5676","calaveras","2020-07-08","   0","   50","   9","  0","   50","   9"
"5677","santa cruz","2020-07-08","  18","  397","  30","  3","  379","  27"
"5678","tuolumne","2020-07-08","   3","  151","   4","  0","  148","   4"
"5679","san mateo","2020-07-08","  60"," 1050","  64"," 15","  990","  49"
"5680","solano","2020-07-08","  45","  707","  42"," 14","  662","  28"
"5681","san diego","2020-07-08"," 483"," 6682"," 305","171"," 6199"," 134"
"5682","glenn","2020-07-08","   1","   47","   0","  0","   46","   0"
"5683","riverside","2020-07-08"," 664"," 4104"," 121","127"," 3440","  -6"
"5684","contra costa","2020-07-08"," 107"," 1579"," 136"," 27"," 1472"," 109"
"5685","monterey","2020-07-08","  44","  845","  89","  9","  801","  80"
"5686","san bernardino","2020-07-08"," 599"," 4838"," 162","153"," 4239","   9"
"5687","trinity","2020-07-08","   0","   54","   0","  0","   54","   0"
"5688","santa barbara","2020-07-08","  86","  763","  52"," 24","  677","  28"
"5689","kern","2020-07-08"," 227"," 1832","  81"," 58"," 1605","  23"
"5690","yuba","2020-07-08","  20","  445","  16","  5","  425","  11"
"5691","inyo","2020-07-08","   1","   42","   2","  1","   41","   1"
"5692","yolo","2020-07-08","  11","  186","   4","  6","  175","  -2"
"5693","madera","2020-07-08","  33","  340","  20","  5","  307","  15"
"5694","lassen","2020-07-08","   1","   65","   0","  0","   64","   0"
"5695","san francisco","2020-07-08","  88"," 2647"," 110"," 28"," 2559","  82"
"5696","tehama","2020-07-08","   0","  106","   4","  0","  106","   4"
"5697","modoc","2020-07-08","   0","   41","   0","  0","   41","   0"
"5698","mono","2020-07-08","   0","   40","   2","  0","   40","   2"
"5699","siskiyou","2020-07-08","   0","   65","   6","  0","   65","   6"
"5700","merced","2020-07-08","  22","  242","   2","  3","  220","  -1"
"5701","lake","2020-07-08","   3","  110","   0","  1","  107","  -1"
"5702","napa","2020-07-08","   8","  397","   2","  5","  389","  -3"
"5703","fresno","2020-07-08"," 206"," 2098","  74"," 43"," 1892","  31"
"5704","stanislaus","2020-07-08"," 215"," 1372","  81"," 55"," 1157","  26"
"5705","sacramento","2020-07-08"," 177"," 2913","  79"," 46"," 2736","  33"
"5706","sutter","2020-07-08","   0","   14","   0","  0","   14","   0"
"5707","san joaquin","2020-07-08"," 244"," 1430","  49"," 54"," 1186","  -5"
"5708","placer","2020-07-08","  56","  753","  26","  7","  697","  19"
"5709","butte","2020-07-08","  14","  492","   5","  7","  478","  -2"
"5710","santa cruz","2020-07-09","  16","  397","  18","  3","  381","  15"
"5711","napa","2020-07-09","   9","  387","   2","  5","  378","  -3"
"5712","tuolumne","2020-07-09","   0","  151","   4","  0","  151","   4"
"5713","mono","2020-07-09","   0","   40","   2","  0","   40","   2"
"5714","yolo","2020-07-09","  15","  186","   1","  5","  171","  -4"
"5715","yuba","2020-07-09","  17","  445","   8","  3","  428","   5"
"5716","lassen","2020-07-09","   1","   65","   0","  0","   64","   0"
"5717","santa barbara","2020-07-09","  82","  763","  53"," 27","  681","  26"
"5718","fresno","2020-07-09"," 229"," 2216","  74"," 42"," 1987","  32"
"5719","orange","2020-07-09"," 800"," 7401"," 402","251"," 6601"," 151"
"5720","el dorado","2020-07-09","   3","  235","   9","  0","  232","   9"
"5721","placer","2020-07-09","  48","  753","  27","  7","  705","  20"
"5722","sutter","2020-07-09","   0","   14","   0","  0","   14","   0"
"5723","marin","2020-07-09","  38","  392","  20","  9","  354","  11"
"5724","san francisco","2020-07-09","  94"," 2647"," 109"," 29"," 2553","  80"
"5725","inyo","2020-07-09","   1","   42","   2","  1","   41","   1"
"5726","modoc","2020-07-09","   0","   41","   0","  0","   41","   0"
"5727","madera","2020-07-09","  30","  340","  18","  4","  310","  14"
"5728","amador","2020-07-09","   1","   51","   0","  1","   50","  -1"
"5729","glenn","2020-07-09","   0","   47","   0","  0","   47","   0"
"5730","del norte","2020-07-09","   0","   51","   2","  0","   51","   2"
"5731","sonoma","2020-07-09","  30","  862","  53","  4","  832","  49"
"5732","nevada","2020-07-09","   3","   91","   3","  1","   88","   2"
"5733","los angeles","2020-07-09","2849","23906","1368","655","21057"," 713"
"5734","solano","2020-07-09","  47","  707","  45"," 14","  660","  31"
"5735","colusa","2020-07-09","   0","   88","   6","  0","   88","   6"
"5736","tulare","2020-07-09","  74","  835","  31"," 10","  761","  21"
"5737","ventura","2020-07-09"," 103"," 1549","  48"," 36"," 1446","  12"
"5738","san diego","2020-07-09"," 489"," 6675"," 309","167"," 6186"," 142"
"5739","merced","2020-07-09","  33","  242","   4","  4","  209","   0"
"5740","tehama","2020-07-09","   0","  106","   4","  0","  106","   4"
"5741","san benito","2020-07-09","   3","   25","   1","  1","   22","   0"
"5742","kings","2020-07-09","  57","  199","   2","  6","  142","  -4"
"5743","lake","2020-07-09","   2","  110","   0","  1","  108","  -1"
"5744","mendocino","2020-07-09","   0","  180","   4","  0","  180","   4"
"5745","calaveras","2020-07-09","   0","   50","   9","  0","   50","   9"
"5746","mariposa","2020-07-09","   0","   33","   0","  0","   33","   0"
"5747","sacramento","2020-07-09"," 181"," 2927","  87"," 48"," 2746","  39"
"5748","butte","2020-07-09","  16","  492","   5"," 10","  476","  -5"
"5749","riverside","2020-07-09"," 690"," 4104"," 129","131"," 3414","  -2"
"5750","humboldt","2020-07-09","   1","  352","  16","  0","  351","  16"
"5751","plumas","2020-07-09","   0","   45","   0","  0","   45","   0"
"5752","siskiyou","2020-07-09","   0","   65","   5","  0","   65","   5"
"5753","shasta","2020-07-09","   6","  671","  10","  3","  665","   7"
"5754","san joaquin","2020-07-09"," 244"," 1430","  41"," 55"," 1186"," -14"
"5755","san bernardino","2020-07-09"," 600"," 4838"," 165","166"," 4238","  -1"
"5756","san luis obispo","2020-07-09","  15","  461","  35","  5","  446","  30"
"5757","imperial","2020-07-09","  77","  298","   9"," 16","  221","  -7"
"5758","santa clara","2020-07-09"," 135"," 3438"," 193"," 49"," 3303"," 144"
"5759","san mateo","2020-07-09","  58"," 1053","  65"," 15","  995","  50"
"5760","alameda","2020-07-09"," 185"," 2968"," 128"," 66"," 2783","  62"
"5761","kern","2020-07-09"," 227"," 1822","  83"," 62"," 1595","  21"
"5762","contra costa","2020-07-09"," 112"," 1579"," 140"," 28"," 1467"," 112"
"5763","monterey","2020-07-09","  47","  845","  93","  9","  798","  84"
"5764","trinity","2020-07-09","   0","   54","   0","  0","   54","   0"
"5765","stanislaus","2020-07-09"," 228"," 1372","  74"," 56"," 1144","  18"
"5766","calaveras","2020-07-10","   0","   50","  10","  0","   50","  10"
"5767","lassen","2020-07-10","   1","   65","   0","  0","   64","   0"
"5768","sonoma","2020-07-10","  36","  862","  53","  7","  826","  46"
"5769","plumas","2020-07-10","   0","   45","   0","  0","   45","   0"
"5770","glenn","2020-07-10","   0","   47","   0","  0","   47","   0"
"5771","orange","2020-07-10"," 785"," 7401"," 390","254"," 6616"," 136"
"5772","shasta","2020-07-10","   6","  671","  18","  3","  665","  15"
"5773","santa clara","2020-07-10"," 142"," 3438"," 181"," 50"," 3296"," 131"
"5774","butte","2020-07-10","  16","  492","   1"," 10","  476","  -9"
"5775","yolo","2020-07-10","  15","  186","   4","  6","  171","  -2"
"5776","san bernardino","2020-07-10"," 642"," 4838"," 197","167"," 4196","  30"
"5777","alameda","2020-07-10"," 183"," 2968"," 122"," 62"," 2785","  60"
"5778","siskiyou","2020-07-10","   2","   65","   6","  0","   63","   6"
"5779","humboldt","2020-07-10","   1","  352","   5","  0","  351","   5"
"5780","san luis obispo","2020-07-10","  17","  468","  40","  4","  451","  36"
"5781","placer","2020-07-10","  49","  753","  25","  8","  704","  17"
"5782","san francisco","2020-07-10","  97"," 2647"," 104"," 34"," 2550","  70"
"5783","santa cruz","2020-07-10","  17","  397","  18","  3","  380","  15"
"5784","marin","2020-07-10","  36","  392","  20"," 10","  356","  10"
"5785","tuolumne","2020-07-10","   2","  151","   4","  0","  149","   4"
"5786","lake","2020-07-10","   3","  110","   1","  1","  107","   0"
"5787","del norte","2020-07-10","   0","   51","   2","  0","   51","   2"
"5788","san joaquin","2020-07-10"," 244"," 1430","  36"," 62"," 1186"," -26"
"5789","yuba","2020-07-10","  20","  445","   8","  4","  425","   4"
"5790","inyo","2020-07-10","   0","   42","   2","  0","   42","   2"
"5791","colusa","2020-07-10","   0","   88","   6","  0","   88","   6"
"5792","mono","2020-07-10","   0","   40","   2","  0","   40","   2"
"5793","solano","2020-07-10","  46","  707","  38"," 11","  661","  27"
"5794","imperial","2020-07-10","  74","  298","   9"," 16","  224","  -7"
"5795","modoc","2020-07-10","   0","   41","   0","  0","   41","   0"
"5796","fresno","2020-07-10"," 235"," 2222","  71"," 46"," 1987","  25"
"5797","sacramento","2020-07-10"," 176"," 2908","  93"," 56"," 2732","  37"
"5798","stanislaus","2020-07-10"," 231"," 1393","  87"," 52"," 1162","  35"
"5799","kern","2020-07-10"," 250"," 1822"," 112"," 64"," 1572","  48"
"5800","trinity","2020-07-10","   0","   54","   0","  0","   54","   0"
"5801","tulare","2020-07-10","  71","  835","  33","  9","  764","  24"
"5802","santa barbara","2020-07-10","  81","  763","  73"," 26","  682","  47"
"5803","tehama","2020-07-10","   0","  106","   3","  0","  106","   3"
"5804","sutter","2020-07-10","   0","   14","   0","  0","   14","   0"
"5805","el dorado","2020-07-10","   2","  235","   7","  2","  233","   5"
"5806","nevada","2020-07-10","   2","   93","   6","  1","   91","   5"
"5807","mendocino","2020-07-10","   2","  180","   7","  0","  178","   7"
"5808","ventura","2020-07-10"," 105"," 1549","  52"," 32"," 1444","  20"
"5809","monterey","2020-07-10","  48","  845","  95"," 10","  797","  85"
"5810","mariposa","2020-07-10","   0","   33","   0","  0","   33","   0"
"5811","riverside","2020-07-10"," 681"," 4123"," 146","130"," 3442","  16"
"5812","contra costa","2020-07-10"," 107"," 1579"," 136"," 29"," 1472"," 107"
"5813","napa","2020-07-10","   7","  387","   2","  5","  380","  -3"
"5814","los angeles","2020-07-10","2777","23901","1327","631","21124"," 696"
"5815","san mateo","2020-07-10","  62"," 1056","  56"," 18","  994","  38"
"5816","merced","2020-07-10","  38","  242","   4","  6","  204","  -2"
"5817","amador","2020-07-10","   2","   51","   1","  1","   49","   0"
"5818","madera","2020-07-10","  41","  340","  14"," 11","  299","   3"
"5819","san benito","2020-07-10","   4","   25","   2","  1","   21","   1"
"5820","san diego","2020-07-10"," 490"," 6687"," 313","173"," 6197"," 140"
"5821","kings","2020-07-10","  58","  199","   2","  6","  141","  -4"
"5822","orange","2020-07-11"," 786"," 7401"," 378","251"," 6615"," 127"
"5823","fresno","2020-07-11"," 239"," 2223","  78"," 42"," 1984","  36"
"5824","marin","2020-07-11","  35","  392","  21"," 10","  357","  11"
"5825","inyo","2020-07-11","   0","   42","   2","  0","   42","   2"
"5826","merced","2020-07-11","  34","  242","   3","  5","  208","  -2"
"5827","del norte","2020-07-11","   0","   51","   0","  0","   51","   0"
"5828","sutter","2020-07-11","   0","   14","   0","  0","   14","   0"
"5829","lassen","2020-07-11","   3","   65","   0","  0","   62","   0"
"5830","calaveras","2020-07-11","   0","   50","   9","  0","   50","   9"
"5831","santa cruz","2020-07-11","  17","  397","  18","  3","  380","  15"
"5832","san diego","2020-07-11"," 466"," 6441"," 300","158"," 5975"," 142"
"5833","amador","2020-07-11","   0","   51","   3","  0","   51","   3"
"5834","yuba","2020-07-11","  21","  445","  14","  4","  424","  10"
"5835","sacramento","2020-07-11"," 180"," 2874","  82"," 58"," 2694","  24"
"5836","imperial","2020-07-11","  76","  298","  10"," 17","  222","  -7"
"5837","santa clara","2020-07-11"," 141"," 3432"," 173"," 53"," 3291"," 120"
"5838","glenn","2020-07-11","   1","   47","   0","  0","   46","   0"
"5839","solano","2020-07-11","  52","  707","  38"," 13","  655","  25"
"5840","san bernardino","2020-07-11"," 652"," 4838"," 145","176"," 4186"," -31"
"5841","tulare","2020-07-11","  77","  835","  23"," 10","  758","  13"
"5842","riverside","2020-07-11"," 647"," 4068"," 148","133"," 3421","  15"
"5843","san joaquin","2020-07-11"," 232"," 1430","  33"," 61"," 1198"," -28"
"5844","nevada","2020-07-11","   2","  100","   6","  1","   98","   5"
"5845","santa barbara","2020-07-11","  81","  763","  56"," 25","  682","  31"
"5846","mariposa","2020-07-11","   0","   33","   0","  0","   33","   0"
"5847","stanislaus","2020-07-11"," 218"," 1393","  75"," 49"," 1175","  26"
"5848","mendocino","2020-07-11","   2","  180","   7","  0","  178","   7"
"5849","ventura","2020-07-11"," 100"," 1549","  48"," 34"," 1449","  14"
"5850","alameda","2020-07-11"," 188"," 2968"," 121"," 60"," 2780","  61"
"5851","shasta","2020-07-11","   5","  671","   4","  3","  666","   1"
"5852","plumas","2020-07-11","   0","   45","   0","  0","   45","   0"
"5853","humboldt","2020-07-11","   1","  352","   5","  0","  351","   5"
"5854","colusa","2020-07-11","   2","   88","   6","  0","   86","   6"
"5855","san francisco","2020-07-11","  97"," 2647"," 112"," 35"," 2550","  77"
"5856","napa","2020-07-11","   8","  387","   4","  4","  379","   0"
"5857","san mateo","2020-07-11","  59"," 1054","  54"," 17","  995","  37"
"5858","san luis obispo","2020-07-11","  11","  463","  40","  4","  452","  36"
"5859","san benito","2020-07-11","   3","   25","   2","  0","   22","   2"
"5860","siskiyou","2020-07-11","   1","   65","   6","  0","   64","   6"
"5861","madera","2020-07-11","  36","  340","  14","  6","  304","   8"
"5862","yolo","2020-07-11","  11","  186","   0","  6","  175","  -6"
"5863","kern","2020-07-11"," 273"," 1822","  82"," 60"," 1549","  22"
"5864","monterey","2020-07-11","  42","  845","  94"," 10","  803","  84"
"5865","los angeles","2020-07-11","2769","23980","1352","650","21211"," 702"
"5866","lake","2020-07-11","   4","  110","   1","  1","  106","   0"
"5867","tuolumne","2020-07-11","   1","  151","   1","  1","  150","   0"
"5868","kings","2020-07-11","  65","  199","   2","  6","  134","  -4"
"5869","butte","2020-07-11","  16","  492","   0"," 10","  476"," -10"
"5870","contra costa","2020-07-11"," 103"," 1579"," 124"," 26"," 1476","  98"
"5871","placer","2020-07-11","  61","  776","  27"," 10","  715","  17"
"5872","modoc","2020-07-11","   0","   41","   0","  0","   41","   0"
"5873","mono","2020-07-11","   0","   40","   2","  0","   40","   2"
"5874","sonoma","2020-07-11","  33","  862","  55","  5","  829","  50"
"5875","tehama","2020-07-11","   1","  106","   0","  1","  105","  -1"
"5876","trinity","2020-07-11","   0","   54","   0","  0","   54","   0"
"5877","el dorado","2020-07-11","   2","  235","   9","  2","  233","   7"
"5878","san francisco","2020-07-12","  94"," 2647"," 122"," 36"," 2553","  86"
"5879","sacramento","2020-07-12"," 200"," 2860","  87"," 67"," 2660","  20"
"5880","yuba","2020-07-12","  19","  445","  10","  5","  426","   5"
"5881","inyo","2020-07-12","   0","   42","   2","  0","   42","   2"
"5882","trinity","2020-07-12","   0","   54","   0","  0","   54","   0"
"5883","tulare","2020-07-12","  89","  835","  13"," 11","  746","   2"
"5884","san luis obispo","2020-07-12","  13","  459","  42","  4","  446","  38"
"5885","stanislaus","2020-07-12"," 230"," 1397","  69"," 44"," 1167","  25"
"5886","modoc","2020-07-12","   0","   41","   0","  0","   41","   0"
"5887","santa cruz","2020-07-12","  17","  397","  23","  2","  380","  21"
"5888","siskiyou","2020-07-12","   2","   65","   6","  0","   63","   6"
"5889","del norte","2020-07-12","   0","   51","   4","  0","   51","   4"
"5890","san mateo","2020-07-12","  65"," 1057","  55"," 17","  992","  38"
"5891","alameda","2020-07-12"," 187"," 2968"," 139"," 59"," 2781","  80"
"5892","plumas","2020-07-12","   0","   45","   0","  0","   45","   0"
"5893","madera","2020-07-12","  35","  340","  27","  3","  305","  24"
"5894","nevada","2020-07-12","   1","   96","   5","  0","   95","   5"
"5895","san bernardino","2020-07-12"," 669"," 4838"," 177","178"," 4169","  -1"
"5896","marin","2020-07-12","  30","  392","  23"," 10","  362","  13"
"5897","tuolumne","2020-07-12","   2","  151","   5","  0","  149","   5"
"5898","amador","2020-07-12","   0","   51","   3","  0","   51","   3"
"5899","napa","2020-07-12","   8","  387","   0","  5","  379","  -5"
"5900","lake","2020-07-12","   4","  110","   0","  1","  106","  -1"
"5901","mendocino","2020-07-12","   2","  180","   7","  0","  178","   7"
"5902","san benito","2020-07-12","   2","   25","   3","  0","   23","   3"
"5903","mariposa","2020-07-12","   0","   33","   0","  0","   33","   0"
"5904","shasta","2020-07-12","   3","  671","   3","  2","  668","   1"
"5905","humboldt","2020-07-12","   2","  352","   5","  0","  350","   5"
"5906","orange","2020-07-12"," 758"," 7401"," 443","245"," 6643"," 198"
"5907","sonoma","2020-07-12","  34","  862","  50","  7","  828","  43"
"5908","calaveras","2020-07-12","   2","   50","  10","  0","   48","  10"
"5909","lassen","2020-07-12","   2","   65","   0","  0","   63","   0"
"5910","merced","2020-07-12","  38","  242","   3","  5","  204","  -2"
"5911","riverside","2020-07-12"," 635"," 4062"," 186","148"," 3427","  38"
"5912","colusa","2020-07-12","   4","   88","   6","  0","   84","   6"
"5913","ventura","2020-07-12"," 109"," 1549","  45"," 36"," 1440","   9"
"5914","solano","2020-07-12","  51","  707","  37"," 10","  656","  27"
"5915","placer","2020-07-12","  63","  776","  20"," 11","  713","   9"
"5916","el dorado","2020-07-12","   3","  235","   5","  3","  232","   2"
"5917","butte","2020-07-12","  17","  492","   2","  9","  475","  -7"
"5918","glenn","2020-07-12","   1","   47","   0","  0","   46","   0"
"5919","contra costa","2020-07-12"," 105"," 1579"," 125"," 27"," 1474","  98"
"5920","fresno","2020-07-12"," 241"," 2208","  65"," 42"," 1967","  23"
"5921","sutter","2020-07-12","   0","   14","   0","  0","   14","   0"
"5922","tehama","2020-07-12","   2","  106","   1","  1","  104","   0"
"5923","yolo","2020-07-12","  11","  186","   2","  4","  175","  -2"
"5924","los angeles","2020-07-12","2773","23868","1502","643","21095"," 859"
"5925","santa barbara","2020-07-12","  84","  763","  57"," 23","  679","  34"
"5926","imperial","2020-07-12","  73","  298","   9"," 17","  225","  -8"
"5927","kings","2020-07-12","  64","  199","   2","  6","  135","  -4"
"5928","san joaquin","2020-07-12"," 237"," 1430","  38"," 61"," 1193"," -23"
"5929","monterey","2020-07-12","  43","  845","  93"," 10","  802","  83"
"5930","kern","2020-07-12"," 255"," 1822","  86"," 57"," 1567","  29"
"5931","san diego","2020-07-12"," 467"," 6398"," 370","159"," 5931"," 211"
"5932","mono","2020-07-12","   0","   40","   2","  0","   40","   2"
"5933","santa clara","2020-07-12"," 149"," 3432"," 189"," 53"," 3283"," 136"
"5934","lake","2020-07-13","   6","  110","   1","  2","  104","  -1"
"5935","lassen","2020-07-13","   1","   65","   0","  0","   64","   0"
"5936","napa","2020-07-13","  11","  387","   4","  7","  376","  -3"
"5937","inyo","2020-07-13","   0","   42","   4","  0","   42","   4"
"5938","monterey","2020-07-13","  51","  845","  93"," 10","  794","  83"
"5939","marin","2020-07-13","  29","  392","  27","  8","  363","  19"
"5940","san mateo","2020-07-13","  82"," 1057","  59"," 16","  975","  43"
"5941","el dorado","2020-07-13","   2","  235","   8","  2","  233","   6"
"5942","placer","2020-07-13","  67","  766","  25"," 11","  699","  14"
"5943","yuba","2020-07-13","  19","  445","  12","  4","  426","   8"
"5944","amador","2020-07-13","   1","   51","   3","  1","   50","   2"
"5945","merced","2020-07-13","  34","  242","   3","  5","  208","  -2"
"5946","mono","2020-07-13","   0","   40","   1","  0","   40","   1"
"5947","plumas","2020-07-13","   0","   45","   0","  0","   45","   0"
"5948","san francisco","2020-07-13"," 109"," 2647"," 126"," 33"," 2538","  93"
"5949","modoc","2020-07-13","   1","   41","   0","  0","   40","   0"
"5950","santa cruz","2020-07-13","  20","  397","  37","  2","  377","  35"
"5951","stanislaus","2020-07-13"," 240"," 1388","  74"," 42"," 1148","  32"
"5952","siskiyou","2020-07-13","   2","   65","   8","  0","   63","   8"
"5953","riverside","2020-07-13"," 662"," 4092"," 177","149"," 3430","  28"
"5954","kern","2020-07-13"," 253"," 1822","  71"," 62"," 1569","   9"
"5955","contra costa","2020-07-13"," 110"," 1579"," 134"," 30"," 1469"," 104"
"5956","butte","2020-07-13","  17","  492","   4","  9","  475","  -5"
"5957","san diego","2020-07-13"," 458"," 6392"," 360","163"," 5934"," 197"
"5958","calaveras","2020-07-13","   3","   50","  10","  2","   47","   8"
"5959","del norte","2020-07-13","   1","   51","   0","  0","   50","   0"
"5960","sonoma","2020-07-13","  38","  858","  40"," 10","  820","  30"
"5961","ventura","2020-07-13"," 124"," 1549","  54"," 36"," 1425","  18"
"5962","fresno","2020-07-13"," 252"," 2218","  59"," 50"," 1966","   9"
"5963","tuolumne","2020-07-13","   1","  151","   4","  0","  150","   4"
"5964","santa barbara","2020-07-13","  88","  763","  60"," 28","  675","  32"
"5965","los angeles","2020-07-13","2805","23866","1367","668","21061"," 699"
"5966","sutter","2020-07-13","   0","   14","   0","  0","   14","   0"
"5967","imperial","2020-07-13","  81","  298","   7"," 22","  217"," -15"
"5968","mariposa","2020-07-13","   0","   33","   0","  0","   33","   0"
"5969","kings","2020-07-13","  62","  199","   0","  6","  137","  -6"
"5970","alameda","2020-07-13"," 200"," 2968"," 144"," 61"," 2768","  83"
"5971","nevada","2020-07-13","   3","  106","   5","  0","  103","   5"
"5972","santa clara","2020-07-13"," 166"," 3433"," 190"," 51"," 3267"," 139"
"5973","humboldt","2020-07-13","   1","  352","   6","  0","  351","   6"
"5974","shasta","2020-07-13","   4","  671","   4","  2","  667","   2"
"5975","mendocino","2020-07-13","   0","  180","  11","  0","  180","  11"
"5976","solano","2020-07-13","  55","  707","  37"," 13","  652","  24"
"5977","sacramento","2020-07-13"," 201"," 2863","  66"," 68"," 2662","  -2"
"5978","madera","2020-07-13","  38","  340","  11","  3","  302","   8"
"5979","tulare","2020-07-13","  92","  835","  13","  9","  743","   4"
"5980","san luis obispo","2020-07-13","  14","  459","  44","  4","  445","  40"
"5981","trinity","2020-07-13","   0","   54","   0","  0","   54","   0"
"5982","san joaquin","2020-07-13"," 247"," 1430","  39"," 56"," 1183"," -17"
"5983","san bernardino","2020-07-13"," 680"," 4838"," 168","179"," 4158"," -11"
"5984","san benito","2020-07-13","   2","   25","   3","  0","   23","   3"
"5985","yolo","2020-07-13","  12","  186","   3","  7","  174","  -4"
"5986","orange","2020-07-13"," 795"," 7401"," 425","251"," 6606"," 174"
"5987","colusa","2020-07-13","   4","   88","   6","  0","   84","   6"
"5988","tehama","2020-07-13","   1","  106","   1","  1","  105","   0"
"5989","glenn","2020-07-13","   0","   47","   0","  0","   47","   0"
"5990","santa barbara","2020-07-14","  91","  763","  56"," 29","  672","  27"
"5991","solano","2020-07-14","  52","  707","  45"," 11","  655","  34"
"5992","yolo","2020-07-14","  22","  186","   3","  8","  164","  -5"
"5993","santa cruz","2020-07-14","  20","  397","  31","  3","  377","  28"
"5994","glenn","2020-07-14","   0","   47","   0","  0","   47","   0"
"5995","shasta","2020-07-14","   5","  671","  15","  3","  666","  12"
"5996","el dorado","2020-07-14","   2","  235","   9","  2","  233","   7"
"5997","lake","2020-07-14","   2","  110","   2","  0","  108","   2"
"5998","ventura","2020-07-14"," 120"," 1549","  46"," 37"," 1429","   9"
"5999","mariposa","2020-07-14","   0","   33","   0","  0","   33","   0"
"6000","inyo","2020-07-14","   0","   42","   3","  0","   42","   3"
"6001","siskiyou","2020-07-14","   4","   65","   5","  0","   61","   5"
"6002","sacramento","2020-07-14"," 195"," 2879","  72"," 62"," 2684","  10"
"6003","monterey","2020-07-14","  50","  845","  89","  9","  795","  80"
"6004","tulare","2020-07-14","  89","  835","  14","  7","  746","   7"
"6005","los angeles","2020-07-14","2899","23862","1297","675","20963"," 622"
"6006","santa clara","2020-07-14"," 169"," 3435"," 155"," 55"," 3266"," 100"
"6007","madera","2020-07-14","  40","  340","  18","  3","  300","  15"
"6008","colusa","2020-07-14","   3","   88","   6","  0","   85","   6"
"6009","san bernardino","2020-07-14"," 676"," 4838"," 158","179"," 4162"," -21"
"6010","marin","2020-07-14","  34","  392","  26","  9","  358","  17"
"6011","plumas","2020-07-14","   0","   45","   0","  0","   45","   0"
"6012","san benito","2020-07-14","   2","   25","   3","  0","   23","   3"
"6013","humboldt","2020-07-14","   1","  352","   6","  0","  351","   6"
"6014","nevada","2020-07-14","   2","   98","   2","  0","   96","   2"
"6015","lassen","2020-07-14","   1","   65","   0","  0","   64","   0"
"6016","yuba","2020-07-14","  20","  445","   9","  5","  425","   4"
"6017","napa","2020-07-14","   8","  387","   3","  3","  379","   0"
"6018","trinity","2020-07-14","   0","   54","   0","  0","   54","   0"
"6019","placer","2020-07-14","  72","  770","  12"," 13","  698","  -1"
"6020","san francisco","2020-07-14"," 105"," 2647"," 110"," 31"," 2542","  79"
"6021","modoc","2020-07-14","   0","   41","   0","  0","   41","   0"
"6022","stanislaus","2020-07-14"," 238"," 1393","  77"," 46"," 1155","  31"
"6023","kern","2020-07-14"," 254"," 1822","  77"," 62"," 1568","  15"
"6024","amador","2020-07-14","   2","   51","   1","  1","   49","   0"
"6025","kings","2020-07-14","  69","  199","   0","  9","  130","  -9"
"6026","san mateo","2020-07-14","  77"," 1057","  55"," 14","  980","  41"
"6027","fresno","2020-07-14"," 270"," 2045","  56"," 48"," 1775","   8"
"6028","imperial","2020-07-14","  85","  298","   6"," 24","  213"," -18"
"6029","calaveras","2020-07-14","   4","   50","   9","  3","   46","   6"
"6030","san luis obispo","2020-07-14","  10","  468","  39","  5","  458","  34"
"6031","butte","2020-07-14","  18","  492","   0","  9","  474","  -9"
"6032","san joaquin","2020-07-14"," 236"," 1430","  34"," 59"," 1194"," -25"
"6033","alameda","2020-07-14"," 204"," 2968"," 144"," 64"," 2764","  80"
"6034","orange","2020-07-14"," 809"," 7401"," 404","247"," 6592"," 157"
"6035","sonoma","2020-07-14","  41","  858","  39"," 11","  817","  28"
"6036","mendocino","2020-07-14","   0","  180","   8","  0","  180","   8"
"6037","tuolumne","2020-07-14","   3","  151","   3","  0","  148","   3"
"6038","contra costa","2020-07-14"," 112"," 1579"," 128"," 32"," 1467","  96"
"6039","merced","2020-07-14","  37","  242","   6","  7","  205","  -1"
"6040","tehama","2020-07-14","   1","  106","   0","  1","  105","  -1"
"6041","del norte","2020-07-14","   1","   51","   0","  0","   50","   0"
"6042","san diego","2020-07-14"," 482"," 6674"," 349","168"," 6192"," 181"
"6043","sutter","2020-07-14","   0","   14","   0","  0","   14","   0"
"6044","riverside","2020-07-14"," 716"," 4129"," 166","156"," 3413","  10"
"6045","mono","2020-07-14","   0","   40","   2","  0","   40","   2"
"6046","calaveras","2020-07-15","   3","   50","   9","  3","   47","   6"
"6047","san mateo","2020-07-15","  77"," 1057","  57"," 16","  980","  41"
"6048","riverside","2020-07-15"," 682"," 4141"," 158","148"," 3459","  10"
"6049","plumas","2020-07-15","   0","   45","   0","  0","   45","   0"
"6050","glenn","2020-07-15","   0","   47","   0","  0","   47","   0"
"6051","yuba","2020-07-15","  20","  445","   9","  5","  425","   4"
"6052","mono","2020-07-15","   0","   40","   2","  0","   40","   2"
"6053","napa","2020-07-15","   9","  387","   0","  4","  378","  -4"
"6054","sutter","2020-07-15","   0","   14","   0","  0","   14","   0"
"6055","humboldt","2020-07-15","   3","  352","   3","  1","  349","   2"
"6056","nevada","2020-07-15","   7","  109","   1","  1","  102","   0"
"6057","butte","2020-07-15","  19","  492","   5","  7","  473","  -2"
"6058","san luis obispo","2020-07-15","  11","  465","  34","  4","  454","  30"
"6059","san francisco","2020-07-15"," 108"," 2647"," 114"," 32"," 2539","  82"
"6060","marin","2020-07-15","  30","  392","  28","  7","  362","  21"
"6061","alameda","2020-07-15"," 202"," 2968"," 143"," 68"," 2766","  75"
"6062","el dorado","2020-07-15","   3","  235","   8","  3","  232","   5"
"6063","tulare","2020-07-15","  92","  835","  29","  7","  743","  22"
"6064","san joaquin","2020-07-15"," 274"," 1430","  38"," 59"," 1156"," -21"
"6065","colusa","2020-07-15","   4","   88","   6","  0","   84","   6"
"6066","tehama","2020-07-15","   1","  106","   3","  1","  105","   2"
"6067","sacramento","2020-07-15"," 204"," 2984","  73"," 63"," 2780","  10"
"6068","modoc","2020-07-15","   1","   41","   0","  0","   40","   0"
"6069","mariposa","2020-07-15","   0","   33","   0","  0","   33","   0"
"6070","kern","2020-07-15"," 250"," 1822","  68"," 68"," 1572","   0"
"6071","san bernardino","2020-07-15"," 656"," 4766"," 148","182"," 4110"," -34"
"6072","orange","2020-07-15"," 813"," 7428"," 378","256"," 6615"," 122"
"6073","shasta","2020-07-15","   5","  671","  20","  3","  666","  17"
"6074","santa clara","2020-07-15"," 183"," 3434"," 144"," 59"," 3251","  85"
"6075","san diego","2020-07-15"," 500"," 6670"," 348","163"," 6170"," 185"
"6076","kings","2020-07-15","  74","  199","   1"," 11","  125"," -10"
"6077","san benito","2020-07-15","   1","   25","   1","  0","   24","   1"
"6078","mendocino","2020-07-15","   2","  180","  11","  2","  178","   9"
"6079","lassen","2020-07-15","   1","   65","   0","  0","   64","   0"
"6080","inyo","2020-07-15","   0","   42","   4","  0","   42","   4"
"6081","monterey","2020-07-15","  52","  845","  89"," 11","  793","  78"
"6082","ventura","2020-07-15"," 151"," 1549","  44"," 35"," 1398","   9"
"6083","fresno","2020-07-15"," 274"," 1890","  60"," 47"," 1616","  13"
"6084","trinity","2020-07-15","   0","   54","   0","  0","   54","   0"
"6085","contra costa","2020-07-15"," 117"," 1579"," 136"," 37"," 1462","  99"
"6086","los angeles","2020-07-15","2851","23884","1322","657","21033"," 665"
"6087","imperial","2020-07-15","  90","  298","   4"," 26","  208"," -22"
"6088","yolo","2020-07-15","  21","  186","   1"," 10","  165","  -9"
"6089","madera","2020-07-15","  32","  340","  19","  3","  308","  16"
"6090","sonoma","2020-07-15","  43","  858","  41"," 14","  815","  27"
"6091","solano","2020-07-15","  50","  707","  45"," 12","  657","  33"
"6092","santa barbara","2020-07-15","  86","  763","  60"," 26","  677","  34"
"6093","amador","2020-07-15","   2","   51","   1","  1","   49","   0"
"6094","merced","2020-07-15","  36","  242","   6","  7","  206","  -1"
"6095","lake","2020-07-15","   1","  110","   2","  1","  109","   1"
"6096","tuolumne","2020-07-15","   2","  151","   1","  0","  149","   1"
"6097","stanislaus","2020-07-15"," 235"," 1393","  76"," 47"," 1158","  29"
"6098","placer","2020-07-15","  69","  770","  16"," 11","  701","   5"
"6099","siskiyou","2020-07-15","   3","   65","   4","  0","   62","   4"
"6100","santa cruz","2020-07-15","  13","  397","  27","  2","  384","  25"
"6101","del norte","2020-07-15","   0","   51","   0","  0","   51","   0"
"6102","santa clara","2020-07-16"," 183"," 3433"," 158"," 55"," 3250"," 103"
"6103","san bernardino","2020-07-16"," 676"," 4766"," 143","188"," 4090"," -45"
"6104","santa barbara","2020-07-16","  84","  763","  62"," 26","  679","  36"
"6105","nevada","2020-07-16","   1","  100","   1","  0","   99","   1"
"6106","napa","2020-07-16","   8","  387","   0","  4","  379","  -4"
"6107","madera","2020-07-16","  24","  340","  13","  6","  316","   7"
"6108","stanislaus","2020-07-16"," 253"," 1393","  77"," 51"," 1140","  26"
"6109","solano","2020-07-16","  56","  707","  36"," 18","  651","  18"
"6110","sutter","2020-07-16","   0","   14","   0","  0","   14","   0"
"6111","kings","2020-07-16","  80","  199","   2","  8","  119","  -6"
"6112","lake","2020-07-16","   4","  110","   2","  3","  106","  -1"
"6113","plumas","2020-07-16","   0","   45","   0","  0","   45","   0"
"6114","san luis obispo","2020-07-16","  12","  477","  37","  5","  465","  32"
"6115","mono","2020-07-16","   0","   40","   2","  0","   40","   2"
"6116","tulare","2020-07-16","  93","  835","  26","  8","  742","  18"
"6117","contra costa","2020-07-16"," 120"," 1579"," 131"," 36"," 1459","  95"
"6118","colusa","2020-07-16","   2","   88","   6","  0","   86","   6"
"6119","siskiyou","2020-07-16","   3","   65","   4","  1","   62","   3"
"6120","kern","2020-07-16"," 273"," 1822","  65"," 68"," 1549","  -3"
"6121","riverside","2020-07-16"," 675"," 4131"," 158","145"," 3456","  13"
"6122","monterey","2020-07-16","  54","  845","  84"," 11","  791","  73"
"6123","sonoma","2020-07-16","  46","  858","  39"," 15","  812","  24"
"6124","tehama","2020-07-16","   1","  106","   2","  1","  105","   1"
"6125","san benito","2020-07-16","   1","   25","   2","  0","   24","   2"
"6126","marin","2020-07-16","  29","  392","  27","  9","  363","  18"
"6127","imperial","2020-07-16","  95","  298","   5"," 24","  203"," -19"
"6128","trinity","2020-07-16","   0","   54","   0","  0","   54","   0"
"6129","ventura","2020-07-16"," 135"," 1549","  43"," 35"," 1414","   8"
"6130","el dorado","2020-07-16","   5","  235","   9","  5","  230","   4"
"6131","san diego","2020-07-16"," 498"," 6692"," 337","166"," 6194"," 171"
"6132","glenn","2020-07-16","   1","   47","   0","  0","   46","   0"
"6133","santa cruz","2020-07-16","  12","  397","  30","  2","  385","  28"
"6134","modoc","2020-07-16","   0","   41","   0","  0","   41","   0"
"6135","calaveras","2020-07-16","   0","   50","  10","  0","   50","  10"
"6136","lassen","2020-07-16","   1","   65","   0","  0","   64","   0"
"6137","yolo","2020-07-16","  14","  186","   0"," 11","  172"," -11"
"6138","merced","2020-07-16","  36","  242","   2","  7","  206","  -5"
"6139","yuba","2020-07-16","  19","  445","   9","  5","  426","   4"
"6140","tuolumne","2020-07-16","   3","  151","   1","  0","  148","   1"
"6141","inyo","2020-07-16","   0","   42","   4","  0","   42","   4"
"6142","fresno","2020-07-16"," 281"," 1901","  65"," 48"," 1620","  17"
"6143","placer","2020-07-16","  81","  771","  30","  9","  690","  21"
"6144","alameda","2020-07-16"," 211"," 2968"," 142"," 56"," 2757","  86"
"6145","mendocino","2020-07-16","   5","  180","  10","  3","  175","   7"
"6146","san mateo","2020-07-16","  80"," 1057","  59"," 19","  977","  40"
"6147","san francisco","2020-07-16"," 107"," 2647"," 117"," 27"," 2540","  90"
"6148","los angeles","2020-07-16","2907","23989","1325","697","21082"," 628"
"6149","humboldt","2020-07-16","   4","  352","   6","  0","  348","   6"
"6150","sacramento","2020-07-16"," 218"," 2920","  76"," 67"," 2702","   9"
"6151","del norte","2020-07-16","   0","   51","   0","  0","   51","   0"
"6152","amador","2020-07-16","   3","   51","   0","  0","   48","   0"
"6153","shasta","2020-07-16","   3","  671","  13","  1","  668","  12"
"6154","san joaquin","2020-07-16"," 233"," 1430","  39"," 58"," 1197"," -19"
"6155","orange","2020-07-16"," 801"," 7428"," 391","248"," 6627"," 143"
"6156","butte","2020-07-16","  19","  492","   2","  7","  473","  -5"
"6157","mariposa","2020-07-16","   0","   33","   0","  0","   33","   0"
