"","county","date","hospitalized_covid_patients","all_hospital_beds","icu_available_beds","icu_combined","hospital_capactity","icu_capacity"
"1","placer","2020-03-29","   0","    0","  10","  5","    0","   5"
"2","butte","2020-03-29","   0","    0","   0","  0","    0","   0"
"3","humboldt","2020-03-29","   0","    0","  18","  0","    0","  18"
"4","san diego","2020-03-29","   0","    0"," 205","116","    0","  89"
"5","solano","2020-03-29","   0","    0","  28","  5","    0","  23"
"6","marin","2020-03-29","   0","    0","  11","  8","    0","   3"
"7","contra costa","2020-03-29","   0","    0","  62"," 23","    0","  39"
"8","lassen","2020-03-29","   0","    0","   0","  0","    0","   0"
"9","san benito","2020-03-29","   0","    0","   1","  1","    0","   0"
"10","calaveras","2020-03-29","   0","    0","   0","  0","    0","   0"
"11","siskiyou","2020-03-29","   0","    0","   2","  0","    0","   2"
"12","san francisco","2020-03-29","   0","    0","  61"," 34","    0","  27"
"13","nevada","2020-03-29","   0","    0","   3","  1","    0","   2"
"14","santa clara","2020-03-29","   0","    0","  70"," 80","    0"," -10"
"15","amador","2020-03-29","   0","    0","   2","  0","    0","   2"
"16","los angeles","2020-03-29","   0","    0"," 345","373","    0"," -28"
"17","lake","2020-03-29","   0","    0","   2","  1","    0","   1"
"18","kern","2020-03-29","   0","    0","  39"," 16","    0","  23"
"19","yuba","2020-03-29","   0","    0","   2","  6","    0","  -4"
"20","orange","2020-03-29","   0","    0"," 131"," 71","    0","  60"
"21","del norte","2020-03-29","   0","    0","   3","  0","    0","   3"
"22","inyo","2020-03-29","   0","    0","   0","  0","    0","   0"
"23","el dorado","2020-03-29","   0","    0","   3","  3","    0","   0"
"24","sutter","2020-03-29","   0","    0","   0","  0","    0","   0"
"25","mono","2020-03-29","   0","    0","   2","  0","    0","   2"
"26","merced","2020-03-29","   0","    0","   3","  0","    0","   3"
"27","fresno","2020-03-29","   0","    0","  22"," 17","    0","   5"
"28","modoc","2020-03-29","   0","    0","   0","  0","    0","   0"
"29","santa cruz","2020-03-29","   0","    0","   0","  0","    0","   0"
"30","ventura","2020-03-29","   0","    0","  14"," 24","    0"," -10"
"31","tuolumne","2020-03-29","   0","    0","   0","  0","    0","   0"
"32","tulare","2020-03-29","   0","    0","   7","  8","    0","  -1"
"33","san joaquin","2020-03-29","   0","    0","   7","  7","    0","   0"
"34","alameda","2020-03-29","   0","    0"," 119"," 36","    0","  83"
"35","kings","2020-03-29","   0","    0","   2","  1","    0","   1"
"36","mendocino","2020-03-29","   0","    0","   1","  0","    0","   1"
"37","riverside","2020-03-29","   0","    0","  46"," 33","    0","  13"
"38","stanislaus","2020-03-29","   0","    0","  25"," 17","    0","   8"
"39","colusa","2020-03-29","   0","    0","   0","  0","    0","   0"
"40","san luis obispo","2020-03-29","   0","    0"," 948","  7","    0"," 941"
"41","san bernardino","2020-03-29","   0","    0","  65"," 39","    0","  26"
"42","imperial","2020-03-29","   0","    0","   2","  3","    0","  -1"
"43","sacramento","2020-03-29","   0","    0","  50"," 30","    0","  20"
"44","santa barbara","2020-03-29","   0","    0","  47"," 12","    0","  35"
"45","monterey","2020-03-29","   0","    0","  10","  3","    0","   7"
"46","plumas","2020-03-29","   0","    0","   0","  1","    0","  -1"
"47","madera","2020-03-29","   0","    0","   8","  2","    0","   6"
"48","yolo","2020-03-29","   0","    0","   0","  2","    0","  -2"
"49","trinity","2020-03-29","   0","    0","   0","  0","    0","   0"
"50","","2020-03-29","   0","    0","   5","  1","    0","   4"
"51","napa","2020-03-29","   0","    0","   5","  0","    0","   5"
"52","shasta","2020-03-29","   0","    0","   0","  0","    0","   0"
"53","sonoma","2020-03-29","   0","    0","  12","  7","    0","   5"
"54","glenn","2020-03-29","   0","    0","   0","  0","    0","   0"
"55","tehama","2020-03-29","   0","    0","   2","  0","    0","   2"
"56","san mateo","2020-03-29","   0","    0","  28"," 26","    0","   2"
"57","nevada","2020-03-30","   0","    0","   3","  7","    0","  -4"
"58","amador","2020-03-30","   0","    0","   4","  0","    0","   4"
"59","sutter","2020-03-30","   0","    0","   0","  0","    0","   0"
"60","colusa","2020-03-30","   0","    0","   5","  1","    0","   4"
"61","monterey","2020-03-30","   0","    0","  17","  4","    0","  13"
"62","merced","2020-03-30","   0","    0","  11","  2","    0","   9"
"63","tehama","2020-03-30","   0","    0","   2","  0","    0","   2"
"64","del norte","2020-03-30","   0","    0","   5","  0","    0","   5"
"65","yolo","2020-03-30","   0","    0","   0","  3","    0","  -3"
"66","","2020-03-30","   0","    0","   9","  6","    0","   3"
"67","calaveras","2020-03-30","   0","    0","   5","  1","    0","   4"
"68","sacramento","2020-03-30","   0","    0","  58"," 44","    0","  14"
"69","san benito","2020-03-30","   0","    0","   1","  1","    0","   0"
"70","glenn","2020-03-30","   0","    0","   0","  0","    0","   0"
"71","siskiyou","2020-03-30","   0","    0","   3","  0","    0","   3"
"72","santa cruz","2020-03-30","   0","    0","   4","  0","    0","   4"
"73","contra costa","2020-03-30","   0","    0","  90"," 17","    0","  73"
"74","trinity","2020-03-30","   0","    0","   0","  0","    0","   0"
"75","san joaquin","2020-03-30","   0","    0","  53"," 12","    0","  41"
"76","santa clara","2020-03-30","   0","    0"," 103"," 97","    0","   6"
"77","stanislaus","2020-03-30","   0","    0","  29"," 14","    0","  15"
"78","lassen","2020-03-30","   0","    0","   0","  0","    0","   0"
"79","san bernardino","2020-03-30","   0","    0","  66"," 60","    0","   6"
"80","alameda","2020-03-30","   0","    0"," 146"," 45","    0"," 101"
"81","napa","2020-03-30","   0","    0","   9","  1","    0","   8"
"82","ventura","2020-03-30","   0","    0","  15"," 33","    0"," -18"
"83","fresno","2020-03-30","   0","    0","  24"," 17","    0","   7"
"84","lake","2020-03-30","   0","    0","   3","  1","    0","   2"
"85","yuba","2020-03-30","   0","    0","  10","  6","    0","   4"
"86","san diego","2020-03-30","   0","    0"," 228"," 95","    0"," 133"
"87","san mateo","2020-03-30","   0","    0","  47"," 29","    0","  18"
"88","imperial","2020-03-30","   0","    0","   4","  6","    0","  -2"
"89","solano","2020-03-30","   0","    0","  47","  6","    0","  41"
"90","tuolumne","2020-03-30","   0","    0","   3","  0","    0","   3"
"91","plumas","2020-03-30","   0","    0","   0","  0","    0","   0"
"92","modoc","2020-03-30","   0","    0","   0","  0","    0","   0"
"93","butte","2020-03-30","   0","    0","   5","  3","    0","   2"
"94","shasta","2020-03-30","   0","    0","  13","  0","    0","  13"
"95","riverside","2020-03-30","   0","    0","  77"," 55","    0","  22"
"96","mono","2020-03-30","   0","    0","   2","  0","    0","   2"
"97","san francisco","2020-03-30","   0","    0","  90"," 25","    0","  65"
"98","el dorado","2020-03-30","   0","    0","   9","  6","    0","   3"
"99","san luis obispo","2020-03-30","   0","    0"," 957","  7","    0"," 950"
"100","orange","2020-03-30","   0","    0"," 131","100","    0","  31"
"101","madera","2020-03-30","   0","    0","   4","  4","    0","   0"
"102","marin","2020-03-30","   0","    0","  16","  6","    0","  10"
"103","placer","2020-03-30","   0","    0","  29","  6","    0","  23"
"104","inyo","2020-03-30","   0","    0","   0","  0","    0","   0"
"105","kern","2020-03-30","   0","    0","  51"," 14","    0","  37"
"106","los angeles","2020-03-30","   0","    0"," 456","489","    0"," -33"
"107","kings","2020-03-30","   0","    0","   0","  3","    0","  -3"
"108","mendocino","2020-03-30","   0","    0","   8","  1","    0","   7"
"109","tulare","2020-03-30","   0","    0","   7"," 10","    0","  -3"
"110","humboldt","2020-03-30","   0","    0","  10","  0","    0","  10"
"111","sonoma","2020-03-30","   0","    0","  29","  7","    0","  22"
"112","santa barbara","2020-03-30","   0","    0","  48"," 18","    0","  30"
"113","kings","2020-03-31","   0","    0","   4","  3","    0","   1"
"114","sutter","2020-03-31","   0","    0","   0","  0","    0","   0"
"115","trinity","2020-03-31","   0","    0","   0","  0","    0","   0"
"116","del norte","2020-03-31","   0","    0","   3","  0","    0","   3"
"117","san mateo","2020-03-31","   0","    0","  37"," 23","    0","  14"
"118","fresno","2020-03-31","   0","    0","  23"," 23","    0","   0"
"119","san diego","2020-03-31","   0","    0"," 208","114","    0","  94"
"120","ventura","2020-03-31","   0","    0","  12"," 29","    0"," -17"
"121","tuolumne","2020-03-31","   0","    0","   4","  0","    0","   4"
"122","napa","2020-03-31","   0","    0","  12","  2","    0","  10"
"123","colusa","2020-03-31","   0","    0","   5","  1","    0","   4"
"124","santa barbara","2020-03-31","   0","    0","  48"," 21","    0","  27"
"125","santa cruz","2020-03-31","   0","    0","   7","  3","    0","   4"
"126","imperial","2020-03-31","   0","    0","   4","  7","    0","  -3"
"127","riverside","2020-03-31","   0","    0","  75"," 87","    0"," -12"
"128","amador","2020-03-31","   0","    0","   4","  0","    0","   4"
"129","kern","2020-03-31","   0","    0","  46"," 12","    0","  34"
"130","yuba","2020-03-31","   0","    0","   6","  6","    0","   0"
"131","sacramento","2020-03-31","   0","    0","  66"," 51","    0","  15"
"132","placer","2020-03-31","   0","    0","  28","  6","    0","  22"
"133","alameda","2020-03-31","   0","    0","  77"," 44","    0","  33"
"134","contra costa","2020-03-31","   0","    0","  68"," 21","    0","  47"
"135","sonoma","2020-03-31","   0","    0","  21","  6","    0","  15"
"136","stanislaus","2020-03-31","   0","    0","  34"," 10","    0","  24"
"137","shasta","2020-03-31","   0","    0","   4","  1","    0","   3"
"138","solano","2020-03-31","   0","    0","  42"," 11","    0","  31"
"139","lake","2020-03-31","   0","    0","   3","  2","    0","   1"
"140","san benito","2020-03-31","   0","    0","   1","  1","    0","   0"
"141","plumas","2020-03-31","   0","    0","   0","  0","    0","   0"
"142","tehama","2020-03-31","   0","    0","   4","  0","    0","   4"
"143","nevada","2020-03-31","   0","    0","   6","  3","    0","   3"
"144","tulare","2020-03-31","   0","    0","   9","  9","    0","   0"
"145","los angeles","2020-03-31","   0","    0"," 445","554","    0","-109"
"146","san bernardino","2020-03-31","   0","    0","  63"," 81","    0"," -18"
"147","yolo","2020-03-31","   0","    0","   1","  4","    0","  -3"
"148","butte","2020-03-31","   0","    0","   2","  5","    0","  -3"
"149","humboldt","2020-03-31","   0","    0","   8","  4","    0","   4"
"150","san francisco","2020-03-31","   0","    0","  77"," 44","    0","  33"
"151","inyo","2020-03-31","   0","    0","   6","  0","    0","   6"
"152","san joaquin","2020-03-31","   0","    0","  28"," 19","    0","   9"
"153","mendocino","2020-03-31","   0","    0","   7","  0","    0","   7"
"154","marin","2020-03-31","   0","    0","  15","  6","    0","   9"
"155","orange","2020-03-31","   0","    0"," 131"," 89","    0","  42"
"156","glenn","2020-03-31","   0","    0","   0","  0","    0","   0"
"157","lassen","2020-03-31","   0","    0","   0","  0","    0","   0"
"158","el dorado","2020-03-31","   0","    0","  12","  6","    0","   6"
"159","monterey","2020-03-31","   0","    0","  17","  6","    0","  11"
"160","san luis obispo","2020-03-31","   0","    0"," 955","  9","    0"," 946"
"161","calaveras","2020-03-31","   0","    0","   4","  0","    0","   4"
"162","merced","2020-03-31","   0","    0","  10","  2","    0","   8"
"163","siskiyou","2020-03-31","   0","    0","   4","  0","    0","   4"
"164","madera","2020-03-31","   0","    0","   5","  1","    0","   4"
"165","mono","2020-03-31","   0","    0","   2","  0","    0","   2"
"166","modoc","2020-03-31","   0","    0","   0","  0","    0","   0"
"167","santa clara","2020-03-31","   0","    0","  92"," 90","    0","   2"
"168","alameda","2020-04-01","   0","    0"," 106"," 42","    0","  64"
"169","riverside","2020-04-01","   0","    0","  76"," 76","    0","   0"
"170","lassen","2020-04-01","   0","    0","   0","  0","    0","   0"
"171","santa clara","2020-04-01","   0","    0","  91"," 92","    0","  -1"
"172","siskiyou","2020-04-01","   0","    0","   3","  2","    0","   1"
"173","santa barbara","2020-04-01","   0","    0","  51"," 21","    0","  30"
"174","san benito","2020-04-01","   0","    0","   0","  2","    0","  -2"
"175","mariposa","2020-04-01","   0","    0","   0","  0","    0","   0"
"176","fresno","2020-04-01","   0","    0","  53"," 18","    0","  35"
"177","sacramento","2020-04-01","   0","    0","  74"," 53","    0","  21"
"178","marin","2020-04-01","   0","    0","  14","  6","    0","   8"
"179","santa cruz","2020-04-01","   0","    0","   3","  4","    0","  -1"
"180","solano","2020-04-01","   0","    0","  31","  7","    0","  24"
"181","madera","2020-04-01","   0","    0","   4","  1","    0","   3"
"182","inyo","2020-04-01","   0","    0","   6","  0","    0","   6"
"183","tehama","2020-04-01","   0","    0","   4","  1","    0","   3"
"184","amador","2020-04-01","   0","    0","   2","  0","    0","   2"
"185","trinity","2020-04-01","   0","    0","   0","  0","    0","   0"
"186","mono","2020-04-01","   0","    0","   2","  0","    0","   2"
"187","glenn","2020-04-01","   0","    0","   0","  0","    0","   0"
"188","calaveras","2020-04-01","   0","    0","   5","  0","    0","   5"
"189","shasta","2020-04-01","   0","    0","  13","  1","    0","  12"
"190","san joaquin","2020-04-01","   0","    0","  21"," 27","    0","  -6"
"191","imperial","2020-04-01","   0","    0","   7","  7","    0","   0"
"192","","2020-04-01","   0","    0","   9","  7","    0","   2"
"193","sutter","2020-04-01","   0","    0","   0","  0","    0","   0"
"194","del norte","2020-04-01","   0","    0","   3","  0","    0","   3"
"195","nevada","2020-04-01","   0","    0","   3","  4","    0","  -1"
"196","san mateo","2020-04-01","   0","    0","  36"," 28","    0","   8"
"197","ventura","2020-04-01","   0","    0","  27"," 28","    0","  -1"
"198","tuolumne","2020-04-01","   0","    0","   2","  0","    0","   2"
"199","placer","2020-04-01","   0","    0","   7","  8","    0","  -1"
"200","san luis obispo","2020-04-01","   0","    0"," 968"," 11","    0"," 957"
"201","mendocino","2020-04-01","   0","    0","   8","  0","    0","   8"
"202","yuba","2020-04-01","   0","    0","   6","  6","    0","   0"
"203","lake","2020-04-01","   0","    0","   2","  0","    0","   2"
"204","contra costa","2020-04-01","   0","    0","  61"," 24","    0","  37"
"205","san francisco","2020-04-01","   0","    0","  64"," 38","    0","  26"
"206","el dorado","2020-04-01","   0","    0","   9","  4","    0","   5"
"207","sonoma","2020-04-01","   0","    0","  22","  3","    0","  19"
"208","orange","2020-04-01","   0","    0"," 118"," 98","    0","  20"
"209","kern","2020-04-01","   0","    0","  32"," 16","    0","  16"
"210","merced","2020-04-01","   0","    0","   9","  3","    0","   6"
"211","napa","2020-04-01","   0","    0","   9","  1","    0","   8"
"212","monterey","2020-04-01","   0","    0","  15","  8","    0","   7"
"213","modoc","2020-04-01","   0","    0","   0","  0","    0","   0"
"214","butte","2020-04-01","   0","    0","   9","  6","    0","   3"
"215","colusa","2020-04-01","   0","    0","   5","  1","    0","   4"
"216","humboldt","2020-04-01","   0","    0","   7","  3","    0","   4"
"217","san bernardino","2020-04-01","   0","    0","  34"," 91","    0"," -57"
"218","kings","2020-04-01","   0","    0","   1","  3","    0","  -2"
"219","tulare","2020-04-01","   0","    0","   9","  7","    0","   2"
"220","yolo","2020-04-01","   0","    0","   2","  2","    0","   0"
"221","stanislaus","2020-04-01","   0","    0","  31"," 16","    0","  15"
"222","plumas","2020-04-01","   0","    0","   0","  0","    0","   0"
"223","los angeles","2020-04-01","   0","    0"," 492","555","    0"," -63"
"224","san diego","2020-04-01","   0","    0"," 215","103","    0"," 112"
"225","fresno","2020-04-02","   0","    0","  33"," 19","    0","  14"
"226","mono","2020-04-02","   0","    0","   2","  0","    0","   2"
"227","humboldt","2020-04-02","   0","    0","   8","  2","    0","   6"
"228","tuolumne","2020-04-02","   0","    0","   2","  0","    0","   2"
"229","santa clara","2020-04-02","   0","    0","  95"," 88","    0","   7"
"230","kern","2020-04-02","   0","    0","  36"," 35","    0","   1"
"231","colusa","2020-04-02","   0","    0","   5","  1","    0","   4"
"232","","2020-04-02","   0","    0","   9","  7","    0","   2"
"233","el dorado","2020-04-02","   0","    0","  10","  6","    0","   4"
"234","tulare","2020-04-02","   0","    0","   3","  9","    0","  -6"
"235","stanislaus","2020-04-02","   0","    0","  22"," 18","    0","   4"
"236","san joaquin","2020-04-02","   0","    0","  17"," 27","    0"," -10"
"237","glenn","2020-04-02","   0","    0","   0","  0","    0","   0"
"238","modoc","2020-04-02","   0","    0","   0","  0","    0","   0"
"239","plumas","2020-04-02","   0","    0","   0","  0","    0","   0"
"240","san luis obispo","2020-04-02","   0","    0"," 966","  8","    0"," 958"
"241","yolo","2020-04-02","   0","    0","   0","  5","    0","  -5"
"242","shasta","2020-04-02","   0","    0","  10","  1","    0","   9"
"243","trinity","2020-04-02","   0","    0","   0","  0","    0","   0"
"244","butte","2020-04-02","   0","    0","  12","  4","    0","   8"
"245","imperial","2020-04-02","   0","    0","   6","  8","    0","  -2"
"246","ventura","2020-04-02","   0","    0","  15"," 31","    0"," -16"
"247","calaveras","2020-04-02","   0","    0","   5","  0","    0","   5"
"248","inyo","2020-04-02","   0","    0","   3","  1","    0","   2"
"249","santa cruz","2020-04-02","   0","    0","   7","  3","    0","   4"
"250","marin","2020-04-02","   0","    0","  16","  4","    0","  12"
"251","monterey","2020-04-02","   0","    0","  12","  6","    0","   6"
"252","merced","2020-04-02","   0","    0","   3","  1","    0","   2"
"253","lake","2020-04-02","   0","    0","   2","  0","    0","   2"
"254","del norte","2020-04-02","   0","    0","   2","  0","    0","   2"
"255","amador","2020-04-02","   0","    0","   2","  0","    0","   2"
"256","sutter","2020-04-02","   0","    0","   0","  0","    0","   0"
"257","san francisco","2020-04-02","   0","    0","  58"," 43","    0","  15"
"258","sonoma","2020-04-02","   0","    0","  10","  1","    0","   9"
"259","san benito","2020-04-02","   0","    0","   0","  2","    0","  -2"
"260","siskiyou","2020-04-02","   0","    0","   4","  2","    0","   2"
"261","mariposa","2020-04-02","   0","    0","   0","  0","    0","   0"
"262","alameda","2020-04-02","   0","    0"," 112"," 46","    0","  66"
"263","tehama","2020-04-02","   0","    0","   4","  1","    0","   3"
"264","san mateo","2020-04-02","   0","    0","  26"," 30","    0","  -4"
"265","los angeles","2020-04-02","   0","    0"," 488","539","    0"," -51"
"266","sacramento","2020-04-02","   0","    0","  80"," 43","    0","  37"
"267","placer","2020-04-02","   0","    0","  11","  9","    0","   2"
"268","riverside","2020-04-02","   0","    0"," 104"," 94","    0","  10"
"269","napa","2020-04-02","   0","    0","  12","  2","    0","  10"
"270","solano","2020-04-02","   0","    0","  27","  8","    0","  19"
"271","san bernardino","2020-04-02","   0","    0","  37"," 95","    0"," -58"
"272","mendocino","2020-04-02","   0","    0","   8","  0","    0","   8"
"273","madera","2020-04-02","   0","    0","   6","  4","    0","   2"
"274","contra costa","2020-04-02","   0","    0","  73"," 23","    0","  50"
"275","orange","2020-04-02","   0","    0","  96","114","    0"," -18"
"276","yuba","2020-04-02","   0","    0","   4","  8","    0","  -4"
"277","lassen","2020-04-02","   0","    0","   0","  0","    0","   0"
"278","santa barbara","2020-04-02","   0","    0","  47"," 28","    0","  19"
"279","nevada","2020-04-02","   0","    0","   6","  3","    0","   3"
"280","kings","2020-04-02","   0","    0","   7","  2","    0","   5"
"281","san diego","2020-04-02","   0","    0"," 206","104","    0"," 102"
"282","ventura","2020-04-03","   0","    0","  56"," 34","    0","  22"
"283","imperial","2020-04-03","   0","    0","   5","  7","    0","  -2"
"284","san diego","2020-04-03","   0","    0"," 216","112","    0"," 104"
"285","mariposa","2020-04-03","   0","    0","   0","  0","    0","   0"
"286","del norte","2020-04-03","   0","    0","   2","  0","    0","   2"
"287","santa barbara","2020-04-03","   0","    0","  50"," 22","    0","  28"
"288","inyo","2020-04-03","   0","    0","   1","  3","    0","  -2"
"289","merced","2020-04-03","   0","    0","   4","  2","    0","   2"
"290","shasta","2020-04-03","   0","    0","  14","  4","    0","  10"
"291","san luis obispo","2020-04-03","   0","    0"," 967","  5","    0"," 962"
"292","amador","2020-04-03","   0","    0","   1","  0","    0","   1"
"293","glenn","2020-04-03","   0","    0","   0","  0","    0","   0"
"294","solano","2020-04-03","   0","    0","  23"," 12","    0","  11"
"295","placer","2020-04-03","   0","    0","   7"," 11","    0","  -4"
"296","kings","2020-04-03","   0","    0","   3","  1","    0","   2"
"297","alameda","2020-04-03","   0","    0"," 117"," 45","    0","  72"
"298","sacramento","2020-04-03","   0","    0","  76"," 45","    0","  31"
"299","santa clara","2020-04-03","   0","    0","  97"," 88","    0","   9"
"300","trinity","2020-04-03","   0","    0","   0","  0","    0","   0"
"301","tehama","2020-04-03","   0","    0","   8","  0","    0","   8"
"302","butte","2020-04-03","   0","    0","   9","  8","    0","   1"
"303","mono","2020-04-03","   0","    0","   2","  0","    0","   2"
"304","napa","2020-04-03","   0","    0","   9","  1","    0","   8"
"305","santa cruz","2020-04-03","   0","    0","   2","  3","    0","  -1"
"306","","2020-04-03","   0","    0","   2","  8","    0","  -6"
"307","plumas","2020-04-03","   0","    0","   0","  0","    0","   0"
"308","stanislaus","2020-04-03","   0","    0","  22"," 20","    0","   2"
"309","san joaquin","2020-04-03","   0","    0","  22"," 26","    0","  -4"
"310","san mateo","2020-04-03","   0","    0","  38"," 30","    0","   8"
"311","marin","2020-04-03","   0","    0","  17","  8","    0","   9"
"312","san francisco","2020-04-03","   0","    0","  74"," 47","    0","  27"
"313","sonoma","2020-04-03","   0","    0","  15","  5","    0","  10"
"314","modoc","2020-04-03","   0","    0","   0","  0","    0","   0"
"315","tulare","2020-04-03","   0","    0","   3","  7","    0","  -4"
"316","los angeles","2020-04-03","   0","    0"," 473","631","    0","-158"
"317","riverside","2020-04-03","   0","    0"," 127","103","    0","  24"
"318","lake","2020-04-03","   0","    0","   2","  1","    0","   1"
"319","kern","2020-04-03","   0","    0","  47"," 28","    0","  19"
"320","lassen","2020-04-03","   0","    0","   0","  0","    0","   0"
"321","calaveras","2020-04-03","   0","    0","   5","  0","    0","   5"
"322","contra costa","2020-04-03","   0","    0","  75"," 25","    0","  50"
"323","fresno","2020-04-03","   0","    0","  35"," 23","    0","  12"
"324","tuolumne","2020-04-03","   0","    0","   1","  0","    0","   1"
"325","sutter","2020-04-03","   0","    0","   0","  0","    0","   0"
"326","colusa","2020-04-03","   0","    0","   5","  1","    0","   4"
"327","humboldt","2020-04-03","   0","    0","  10","  0","    0","  10"
"328","el dorado","2020-04-03","   0","    0","  14","  4","    0","  10"
"329","monterey","2020-04-03","   0","    0","  17","  4","    0","  13"
"330","madera","2020-04-03","   0","    0","   7","  1","    0","   6"
"331","yolo","2020-04-03","   0","    0","   4","  9","    0","  -5"
"332","nevada","2020-04-03","   0","    0","   5","  3","    0","   2"
"333","san benito","2020-04-03","   0","    0","   0","  2","    0","  -2"
"334","siskiyou","2020-04-03","   0","    0","   4","  1","    0","   3"
"335","yuba","2020-04-03","   0","    0","   5","  4","    0","   1"
"336","mendocino","2020-04-03","   0","    0","   6","  1","    0","   5"
"337","orange","2020-04-03","   0","    0"," 151","102","    0","  49"
"338","san bernardino","2020-04-03","   0","    0","  57"," 97","    0"," -40"
"339","tuolumne","2020-04-04","   0","    0","   2","  1","    0","   1"
"340","yuba","2020-04-04","   0","    0","   7","  4","    0","   3"
"341","kings","2020-04-04","   0","    0","   0","  1","    0","  -1"
"342","siskiyou","2020-04-04","   0","    0","   5","  1","    0","   4"
"343","tulare","2020-04-04","   0","    0","   6","  6","    0","   0"
"344","trinity","2020-04-04","   0","    0","   0","  0","    0","   0"
"345","nevada","2020-04-04","   0","    0","   5","  4","    0","   1"
"346","santa barbara","2020-04-04","   0","    0","  53"," 20","    0","  33"
"347","mono","2020-04-04","   0","    0","   2","  0","    0","   2"
"348","san benito","2020-04-04","   0","    0","   0","  2","    0","  -2"
"349","","2020-04-04","   0","    0","   7","  5","    0","   2"
"350","butte","2020-04-04","   0","    0","   7","  5","    0","   2"
"351","sacramento","2020-04-04","   0","    0","  82"," 43","    0","  39"
"352","san mateo","2020-04-04","   0","    0","  40"," 31","    0","   9"
"353","santa clara","2020-04-04","   0","    0","  91"," 91","    0","   0"
"354","ventura","2020-04-04","   0","    0","  10"," 32","    0"," -22"
"355","san luis obispo","2020-04-04","   0","    0"," 954","  6","    0"," 948"
"356","yolo","2020-04-04","   0","    0","   4","  6","    0","  -2"
"357","lassen","2020-04-04","   0","    0","   0","  0","    0","   0"
"358","mendocino","2020-04-04","   0","    0","   7","  1","    0","   6"
"359","amador","2020-04-04","   0","    0","   2","  0","    0","   2"
"360","del norte","2020-04-04","   0","    0","   1","  0","    0","   1"
"361","solano","2020-04-04","   0","    0","  23","  9","    0","  14"
"362","plumas","2020-04-04","   0","    0","   0","  0","    0","   0"
"363","imperial","2020-04-04","   0","    0","   5","  7","    0","  -2"
"364","riverside","2020-04-04","   0","    0"," 125"," 95","    0","  30"
"365","glenn","2020-04-04","   0","    0","   0","  0","    0","   0"
"366","los angeles","2020-04-04","   0","    0"," 537","630","    0"," -93"
"367","orange","2020-04-04","   0","    0"," 153","115","    0","  38"
"368","san bernardino","2020-04-04","   0","    0","  67","117","    0"," -50"
"369","colusa","2020-04-04","   0","    0","   5","  1","    0","   4"
"370","fresno","2020-04-04","   0","    0","  36"," 27","    0","   9"
"371","modoc","2020-04-04","   0","    0","   0","  0","    0","   0"
"372","san joaquin","2020-04-04","   0","    0","  24"," 23","    0","   1"
"373","sonoma","2020-04-04","   0","    0","  15","  8","    0","   7"
"374","stanislaus","2020-04-04","   0","    0","  26"," 21","    0","   5"
"375","madera","2020-04-04","   0","    0","   8","  0","    0","   8"
"376","san diego","2020-04-04","   0","    0"," 222","105","    0"," 117"
"377","alameda","2020-04-04","   0","    0"," 120"," 53","    0","  67"
"378","humboldt","2020-04-04","   0","    0","   7","  0","    0","   7"
"379","napa","2020-04-04","   0","    0","   6","  1","    0","   5"
"380","san francisco","2020-04-04","   0","    0","  79"," 44","    0","  35"
"381","kern","2020-04-04","   0","    0","  29"," 25","    0","   4"
"382","tehama","2020-04-04","   0","    0","   8","  0","    0","   8"
"383","santa cruz","2020-04-04","   0","    0","   7","  3","    0","   4"
"384","shasta","2020-04-04","   0","    0","  13","  4","    0","   9"
"385","calaveras","2020-04-04","   0","    0","   5","  0","    0","   5"
"386","inyo","2020-04-04","   0","    0","   2","  2","    0","   0"
"387","contra costa","2020-04-04","   0","    0","  87"," 19","    0","  68"
"388","monterey","2020-04-04","   0","    0","  18","  6","    0","  12"
"389","lake","2020-04-04","   0","    0","   4","  1","    0","   3"
"390","placer","2020-04-04","   0","    0","  12"," 11","    0","   1"
"391","sutter","2020-04-04","   0","    0","   0","  0","    0","   0"
"392","el dorado","2020-04-04","   0","    0","  12","  3","    0","   9"
"393","marin","2020-04-04","   0","    0","  12","  8","    0","   4"
"394","merced","2020-04-04","   0","    0","   6","  2","    0","   4"
"395","mariposa","2020-04-04","   0","    0","   0","  0","    0","   0"
"396","san joaquin","2020-04-05","   0","    0","  19"," 21","    0","  -2"
"397","colusa","2020-04-05","   0","    0","   5","  1","    0","   4"
"398","orange","2020-04-05","   0","    0"," 156","116","    0","  40"
"399","yuba","2020-04-05","   0","    0","  10","  2","    0","   8"
"400","nevada","2020-04-05","   0","    0","   3","  3","    0","   0"
"401","san mateo","2020-04-05","   0","    0","  36"," 30","    0","   6"
"402","contra costa","2020-04-05","   0","    0","  74"," 25","    0","  49"
"403","yolo","2020-04-05","   0","    0","   4","  6","    0","  -2"
"404","stanislaus","2020-04-05","   0","    0","  30"," 19","    0","  11"
"405","imperial","2020-04-05","   0","    0","   3","  9","    0","  -6"
"406","los angeles","2020-04-05","   0","    0"," 554","639","    0"," -85"
"407","butte","2020-04-05","   0","    0","  10","  7","    0","   3"
"408","san benito","2020-04-05","   0","    0","   0","  2","    0","  -2"
"409","inyo","2020-04-05","   0","    0","   3","  1","    0","   2"
"410","calaveras","2020-04-05","   0","    0","   6","  0","    0","   6"
"411","madera","2020-04-05","   0","    0","   8","  0","    0","   8"
"412","mariposa","2020-04-05","   0","    0","   0","  0","    0","   0"
"413","santa barbara","2020-04-05","   0","    0","  59"," 20","    0","  39"
"414","merced","2020-04-05","   0","    0","   8","  4","    0","   4"
"415","modoc","2020-04-05","   0","    0","   0","  0","    0","   0"
"416","trinity","2020-04-05","   0","    0","   0","  0","    0","   0"
"417","monterey","2020-04-05","   0","    0","  23","  4","    0","  19"
"418","lake","2020-04-05","   0","    0","   3","  2","    0","   1"
"419","siskiyou","2020-04-05","   0","    0","   3","  2","    0","   1"
"420","tuolumne","2020-04-05","   0","    0","   4","  0","    0","   4"
"421","tehama","2020-04-05","   0","    0","   5","  0","    0","   5"
"422","amador","2020-04-05","   0","    0","   2","  0","    0","   2"
"423","del norte","2020-04-05","   0","    0","   1","  0","    0","   1"
"424","marin","2020-04-05","   0","    0","  13","  8","    0","   5"
"425","riverside","2020-04-05","   0","    0"," 130","107","    0","  23"
"426","sutter","2020-04-05","   0","    0","   0","  0","    0","   0"
"427","alameda","2020-04-05","   0","    0"," 113"," 52","    0","  61"
"428","fresno","2020-04-05","   0","    0","  39"," 23","    0","  16"
"429","san francisco","2020-04-05","   0","    0","  74"," 48","    0","  26"
"430","solano","2020-04-05","   0","    0","   3"," 30","    0"," -27"
"431","san diego","2020-04-05","   0","    0"," 247","120","    0"," 127"
"432","humboldt","2020-04-05","   0","    0","   8","  0","    0","   8"
"433","mono","2020-04-05","   0","    0","   2","  0","    0","   2"
"434","shasta","2020-04-05","   0","    0","  13","  4","    0","   9"
"435","sonoma","2020-04-05","   0","    0","  16","  8","    0","   8"
"436","santa clara","2020-04-05","   0","    0","  90"," 86","    0","   4"
"437","sacramento","2020-04-05","   0","    0","  82"," 49","    0","  33"
"438","placer","2020-04-05","   0","    0","  10"," 11","    0","  -1"
"439","el dorado","2020-04-05","   0","    0","   7","  3","    0","   4"
"440","lassen","2020-04-05","   0","    0","   0","  0","    0","   0"
"441","san luis obispo","2020-04-05","   0","    0","  28"," 11","    0","  17"
"442","tulare","2020-04-05","   0","    0","   3"," 10","    0","  -7"
"443","napa","2020-04-05","   0","    0","  11","  1","    0","  10"
"444","glenn","2020-04-05","   0","    0","   0","  0","    0","   0"
"445","santa cruz","2020-04-05","   0","    0","  10","  8","    0","   2"
"446","kern","2020-04-05","   0","    0","  40"," 16","    0","  24"
"447","san bernardino","2020-04-05","   0","    0","  70","113","    0"," -43"
"448","ventura","2020-04-05","   0","    0","  12"," 35","    0"," -23"
"449","plumas","2020-04-05","   0","    0","   0","  0","    0","   0"
"450","mendocino","2020-04-05","   0","    0","   4","  2","    0","   2"
"451","kings","2020-04-05","   0","    0","   0","  2","    0","  -2"
"452","butte","2020-04-06","   0","    0","   9","  6","    0","   3"
"453","san joaquin","2020-04-06","   0","    0","  20"," 17","    0","   3"
"454","humboldt","2020-04-06","   0","    0","   2","  3","    0","  -1"
"455","yolo","2020-04-06","   0","    0","  -3","  7","    0"," -10"
"456","alameda","2020-04-06","   0","    0","  92"," 62","    0","  30"
"457","sutter","2020-04-06","   0","    0","   0","  0","    0","   0"
"458","inyo","2020-04-06","   0","    0","   3","  1","    0","   2"
"459","placer","2020-04-06","   0","    0","  24"," 11","    0","  13"
"460","solano","2020-04-06","   0","    0","  28"," 12","    0","  16"
"461","santa barbara","2020-04-06","   0","    0","  54"," 24","    0","  30"
"462","mendocino","2020-04-06","   0","    0","  10","  2","    0","   8"
"463","san francisco","2020-04-06","   0","    0","  71"," 43","    0","  28"
"464","madera","2020-04-06","   0","    0","   8","  1","    0","   7"
"465","san benito","2020-04-06","   0","    0","   0","  2","    0","  -2"
"466","santa cruz","2020-04-06","   0","    0","   5","  6","    0","  -1"
"467","shasta","2020-04-06","   0","    0","  28","  4","    0","  24"
"468","plumas","2020-04-06","   0","    0","   0","  0","    0","   0"
"469","siskiyou","2020-04-06","   0","    0","   5","  0","    0","   5"
"470","fresno","2020-04-06","   0","    0","  45"," 31","    0","  14"
"471","san mateo","2020-04-06","   0","    0","  36"," 30","    0","   6"
"472","san diego","2020-04-06","   0","    0"," 270","108","    0"," 162"
"473","sonoma","2020-04-06","   0","    0","  20","  6","    0","  14"
"474","yuba","2020-04-06","   0","    0","   7","  4","    0","   3"
"475","del norte","2020-04-06","   0","    0","   0","  0","    0","   0"
"476","kings","2020-04-06","   0","    0","   3","  2","    0","   1"
"477","santa clara","2020-04-06","   0","    0"," 100"," 89","    0","  11"
"478","ventura","2020-04-06","   0","    0","  32"," 29","    0","   3"
"479","amador","2020-04-06","   0","    0","   2","  0","    0","   2"
"480","tehama","2020-04-06","   0","    0","   4","  0","    0","   4"
"481","orange","2020-04-06","   0","    0"," 134","106","    0","  28"
"482","marin","2020-04-06","   0","    0","  13","  8","    0","   5"
"483","los angeles","2020-04-06","   0","    0"," 587","661","    0"," -74"
"484","modoc","2020-04-06","   0","    0","   0","  0","    0","   0"
"485","sacramento","2020-04-06","   0","    0","  75"," 45","    0","  30"
"486","nevada","2020-04-06","   0","    0","   4","  3","    0","   1"
"487","imperial","2020-04-06","   0","    0","   3","  9","    0","  -6"
"488","monterey","2020-04-06","   0","    0","  18","  6","    0","  12"
"489","contra costa","2020-04-06","   0","    0","  78"," 26","    0","  52"
"490","stanislaus","2020-04-06","   0","    0","  37"," 16","    0","  21"
"491","merced","2020-04-06","   0","    0","   4","  2","    0","   2"
"492","lake","2020-04-06","   0","    0","   1","  2","    0","  -1"
"493","calaveras","2020-04-06","   0","    0","   6","  0","    0","   6"
"494","kern","2020-04-06","   0","    0","  39"," 17","    0","  22"
"495","riverside","2020-04-06","   0","    0"," 152","111","    0","  41"
"496","glenn","2020-04-06","   0","    0","   0","  0","    0","   0"
"497","lassen","2020-04-06","   0","    0","   0","  0","    0","   0"
"498","san bernardino","2020-04-06","   0","    0"," 102","103","    0","  -1"
"499","el dorado","2020-04-06","   0","    0","  10","  0","    0","  10"
"500","tulare","2020-04-06","   0","    0","  16"," 11","    0","   5"
"501","tuolumne","2020-04-06","   0","    0","   0","  0","    0","   0"
"502","napa","2020-04-06","   0","    0","  15","  0","    0","  15"
"503","trinity","2020-04-06","   0","    0","   0","  0","    0","   0"
"504","san luis obispo","2020-04-06","   0","    0","  42","  4","    0","  38"
"505","mono","2020-04-06","   0","    0","   2","  0","    0","   2"
"506","colusa","2020-04-06","   0","    0","   6","  0","    0","   6"
"507","mariposa","2020-04-06","   0","    0","   0","  0","    0","   0"
"508","san joaquin","2020-04-07","   0","    0","  20"," 18","    0","   2"
"509","los angeles","2020-04-07","   0","    0"," 603","679","    0"," -76"
"510","san benito","2020-04-07","   0","    0","   0","  2","    0","  -2"
"511","orange","2020-04-07","   0","    0"," 136","100","    0","  36"
"512","alameda","2020-04-07","   0","    0","  90"," 68","    0","  22"
"513","plumas","2020-04-07","   0","    0","   0","  0","    0","   0"
"514","modoc","2020-04-07","   0","    0","   0","  0","    0","   0"
"515","san francisco","2020-04-07","   0","    0","  57"," 45","    0","  12"
"516","stanislaus","2020-04-07","   0","    0","  32"," 22","    0","  10"
"517","lassen","2020-04-07","   0","    0","   0","  0","    0","   0"
"518","san luis obispo","2020-04-07","   0","    0","  30","  6","    0","  24"
"519","san diego","2020-04-07","   0","    0"," 189","116","    0","  73"
"520","santa barbara","2020-04-07","   0","    0","  48"," 24","    0","  24"
"521","kern","2020-04-07","   0","    0","  50"," 27","    0","  23"
"522","kings","2020-04-07","   0","    0","   3","  2","    0","   1"
"523","tuolumne","2020-04-07","   0","    0","   0","  0","    0","   0"
"524","napa","2020-04-07","   0","    0","   7","  3","    0","   4"
"525","colusa","2020-04-07","   0","    0","   6","  0","    0","   6"
"526","el dorado","2020-04-07","   0","    0","  10","  3","    0","   7"
"527","sutter","2020-04-07","   0","    0","   0","  0","    0","   0"
"528","contra costa","2020-04-07","   0","    0","  82"," 26","    0","  56"
"529","yolo","2020-04-07","   0","    0","   4","  3","    0","   1"
"530","nevada","2020-04-07","   0","    0","   3","  3","    0","   0"
"531","siskiyou","2020-04-07","   0","    0","   5","  1","    0","   4"
"532","tehama","2020-04-07","   0","    0","   2","  0","    0","   2"
"533","santa cruz","2020-04-07","   0","    0","   4","  7","    0","  -3"
"534","butte","2020-04-07","   0","    0","   6","  6","    0","   0"
"535","mariposa","2020-04-07","   0","    0","   0","  0","    0","   0"
"536","placer","2020-04-07","   0","    0","  20"," 12","    0","   8"
"537","marin","2020-04-07","   0","    0","  12","  8","    0","   4"
"538","mono","2020-04-07","   0","    0","   2","  0","    0","   2"
"539","del norte","2020-04-07","   0","    0","   2","  1","    0","   1"
"540","santa clara","2020-04-07","   0","    0"," 105"," 84","    0","  21"
"541","monterey","2020-04-07","   0","    0","  21","  9","    0","  12"
"542","san mateo","2020-04-07","   0","    0","  35"," 28","    0","   7"
"543","lake","2020-04-07","   0","    0","   1","  0","    0","   1"
"544","sonoma","2020-04-07","   0","    0","  21","  8","    0","  13"
"545","inyo","2020-04-07","   0","    0","   3","  1","    0","   2"
"546","amador","2020-04-07","   0","    0","   3","  0","    0","   3"
"547","ventura","2020-04-07","   0","    0","  31"," 29","    0","   2"
"548","sacramento","2020-04-07","   0","    0","  72"," 46","    0","  26"
"549","shasta","2020-04-07","   0","    0","   6","  5","    0","   1"
"550","calaveras","2020-04-07","   0","    0","   8","  0","    0","   8"
"551","solano","2020-04-07","   0","    0","  31"," 13","    0","  18"
"552","trinity","2020-04-07","   0","    0","   0","  0","    0","   0"
"553","glenn","2020-04-07","   0","    0","   0","  0","    0","   0"
"554","merced","2020-04-07","   0","    0","   3","  3","    0","   0"
"555","riverside","2020-04-07","   0","    0"," 129","114","    0","  15"
"556","madera","2020-04-07","   0","    0","   7","  1","    0","   6"
"557","fresno","2020-04-07","   0","    0","  50"," 24","    0","  26"
"558","tulare","2020-04-07","   0","    0","  10"," 11","    0","  -1"
"559","yuba","2020-04-07","   0","    0","   6","  6","    0","   0"
"560","imperial","2020-04-07","   0","    0","   3","  9","    0","  -6"
"561","humboldt","2020-04-07","   0","    0","   7","  0","    0","   7"
"562","san bernardino","2020-04-07","   0","    0"," 126","103","    0","  23"
"563","mendocino","2020-04-07","   0","    0","   9","  0","    0","   9"
"564","placer","2020-04-08","   0","    0","  19"," 12","    0","   7"
"565","marin","2020-04-08","   0","    0","  17","  6","    0","  11"
"566","mono","2020-04-08","   0","    0","   2","  0","    0","   2"
"567","humboldt","2020-04-08","   0","    0","   6","  0","    0","   6"
"568","contra costa","2020-04-08","   0","    0","  78"," 31","    0","  47"
"569","glenn","2020-04-08","   0","    0","   0","  0","    0","   0"
"570","calaveras","2020-04-08","   0","    0","   8","  0","    0","   8"
"571","inyo","2020-04-08","   0","    0","   2","  2","    0","   0"
"572","amador","2020-04-08","   0","    0","   1","  0","    0","   1"
"573","del norte","2020-04-08","   0","    0","   4","  1","    0","   3"
"574","yolo","2020-04-08","   0","    0","   6","  3","    0","   3"
"575","sonoma","2020-04-08","   0","    0","  18","  7","    0","  11"
"576","sutter","2020-04-08","   0","    0","   0","  0","    0","   0"
"577","tehama","2020-04-08","   0","    0","   4","  0","    0","   4"
"578","nevada","2020-04-08","   0","    0","   6","  4","    0","   2"
"579","merced","2020-04-08","   0","    0","   5","  2","    0","   3"
"580","madera","2020-04-08","   0","    0","   7","  1","    0","   6"
"581","solano","2020-04-08","   0","    0","  27"," 10","    0","  17"
"582","lake","2020-04-08","   0","    0","   1","  1","    0","   0"
"583","imperial","2020-04-08","   0","    0","   3"," 11","    0","  -8"
"584","siskiyou","2020-04-08","   0","    0","   5","  1","    0","   4"
"585","kings","2020-04-08","   0","    0","   1","  2","    0","  -1"
"586","napa","2020-04-08","   0","    0","   5","  1","    0","   4"
"587","tulare","2020-04-08","   0","    0","  22","  7","    0","  15"
"588","orange","2020-04-08","   0","    0"," 201"," 83","    0"," 118"
"589","lassen","2020-04-08","   0","    0","   0","  0","    0","   0"
"590","stanislaus","2020-04-08","   0","    0","  58"," 16","    0","  42"
"591","mendocino","2020-04-08","   0","    0","   7","  0","    0","   7"
"592","butte","2020-04-08","   0","    0","   4","  8","    0","  -4"
"593","los angeles","2020-04-08","   0","    0"," 582","743","    0","-161"
"594","san joaquin","2020-04-08","   0","    0","  18"," 19","    0","  -1"
"595","fresno","2020-04-08","   0","    0","  64"," 18","    0","  46"
"596","ventura","2020-04-08","   0","    0","  31"," 23","    0","   8"
"597","alameda","2020-04-08","   0","    0"," 111"," 63","    0","  48"
"598","san luis obispo","2020-04-08","   0","    0","  22"," 13","    0","   9"
"599","santa clara","2020-04-08","   0","    0"," 104"," 76","    0","  28"
"600","colusa","2020-04-08","   0","    0","   6","  0","    0","   6"
"601","monterey","2020-04-08","   0","    0","  24","  5","    0","  19"
"602","santa cruz","2020-04-08","   0","    0","   8","  7","    0","   1"
"603","plumas","2020-04-08","   0","    0","   0","  0","    0","   0"
"604","santa barbara","2020-04-08","   0","    0","  51"," 20","    0","  31"
"605","san benito","2020-04-08","   0","    0","   1","  1","    0","   0"
"606","mariposa","2020-04-08","   0","    0","   0","  0","    0","   0"
"607","kern","2020-04-08","   0","    0","  32"," 19","    0","  13"
"608","yuba","2020-04-08","   0","    0","   5","  4","    0","   1"
"609","sacramento","2020-04-08","   0","    0","  73"," 40","    0","  33"
"610","san bernardino","2020-04-08","   0","    0"," 144","104","    0","  40"
"611","san francisco","2020-04-08","   0","    0","  55"," 53","    0","   2"
"612","el dorado","2020-04-08","   0","    0","  10","  1","    0","   9"
"613","tuolumne","2020-04-08","   0","    0","   1","  0","    0","   1"
"614","san diego","2020-04-08","   0","    0"," 183","116","    0","  67"
"615","modoc","2020-04-08","   0","    0","   0","  0","    0","   0"
"616","trinity","2020-04-08","   0","    0","   0","  0","    0","   0"
"617","riverside","2020-04-08","   0","    0"," 154"," 97","    0","  57"
"618","san mateo","2020-04-08","   0","    0","  32"," 27","    0","   5"
"619","shasta","2020-04-08","   0","    0","  10","  4","    0","   6"
"620","yuba","2020-04-09","   0","    0","   6","  6","    0","   0"
"621","mariposa","2020-04-09","   0","    0","   0","  0","    0","   0"
"622","plumas","2020-04-09","   0","    0","   0","  0","    0","   0"
"623","glenn","2020-04-09","   0","    0","   0","  0","    0","   0"
"624","san bernardino","2020-04-09","   0","    0"," 143"," 97","    0","  46"
"625","santa cruz","2020-04-09","   0","    0","   7","  7","    0","   0"
"626","contra costa","2020-04-09","   0","    0","  73"," 30","    0","  43"
"627","san mateo","2020-04-09","   0","    0","  39"," 20","    0","  19"
"628","alameda","2020-04-09","   0","    0"," 107"," 62","    0","  45"
"629","colusa","2020-04-09","   0","    0","   5","  1","    0","   4"
"630","merced","2020-04-09","   0","    0","   5","  2","    0","   3"
"631","tehama","2020-04-09","   0","    0","   5","  1","    0","   4"
"632","ventura","2020-04-09","   0","    0","  29"," 21","    0","   8"
"633","calaveras","2020-04-09","   0","    0","  11","  0","    0","  11"
"634","santa clara","2020-04-09","   0","    0","  87"," 87","    0","   0"
"635","riverside","2020-04-09","   0","    0"," 133"," 93","    0","  40"
"636","trinity","2020-04-09","   0","    0","   0","  0","    0","   0"
"637","modoc","2020-04-09","   0","    0","   0","  0","    0","   0"
"638","lake","2020-04-09","   0","    0","   2","  1","    0","   1"
"639","placer","2020-04-09","   0","    0","  16"," 10","    0","   6"
"640","amador","2020-04-09","   0","    0","   3","  0","    0","   3"
"641","stanislaus","2020-04-09","   0","    0","  45"," 18","    0","  27"
"642","san luis obispo","2020-04-09","   0","    0","  21"," 10","    0","  11"
"643","butte","2020-04-09","   0","    0","   5","  5","    0","   0"
"644","tuolumne","2020-04-09","   0","    0","   5","  0","    0","   5"
"645","san diego","2020-04-09","   0","    0"," 163","116","    0","  47"
"646","napa","2020-04-09","   0","    0","  10","  0","    0","  10"
"647","san benito","2020-04-09","   0","    0","   1","  1","    0","   0"
"648","siskiyou","2020-04-09","   0","    0","   5","  0","    0","   5"
"649","madera","2020-04-09","   0","    0","   5","  2","    0","   3"
"650","santa barbara","2020-04-09","   0","    0","  45"," 22","    0","  23"
"651","imperial","2020-04-09","   0","    0","   1"," 10","    0","  -9"
"652","san francisco","2020-04-09","   0","    0","  45"," 46","    0","  -1"
"653","tulare","2020-04-09","   0","    0","  19","  9","    0","  10"
"654","kings","2020-04-09","   0","    0","   2","  3","    0","  -1"
"655","lassen","2020-04-09","   0","    0","   0","  0","    0","   0"
"656","inyo","2020-04-09","   0","    0","   3","  1","    0","   2"
"657","los angeles","2020-04-09","   0","    0"," 569","697","    0","-128"
"658","fresno","2020-04-09","   0","    0","  59"," 19","    0","  40"
"659","sacramento","2020-04-09","   0","    0","  63"," 42","    0","  21"
"660","mendocino","2020-04-09","   0","    0","   8","  0","    0","   8"
"661","san joaquin","2020-04-09","   0","    0","  16"," 19","    0","  -3"
"662","yolo","2020-04-09","   0","    0","  11","  3","    0","   8"
"663","nevada","2020-04-09","   0","    0","   4","  3","    0","   1"
"664","shasta","2020-04-09","   0","    0","   5","  3","    0","   2"
"665","marin","2020-04-09","   0","    0","  21","  3","    0","  18"
"666","humboldt","2020-04-09","   0","    0","   6","  2","    0","   4"
"667","del norte","2020-04-09","   0","    0","   5","  0","    0","   5"
"668","orange","2020-04-09","   0","    0"," 206"," 74","    0"," 132"
"669","sonoma","2020-04-09","   0","    0","  24","  6","    0","  18"
"670","kern","2020-04-09","   0","    0","  25"," 25","    0","   0"
"671","el dorado","2020-04-09","   0","    0","  10","  1","    0","   9"
"672","sutter","2020-04-09","   0","    0","   0","  0","    0","   0"
"673","solano","2020-04-09","   0","    0","  33","  8","    0","  25"
"674","mono","2020-04-09","   0","    0","   2","  0","    0","   2"
"675","monterey","2020-04-09","   0","    0","  22","  5","    0","  17"
"676","sutter","2020-04-10","   0","    0","   0","  0","    0","   0"
"677","del norte","2020-04-10","   0","    0","   4","  0","    0","   4"
"678","san francisco","2020-04-10","   0","    0"," 125"," 44","    0","  81"
"679","santa clara","2020-04-10","   0","    0","  99"," 72","    0","  27"
"680","trinity","2020-04-10","   0","    0","   0","  0","    0","   0"
"681","lake","2020-04-10","   0","    0","   2","  0","    0","   2"
"682","san luis obispo","2020-04-10","   0","    0","  24","  5","    0","  19"
"683","solano","2020-04-10","   0","    0","  31"," 12","    0","  19"
"684","mendocino","2020-04-10","   0","    0","   5","  1","    0","   4"
"685","orange","2020-04-10","   0","    0"," 187"," 94","    0","  93"
"686","stanislaus","2020-04-10","   0","    0","  44"," 14","    0","  30"
"687","plumas","2020-04-10","   0","    0","   0","  0","    0","   0"
"688","santa cruz","2020-04-10","   0","    0","   4","  8","    0","  -4"
"689","santa barbara","2020-04-10","   0","    0","  43"," 20","    0","  23"
"690","humboldt","2020-04-10","   0","    0","   0","  3","    0","  -3"
"691","yolo","2020-04-10","   0","    0","   7","  2","    0","   5"
"692","amador","2020-04-10","   0","    0","   4","  0","    0","   4"
"693","placer","2020-04-10","   0","    0","   9"," 12","    0","  -3"
"694","butte","2020-04-10","   0","    0","   5","  6","    0","  -1"
"695","colusa","2020-04-10","   0","    0","   6","  0","    0","   6"
"696","mariposa","2020-04-10","   0","    0","   0","  0","    0","   0"
"697","glenn","2020-04-10","   0","    0","   0","  0","    0","   0"
"698","sonoma","2020-04-10","   0","    0","  32","  7","    0","  25"
"699","modoc","2020-04-10","   0","    0","   0","  0","    0","   0"
"700","madera","2020-04-10","   0","    0","   6","  1","    0","   5"
"701","lassen","2020-04-10","   0","    0","   0","  0","    0","   0"
"702","shasta","2020-04-10","   0","    0","  12","  3","    0","   9"
"703","alameda","2020-04-10","   0","    0"," 128"," 71","    0","  57"
"704","fresno","2020-04-10","   0","    0","  57"," 20","    0","  37"
"705","monterey","2020-04-10","   0","    0","  25","  6","    0","  19"
"706","marin","2020-04-10","   0","    0","  17","  2","    0","  15"
"707","contra costa","2020-04-10","   0","    0","  75"," 23","    0","  52"
"708","los angeles","2020-04-10","   0","    0"," 663","656","    0","   7"
"709","san diego","2020-04-10","   0","    0"," 153","110","    0","  43"
"710","riverside","2020-04-10","   0","    0"," 140"," 91","    0","  49"
"711","sacramento","2020-04-10","   0","    0","  69"," 43","    0","  26"
"712","tulare","2020-04-10","   0","    0","  16","  7","    0","   9"
"713","merced","2020-04-10","   0","    0","   4","  1","    0","   3"
"714","nevada","2020-04-10","   0","    0","   6","  3","    0","   3"
"715","san joaquin","2020-04-10","   0","    0","  20"," 19","    0","   1"
"716","imperial","2020-04-10","   0","    0","   1"," 11","    0"," -10"
"717","san mateo","2020-04-10","   0","    0","  41"," 21","    0","  20"
"718","tehama","2020-04-10","   0","    0","   8","  0","    0","   8"
"719","kings","2020-04-10","   0","    0","   1","  3","    0","  -2"
"720","mono","2020-04-10","   0","    0","   2","  0","    0","   2"
"721","tuolumne","2020-04-10","   0","    0","   0","  1","    0","  -1"
"722","kern","2020-04-10","   0","    0","  45"," 20","    0","  25"
"723","el dorado","2020-04-10","   0","    0","  10","  1","    0","   9"
"724","siskiyou","2020-04-10","   0","    0","   4","  0","    0","   4"
"725","san bernardino","2020-04-10","   0","    0"," 134","124","    0","  10"
"726","ventura","2020-04-10","   0","    0","  30"," 21","    0","   9"
"727","napa","2020-04-10","   0","    0","   7","  4","    0","   3"
"728","san benito","2020-04-10","   0","    0","   1","  1","    0","   0"
"729","inyo","2020-04-10","   0","    0","   3","  1","    0","   2"
"730","calaveras","2020-04-10","   0","    0","  11","  0","    0","  11"
"731","yuba","2020-04-10","   0","    0","   7","  1","    0","   6"
"732","san joaquin","2020-04-11","   0","    0","  28"," 19","    0","   9"
"733","tuolumne","2020-04-11","   0","    0","   3","  0","    0","   3"
"734","trinity","2020-04-11","   0","    0","   0","  0","    0","   0"
"735","yolo","2020-04-11","   0","    0","   7","  1","    0","   6"
"736","del norte","2020-04-11","   0","    0","   5","  1","    0","   4"
"737","lassen","2020-04-11","   0","    0","   0","  0","    0","   0"
"738","solano","2020-04-11","   0","    0","  32"," 13","    0","  19"
"739","el dorado","2020-04-11","   0","    0","   9","  1","    0","   8"
"740","santa clara","2020-04-11","   0","    0"," 106"," 74","    0","  32"
"741","amador","2020-04-11","   0","    0","   4","  0","    0","   4"
"742","placer","2020-04-11","   0","    0","  13"," 11","    0","   2"
"743","mariposa","2020-04-11","   0","    0","   0","  0","    0","   0"
"744","colusa","2020-04-11","   0","    0","   6","  0","    0","   6"
"745","kings","2020-04-11","   0","    0","   1","  4","    0","  -3"
"746","sonoma","2020-04-11","   0","    0","  30","  5","    0","  25"
"747","monterey","2020-04-11","   0","    0","  24","  7","    0","  17"
"748","napa","2020-04-11","   0","    0","   5","  0","    0","   5"
"749","stanislaus","2020-04-11","   0","    0","  44"," 12","    0","  32"
"750","riverside","2020-04-11","   0","    0"," 149"," 83","    0","  66"
"751","plumas","2020-04-11","   0","    0","   0","  0","    0","   0"
"752","butte","2020-04-11","   0","    0","   5","  2","    0","   3"
"753","glenn","2020-04-11","   0","    0","   0","  0","    0","   0"
"754","santa barbara","2020-04-11","   0","    0","  53"," 25","    0","  28"
"755","san benito","2020-04-11","   0","    0","   2","  0","    0","   2"
"756","humboldt","2020-04-11","   0","    0","   3","  3","    0","   0"
"757","madera","2020-04-11","   0","    0","   5","  2","    0","   3"
"758","calaveras","2020-04-11","   0","    0","  11","  1","    0","  10"
"759","merced","2020-04-11","   0","    0","   3","  1","    0","   2"
"760","yuba","2020-04-11","   0","    0","   9","  2","    0","   7"
"761","san francisco","2020-04-11","   0","    0"," 132"," 41","    0","  91"
"762","san luis obispo","2020-04-11","   0","    0","  23","  7","    0","  16"
"763","mono","2020-04-11","   0","    0","   2","  0","    0","   2"
"764","modoc","2020-04-11","   0","    0","   0","  0","    0","   0"
"765","nevada","2020-04-11","   0","    0","   5","  3","    0","   2"
"766","tehama","2020-04-11","   0","    0","   7","  0","    0","   7"
"767","sutter","2020-04-11","   0","    0","   0","  0","    0","   0"
"768","san diego","2020-04-11","   0","    0"," 140","121","    0","  19"
"769","fresno","2020-04-11","   0","    0","  52"," 19","    0","  33"
"770","inyo","2020-04-11","   0","    0","   3","  1","    0","   2"
"771","lake","2020-04-11","   0","    0","   0","  0","    0","   0"
"772","contra costa","2020-04-11","   0","    0","  75"," 30","    0","  45"
"773","marin","2020-04-11","   0","    0","  14","  4","    0","  10"
"774","alameda","2020-04-11","   0","    0"," 121"," 65","    0","  56"
"775","kern","2020-04-11","   0","    0","  41"," 21","    0","  20"
"776","santa cruz","2020-04-11","   0","    0","   6","  9","    0","  -3"
"777","shasta","2020-04-11","   0","    0","  12","  2","    0","  10"
"778","sacramento","2020-04-11","   0","    0","  80"," 39","    0","  41"
"779","los angeles","2020-04-11","   0","    0"," 595","690","    0"," -95"
"780","san bernardino","2020-04-11","   0","    0"," 117"," 99","    0","  18"
"781","siskiyou","2020-04-11","   0","    0","   4","  0","    0","   4"
"782","orange","2020-04-11","   0","    0"," 219"," 64","    0"," 155"
"783","mendocino","2020-04-11","   0","    0","   9","  1","    0","   8"
"784","imperial","2020-04-11","   0","    0","   1"," 10","    0","  -9"
"785","tulare","2020-04-11","   0","    0","  19","  6","    0","  13"
"786","ventura","2020-04-11","   0","    0","  33"," 20","    0","  13"
"787","san mateo","2020-04-11","   0","    0","  42"," 20","    0","  22"
"788","mariposa","2020-04-12","   0","    0","   0","  0","    0","   0"
"789","trinity","2020-04-12","   0","    0","   0","  0","    0","   0"
"790","sutter","2020-04-12","   0","    0","   0","  0","    0","   0"
"791","modoc","2020-04-12","   0","    0","   0","  0","    0","   0"
"792","mono","2020-04-12","   0","    0","   2","  0","    0","   2"
"793","madera","2020-04-12","   0","    0","   5","  0","    0","   5"
"794","el dorado","2020-04-12","   0","    0","  11","  0","    0","  11"
"795","placer","2020-04-12","   0","    0","   6","  9","    0","  -3"
"796","marin","2020-04-12","   0","    0","  13","  2","    0","  11"
"797","glenn","2020-04-12","   0","    0","   0","  0","    0","   0"
"798","nevada","2020-04-12","   0","    0","   4","  4","    0","   0"
"799","fresno","2020-04-12","   0","    0","  54"," 15","    0","  39"
"800","del norte","2020-04-12","   0","    0","   6","  0","    0","   6"
"801","tuolumne","2020-04-12","   0","    0","   5","  0","    0","   5"
"802","orange","2020-04-12","   0","    0"," 190"," 96","    0","  94"
"803","alameda","2020-04-12","   0","    0","  52"," 63","    0"," -11"
"804","sonoma","2020-04-12","   0","    0","  25","  4","    0","  21"
"805","colusa","2020-04-12","   0","    0","   6","  0","    0","   6"
"806","san diego","2020-04-12","   0","    0"," 170","118","    0","  52"
"807","yolo","2020-04-12","   0","    0","   3","  2","    0","   1"
"808","calaveras","2020-04-12","   0","    0","   9","  2","    0","   7"
"809","santa cruz","2020-04-12","   0","    0","   4","  9","    0","  -5"
"810","tehama","2020-04-12","   0","    0","   6","  0","    0","   6"
"811","mendocino","2020-04-12","   0","    0","   6","  0","    0","   6"
"812","plumas","2020-04-12","   0","    0","   0","  0","    0","   0"
"813","inyo","2020-04-12","   0","    0","   4","  1","    0","   3"
"814","solano","2020-04-12","   0","    0","  30"," 17","    0","  13"
"815","lake","2020-04-12","   0","    0","   0","  0","    0","   0"
"816","amador","2020-04-12","   0","    0","   3","  0","    0","   3"
"817","humboldt","2020-04-12","   0","    0","   3","  2","    0","   1"
"818","san benito","2020-04-12","   0","    0","   2","  0","    0","   2"
"819","butte","2020-04-12","   0","    0","  15","  2","    0","  13"
"820","imperial","2020-04-12","   0","    0","   2","  9","    0","  -7"
"821","san mateo","2020-04-12","   0","    0","  23"," 18","    0","   5"
"822","shasta","2020-04-12","   0","    0","  15","  2","    0","  13"
"823","siskiyou","2020-04-12","   0","    0","   6","  0","    0","   6"
"824","merced","2020-04-12","   0","    0","   2","  2","    0","   0"
"825","sacramento","2020-04-12","   0","    0","  68"," 37","    0","  31"
"826","san luis obispo","2020-04-12","   0","    0","  24","  6","    0","  18"
"827","santa barbara","2020-04-12","   0","    0","  53"," 22","    0","  31"
"828","contra costa","2020-04-12","   0","    0","  64"," 19","    0","  45"
"829","monterey","2020-04-12","   0","    0","  26","  8","    0","  18"
"830","santa clara","2020-04-12","   0","    0"," 102"," 74","    0","  28"
"831","san bernardino","2020-04-12","   0","    0"," 108"," 99","    0","   9"
"832","stanislaus","2020-04-12","   0","    0","   7"," 11","    0","  -4"
"833","riverside","2020-04-12","   0","    0"," 146"," 95","    0","  51"
"834","ventura","2020-04-12","   0","    0","  36"," 16","    0","  20"
"835","kings","2020-04-12","   0","    0","   3","  3","    0","   0"
"836","los angeles","2020-04-12","   0","    0"," 564","703","    0","-139"
"837","tulare","2020-04-12","   0","    0","  22","  7","    0","  15"
"838","san francisco","2020-04-12","   0","    0","  71"," 37","    0","  34"
"839","napa","2020-04-12","   0","    0","   6","  0","    0","   6"
"840","lassen","2020-04-12","   0","    0","   0","  0","    0","   0"
"841","kern","2020-04-12","   0","    0","  41"," 21","    0","  20"
"842","yuba","2020-04-12","   0","    0","   6","  1","    0","   5"
"843","san joaquin","2020-04-12","   0","    0","  23"," 16","    0","   7"
"844","mono","2020-04-13","   0","    0","   2","  0","    0","   2"
"845","sacramento","2020-04-13","   0","    0","  65"," 35","    0","  30"
"846","tulare","2020-04-13","   0","    0","  18","  6","    0","  12"
"847","inyo","2020-04-13","   0","    0","   3","  3","    0","   0"
"848","napa","2020-04-13","   0","    0","   9","  0","    0","   9"
"849","yolo","2020-04-13","   0","    0","  14","  2","    0","  12"
"850","nevada","2020-04-13","   0","    0","   5","  4","    0","   1"
"851","santa clara","2020-04-13","   0","    0","  87"," 76","    0","  11"
"852","shasta","2020-04-13","   0","    0","   6","  2","    0","   4"
"853","fresno","2020-04-13","   0","    0","  60"," 20","    0","  40"
"854","riverside","2020-04-13","   0","    0"," 132"," 96","    0","  36"
"855","san mateo","2020-04-13","   0","    0","  26"," 22","    0","   4"
"856","merced","2020-04-13","   0","    0","   5","  1","    0","   4"
"857","sonoma","2020-04-13","   0","    0","  31","  4","    0","  27"
"858","santa cruz","2020-04-13","   0","    0","   1","  5","    0","  -4"
"859","calaveras","2020-04-13","   0","    0","  10","  1","    0","   9"
"860","marin","2020-04-13","   0","    0","  12","  3","    0","   9"
"861","san francisco","2020-04-13","   0","    0","  61"," 39","    0","  22"
"862","plumas","2020-04-13","   0","    0","   0","  0","    0","   0"
"863","mariposa","2020-04-13","   0","    0","   0","  0","    0","   0"
"864","humboldt","2020-04-13","   0","    0","  10","  1","    0","   9"
"865","san diego","2020-04-13","   0","    0"," 171","125","    0","  46"
"866","tehama","2020-04-13","   0","    0","   6","  0","    0","   6"
"867","santa barbara","2020-04-13","   0","    0","  59"," 23","    0","  36"
"868","yuba","2020-04-13","   0","    0","   8","  0","    0","   8"
"869","lake","2020-04-13","   0","    0","   3","  1","    0","   2"
"870","contra costa","2020-04-13","   0","    0","  69"," 21","    0","  48"
"871","trinity","2020-04-13","   0","    0","   0","  0","    0","   0"
"872","mendocino","2020-04-13","   0","    0","   6","  3","    0","   3"
"873","kern","2020-04-13","   0","    0","  49"," 19","    0","  30"
"874","glenn","2020-04-13","   0","    0","   0","  0","    0","   0"
"875","tuolumne","2020-04-13","   0","    0","   6","  0","    0","   6"
"876","kings","2020-04-13","   0","    0","   0","  1","    0","  -1"
"877","ventura","2020-04-13","   0","    0","  35"," 18","    0","  17"
"878","lassen","2020-04-13","   0","    0","   0","  0","    0","   0"
"879","modoc","2020-04-13","   0","    0","   0","  0","    0","   0"
"880","madera","2020-04-13","   0","    0","   8","  1","    0","   7"
"881","san benito","2020-04-13","   0","    0","   2","  0","    0","   2"
"882","san luis obispo","2020-04-13","   0","    0","  20","  4","    0","  16"
"883","los angeles","2020-04-13","   0","    0"," 632","720","    0"," -88"
"884","el dorado","2020-04-13","   0","    0","  12","  1","    0","  11"
"885","san bernardino","2020-04-13","   0","    0"," 135"," 84","    0","  51"
"886","placer","2020-04-13","   0","    0","  10","  8","    0","   2"
"887","butte","2020-04-13","   0","    0","   3","  8","    0","  -5"
"888","siskiyou","2020-04-13","   0","    0","   3","  2","    0","   1"
"889","colusa","2020-04-13","   0","    0","   6","  0","    0","   6"
"890","imperial","2020-04-13","   0","    0","   6","  8","    0","  -2"
"891","stanislaus","2020-04-13","   0","    0","  45"," 14","    0","  31"
"892","solano","2020-04-13","   0","    0","  27"," 12","    0","  15"
"893","orange","2020-04-13","   0","    0"," 205"," 71","    0"," 134"
"894","monterey","2020-04-13","   0","    0","  21","  6","    0","  15"
"895","del norte","2020-04-13","   0","    0","   3","  1","    0","   2"
"896","amador","2020-04-13","   0","    0","   3","  0","    0","   3"
"897","alameda","2020-04-13","   0","    0","  58"," 61","    0","  -3"
"898","san joaquin","2020-04-13","   0","    0","  14"," 20","    0","  -6"
"899","sutter","2020-04-13","   0","    0","   0","  0","    0","   0"
"900","mariposa","2020-04-14","   0","    0","   0","  0","    0","   0"
"901","lassen","2020-04-14","   0","    0","   0","  0","    0","   0"
"902","humboldt","2020-04-14","   0","    0","  10","  0","    0","  10"
"903","modoc","2020-04-14","   0","    0","   0","  0","    0","   0"
"904","tuolumne","2020-04-14","   0","    0","   1","  0","    0","   1"
"905","mono","2020-04-14","   0","    0","   2","  0","    0","   2"
"906","napa","2020-04-14","   0","    0","   8","  0","    0","   8"
"907","yuba","2020-04-14","   0","    0","   7","  1","    0","   6"
"908","inyo","2020-04-14","   0","    0","   5","  1","    0","   4"
"909","los angeles","2020-04-14","   0","    0"," 614","703","    0"," -89"
"910","calaveras","2020-04-14","   0","    0","  12","  0","    0","  12"
"911","trinity","2020-04-14","   0","    0","   0","  0","    0","   0"
"912","riverside","2020-04-14","   0","    0"," 141","100","    0","  41"
"913","fresno","2020-04-14","   0","    0","  42"," 20","    0","  22"
"914","tehama","2020-04-14","   0","    0","   4","  0","    0","   4"
"915","orange","2020-04-14","   0","    0"," 259"," 88","    0"," 171"
"916","lake","2020-04-14","   0","    0","   3","  0","    0","   3"
"917","plumas","2020-04-14","   0","    0","   0","  0","    0","   0"
"918","san bernardino","2020-04-14","   0","    0"," 117","102","    0","  15"
"919","el dorado","2020-04-14","   0","    0","  12","  0","    0","  12"
"920","shasta","2020-04-14","   0","    0","   9","  3","    0","   6"
"921","santa cruz","2020-04-14","   0","    0","   3","  3","    0","   0"
"922","san diego","2020-04-14","   0","    0"," 162","123","    0","  39"
"923","del norte","2020-04-14","   0","    0","   4","  4","    0","   0"
"924","santa clara","2020-04-14","   0","    0"," 104"," 71","    0","  33"
"925","san luis obispo","2020-04-14","   0","    0","  18","  8","    0","  10"
"926","kern","2020-04-14","   0","    0","  45"," 20","    0","  25"
"927","mendocino","2020-04-14","   0","    0","   6","  0","    0","   6"
"928","san francisco","2020-04-14","   0","    0","  69"," 33","    0","  36"
"929","ventura","2020-04-14","   0","    0","  43"," 16","    0","  27"
"930","imperial","2020-04-14","   0","    0","   3","  9","    0","  -6"
"931","glenn","2020-04-14","   0","    0","   0","  0","    0","   0"
"932","san joaquin","2020-04-14","   0","    0","  12"," 13","    0","  -1"
"933","sacramento","2020-04-14","   0","    0","  59"," 32","    0","  27"
"934","san mateo","2020-04-14","   0","    0","  25"," 23","    0","   2"
"935","nevada","2020-04-14","   0","    0","   7","  3","    0","   4"
"936","san benito","2020-04-14","   0","    0","   2","  0","    0","   2"
"937","santa barbara","2020-04-14","   0","    0","  64"," 20","    0","  44"
"938","merced","2020-04-14","   0","    0","   4","  2","    0","   2"
"939","yolo","2020-04-14","   0","    0","  12","  2","    0","  10"
"940","siskiyou","2020-04-14","   0","    0","   2","  0","    0","   2"
"941","placer","2020-04-14","   0","    0","   9","  9","    0","   0"
"942","solano","2020-04-14","   0","    0","  27"," 10","    0","  17"
"943","kings","2020-04-14","   0","    0","   2","  2","    0","   0"
"944","sutter","2020-04-14","   0","    0","   0","  0","    0","   0"
"945","marin","2020-04-14","   0","    0","   9","  5","    0","   4"
"946","contra costa","2020-04-14","   0","    0","  61"," 24","    0","  37"
"947","tulare","2020-04-14","   0","    0","  18","  6","    0","  12"
"948","alameda","2020-04-14","   0","    0","  61"," 55","    0","   6"
"949","butte","2020-04-14","   0","    0","   4","  7","    0","  -3"
"950","stanislaus","2020-04-14","   0","    0","  50"," 16","    0","  34"
"951","monterey","2020-04-14","   0","    0","  25","  3","    0","  22"
"952","sonoma","2020-04-14","   0","    0","  23","  4","    0","  19"
"953","amador","2020-04-14","   0","    0","   4","  0","    0","   4"
"954","madera","2020-04-14","   0","    0","   7","  2","    0","   5"
"955","colusa","2020-04-14","   0","    0","   6","  0","    0","   6"
"956","santa clara","2020-04-15","   0","    0","  92"," 71","    0","  21"
"957","fresno","2020-04-15","   0","    0","  44"," 14","    0","  30"
"958","santa cruz","2020-04-15","   0","    0","   5","  5","    0","   0"
"959","marin","2020-04-15","   0","    0","  11","  6","    0","   5"
"960","san mateo","2020-04-15","   0","    0","  27"," 18","    0","   9"
"961","nevada","2020-04-15","   0","    0","   2","  3","    0","  -1"
"962","merced","2020-04-15","   0","    0","   5","  0","    0","   5"
"963","yolo","2020-04-15","   0","    0","  14","  2","    0","  12"
"964","colusa","2020-04-15","   0","    0","   6","  0","    0","   6"
"965","tehama","2020-04-15","   0","    0","   7","  0","    0","   7"
"966","kings","2020-04-15","   0","    0","   3","  2","    0","   1"
"967","amador","2020-04-15","   0","    0","   2","  0","    0","   2"
"968","san bernardino","2020-04-15","   0","    0","  61","104","    0"," -43"
"969","tulare","2020-04-15","   0","    0","  22","  7","    0","  15"
"970","alameda","2020-04-15","   0","    0","  70"," 45","    0","  25"
"971","madera","2020-04-15","   0","    0","   6","  1","    0","   5"
"972","siskiyou","2020-04-15","   0","    0","   3","  2","    0","   1"
"973","santa barbara","2020-04-15","   0","    0","  61"," 19","    0","  42"
"974","mono","2020-04-15","   0","    0","   2","  0","    0","   2"
"975","humboldt","2020-04-15","   0","    0","  11","  0","    0","  11"
"976","inyo","2020-04-15","   0","    0","   6","  0","    0","   6"
"977","solano","2020-04-15","   0","    0","  30"," 10","    0","  20"
"978","yuba","2020-04-15","   0","    0","   8","  2","    0","   6"
"979","lake","2020-04-15","   0","    0","   1","  2","    0","  -1"
"980","mendocino","2020-04-15","   0","    0","   8","  0","    0","   8"
"981","napa","2020-04-15","   0","    0","   8","  0","    0","   8"
"982","san francisco","2020-04-15","   0","    0","  76"," 32","    0","  44"
"983","mariposa","2020-04-15","   0","    0","   0","  0","    0","   0"
"984","orange","2020-04-15","   0","    0"," 235","100","    0"," 135"
"985","san joaquin","2020-04-15","   0","    0","  27"," 13","    0","  14"
"986","imperial","2020-04-15","   0","    0","   2"," 11","    0","  -9"
"987","contra costa","2020-04-15","   0","    0","  76"," 24","    0","  52"
"988","sonoma","2020-04-15","   0","    0","  25","  8","    0","  17"
"989","san diego","2020-04-15","   0","    0"," 148","121","    0","  27"
"990","los angeles","2020-04-15","   0","    0"," 566","739","    0","-173"
"991","sacramento","2020-04-15","   0","    0","  55"," 34","    0","  21"
"992","shasta","2020-04-15","   0","    0","  13","  1","    0","  12"
"993","lassen","2020-04-15","   0","    0","   0","  0","    0","   0"
"994","del norte","2020-04-15","   0","    0","   4","  1","    0","   3"
"995","glenn","2020-04-15","   0","    0","   0","  0","    0","   0"
"996","calaveras","2020-04-15","   0","    0","  10","  0","    0","  10"
"997","tuolumne","2020-04-15","   0","    0","   3","  0","    0","   3"
"998","stanislaus","2020-04-15","   0","    0","  33"," 11","    0","  22"
"999","sutter","2020-04-15","   0","    0","   0","  0","    0","   0"
"1000","plumas","2020-04-15","   0","    0","   0","  0","    0","   0"
"1001","riverside","2020-04-15","   0","    0"," 112"," 99","    0","  13"
"1002","monterey","2020-04-15","   0","    0","  22","  5","    0","  17"
"1003","butte","2020-04-15","   0","    0","   6","  2","    0","   4"
"1004","san benito","2020-04-15","   0","    0","   4","  0","    0","   4"
"1005","modoc","2020-04-15","   0","    0","   0","  0","    0","   0"
"1006","el dorado","2020-04-15","   0","    0","  12","  1","    0","  11"
"1007","trinity","2020-04-15","   0","    0","   0","  0","    0","   0"
"1008","ventura","2020-04-15","   0","    0","  37"," 24","    0","  13"
"1009","kern","2020-04-15","   0","    0","  47"," 17","    0","  30"
"1010","san luis obispo","2020-04-15","   0","    0","  28","  6","    0","  22"
"1011","placer","2020-04-15","   0","    0","  12","  6","    0","   6"
"1012","san diego","2020-04-16","   0","    0"," 151","113","    0","  38"
"1013","lassen","2020-04-16","   0","    0","   0","  0","    0","   0"
"1014","napa","2020-04-16","   0","    0","   2","  0","    0","   2"
"1015","el dorado","2020-04-16","   0","    0","  14","  0","    0","  14"
"1016","stanislaus","2020-04-16","   0","    0","  25","  9","    0","  16"
"1017","amador","2020-04-16","   0","    0","   5","  0","    0","   5"
"1018","del norte","2020-04-16","   0","    0","   2","  0","    0","   2"
"1019","contra costa","2020-04-16","   0","    0","  61"," 27","    0","  34"
"1020","san luis obispo","2020-04-16","   0","    0","  32","  3","    0","  29"
"1021","yuba","2020-04-16","   0","    0","   6","  2","    0","   4"
"1022","kings","2020-04-16","   0","    0","   5","  2","    0","   3"
"1023","tuolumne","2020-04-16","   0","    0","   2","  0","    0","   2"
"1024","monterey","2020-04-16","   0","    0","  23","  4","    0","  19"
"1025","trinity","2020-04-16","   0","    0","   0","  0","    0","   0"
"1026","calaveras","2020-04-16","   0","    0","  10","  1","    0","   9"
"1027","santa cruz","2020-04-16","   0","    0","   7","  4","    0","   3"
"1028","los angeles","2020-04-16","   0","    0"," 608","702","    0"," -94"
"1029","humboldt","2020-04-16","   0","    0","  -1","  6","    0","  -7"
"1030","plumas","2020-04-16","   0","    0","   0","  0","    0","   0"
"1031","fresno","2020-04-16","   0","    0","  48"," 16","    0","  32"
"1032","orange","2020-04-16","   0","    0"," 258"," 80","    0"," 178"
"1033","tulare","2020-04-16","   0","    0","  17","  9","    0","   8"
"1034","siskiyou","2020-04-16","   0","    0","   4","  1","    0","   3"
"1035","alameda","2020-04-16","   0","    0","  66"," 40","    0","  26"
"1036","kern","2020-04-16","   0","    0","  57"," 17","    0","  40"
"1037","glenn","2020-04-16","   0","    0","   0","  0","    0","   0"
"1038","riverside","2020-04-16","   0","    0"," 123","106","    0","  17"
"1039","mendocino","2020-04-16","   0","    0","   8","  0","    0","   8"
"1040","imperial","2020-04-16","   0","    0","   3"," 10","    0","  -7"
"1041","san bernardino","2020-04-16","   0","    0","  83"," 85","    0","  -2"
"1042","modoc","2020-04-16","   0","    0","   0","  0","    0","   0"
"1043","marin","2020-04-16","   0","    0","  15","  3","    0","  12"
"1044","sacramento","2020-04-16","   0","    0","  43"," 38","    0","   5"
"1045","santa clara","2020-04-16","   0","    0","  89"," 77","    0","  12"
"1046","ventura","2020-04-16","   0","    0","  38"," 17","    0","  21"
"1047","tehama","2020-04-16","   0","    0","   5","  0","    0","   5"
"1048","sonoma","2020-04-16","   0","    0","  28","  4","    0","  24"
"1049","mono","2020-04-16","   0","    0","   2","  0","    0","   2"
"1050","santa barbara","2020-04-16","   0","    0","  62"," 16","    0","  46"
"1051","yolo","2020-04-16","   0","    0","  15","  1","    0","  14"
"1052","lake","2020-04-16","   0","    0","   1","  0","    0","   1"
"1053","san francisco","2020-04-16","   0","    0","  64"," 40","    0","  24"
"1054","inyo","2020-04-16","   0","    0","   5","  1","    0","   4"
"1055","san mateo","2020-04-16","   0","    0","  26"," 16","    0","  10"
"1056","nevada","2020-04-16","   0","    0","   2","  4","    0","  -2"
"1057","san joaquin","2020-04-16","   0","    0","  28"," 13","    0","  15"
"1058","shasta","2020-04-16","   0","    0","  14","  1","    0","  13"
"1059","merced","2020-04-16","   0","    0","   7","  0","    0","   7"
"1060","madera","2020-04-16","   0","    0","   6","  0","    0","   6"
"1061","solano","2020-04-16","   0","    0","  28"," 10","    0","  18"
"1062","placer","2020-04-16","   0","    0","  15","  2","    0","  13"
"1063","sutter","2020-04-16","   0","    0","   0","  0","    0","   0"
"1064","san benito","2020-04-16","   0","    0","   2","  0","    0","   2"
"1065","butte","2020-04-16","   0","    0","   8","  3","    0","   5"
"1066","colusa","2020-04-16","   0","    0","   5","  1","    0","   4"
"1067","mariposa","2020-04-16","   0","    0","   0","  0","    0","   0"
"1068","santa clara","2020-04-17","   0","    0","  86"," 82","    0","   4"
"1069","san joaquin","2020-04-17","   0","    0","  26"," 13","    0","  13"
"1070","san francisco","2020-04-17","   0","    0","  66"," 36","    0","  30"
"1071","riverside","2020-04-17","   0","    0"," 119"," 92","    0","  27"
"1072","merced","2020-04-17","   0","    0","   3","  2","    0","   1"
"1073","san luis obispo","2020-04-17","   0","    0","  32","  5","    0","  27"
"1074","santa barbara","2020-04-17","   0","    0","  63"," 16","    0","  47"
"1075","calaveras","2020-04-17","   0","    0","   9","  2","    0","   7"
"1076","nevada","2020-04-17","   0","    0","   0","  4","    0","  -4"
"1077","solano","2020-04-17","   0","    0","  36","  6","    0","  30"
"1078","alameda","2020-04-17","   0","    0","  55"," 53","    0","   2"
"1079","trinity","2020-04-17","   0","    0","   0","  0","    0","   0"
"1080","mariposa","2020-04-17","   0","    0","   0","  0","    0","   0"
"1081","yuba","2020-04-17","   0","    0","   4","  4","    0","   0"
"1082","siskiyou","2020-04-17","   0","    0","   4","  0","    0","   4"
"1083","monterey","2020-04-17","   0","    0","  22","  4","    0","  18"
"1084","los angeles","2020-04-17","   0","    0"," 593","699","    0","-106"
"1085","imperial","2020-04-17","   0","    0","   3"," 12","    0","  -9"
"1086","amador","2020-04-17","   0","    0","   3","  0","    0","   3"
"1087","modoc","2020-04-17","   0","    0","   0","  0","    0","   0"
"1088","glenn","2020-04-17","   0","    0","   0","  0","    0","   0"
"1089","mendocino","2020-04-17","   0","    0","   7","  0","    0","   7"
"1090","tulare","2020-04-17","   0","    0","   6","  8","    0","  -2"
"1091","san mateo","2020-04-17","   0","    0","  22"," 17","    0","   5"
"1092","san diego","2020-04-17","   0","    0"," 157","113","    0","  44"
"1093","plumas","2020-04-17","   0","    0","   0","  0","    0","   0"
"1094","fresno","2020-04-17","   0","    0","  52"," 14","    0","  38"
"1095","humboldt","2020-04-17","   0","    0","   1","  3","    0","  -2"
"1096","napa","2020-04-17","   0","    0","  13","  0","    0","  13"
"1097","placer","2020-04-17","   0","    0","  16","  3","    0","  13"
"1098","mono","2020-04-17","   0","    0","   2","  0","    0","   2"
"1099","lassen","2020-04-17","   0","    0","   0","  0","    0","   0"
"1100","colusa","2020-04-17","   0","    0","   5","  1","    0","   4"
"1101","orange","2020-04-17","   0","    0"," 274"," 73","    0"," 201"
"1102","san benito","2020-04-17","   0","    0","   2","  0","    0","   2"
"1103","sutter","2020-04-17","   0","    0","   0","  0","    0","   0"
"1104","del norte","2020-04-17","   0","    0","   3","  1","    0","   2"
"1105","tuolumne","2020-04-17","   0","    0","   2","  0","    0","   2"
"1106","kings","2020-04-17","   0","    0","   0","  2","    0","  -2"
"1107","lake","2020-04-17","   0","    0","   3","  1","    0","   2"
"1108","tehama","2020-04-17","   0","    0","   5","  0","    0","   5"
"1109","santa cruz","2020-04-17","   0","    0","   6","  3","    0","   3"
"1110","sonoma","2020-04-17","   0","    0","  33","  4","    0","  29"
"1111","madera","2020-04-17","   0","    0","   7","  0","    0","   7"
"1112","contra costa","2020-04-17","   0","    0","  59"," 24","    0","  35"
"1113","inyo","2020-04-17","   0","    0","   5","  1","    0","   4"
"1114","yolo","2020-04-17","   0","    0","  14","  1","    0","  13"
"1115","el dorado","2020-04-17","   0","    0","  12","  1","    0","  11"
"1116","ventura","2020-04-17","   0","    0","  37"," 19","    0","  18"
"1117","san bernardino","2020-04-17","   0","    0","  82"," 91","    0","  -9"
"1118","stanislaus","2020-04-17","   0","    0","  22","  9","    0","  13"
"1119","kern","2020-04-17","   0","    0","  59"," 19","    0","  40"
"1120","shasta","2020-04-17","   0","    0","  13","  1","    0","  12"
"1121","sacramento","2020-04-17","   0","    0","  38"," 42","    0","  -4"
"1122","marin","2020-04-17","   0","    0","  15","  2","    0","  13"
"1123","butte","2020-04-17","   0","    0","   7","  6","    0","   1"
"1124","santa cruz","2020-04-18","   0","    0","  12","  2","    0","  10"
"1125","kings","2020-04-18","   0","    0","   1","  2","    0","  -1"
"1126","san benito","2020-04-18","   0","    0","   2","  0","    0","   2"
"1127","tulare","2020-04-18","   0","    0","  11","  9","    0","   2"
"1128","alameda","2020-04-18","   0","    0","  62"," 52","    0","  10"
"1129","contra costa","2020-04-18","   0","    0","  79"," 21","    0","  58"
"1130","yolo","2020-04-18","   0","    0","  14","  1","    0","  13"
"1131","san joaquin","2020-04-18","   0","    0","  38"," 15","    0","  23"
"1132","tuolumne","2020-04-18","   0","    0","   1","  0","    0","   1"
"1133","solano","2020-04-18","   0","    0","  34","  7","    0","  27"
"1134","el dorado","2020-04-18","   0","    0","  11","  2","    0","   9"
"1135","kern","2020-04-18","   0","    0","  56"," 20","    0","  36"
"1136","san bernardino","2020-04-18","   0","    0"," 107"," 83","    0","  24"
"1137","san mateo","2020-04-18","   0","    0","  37"," 16","    0","  21"
"1138","lassen","2020-04-18","   0","    0","   0","  0","    0","   0"
"1139","shasta","2020-04-18","   0","    0","  13","  1","    0","  12"
"1140","siskiyou","2020-04-18","   0","    0","   4","  1","    0","   3"
"1141","mono","2020-04-18","   0","    0","   2","  0","    0","   2"
"1142","monterey","2020-04-18","   0","    0","  38","  2","    0","  36"
"1143","calaveras","2020-04-18","   0","    0","  11","  0","    0","  11"
"1144","stanislaus","2020-04-18","   0","    0","  31","  6","    0","  25"
"1145","san diego","2020-04-18","   0","    0"," 164","108","    0","  56"
"1146","santa clara","2020-04-18","   0","    0","  84"," 80","    0","   4"
"1147","los angeles","2020-04-18","   0","    0"," 579","696","    0","-117"
"1148","sacramento","2020-04-18","   0","    0","  58"," 39","    0","  19"
"1149","butte","2020-04-18","   0","    0","  11","  2","    0","   9"
"1150","sutter","2020-04-18","   0","    0","   0","  0","    0","   0"
"1151","riverside","2020-04-18","   0","    0"," 133"," 90","    0","  43"
"1152","inyo","2020-04-18","   0","    0","   4","  1","    0","   3"
"1153","napa","2020-04-18","   0","    0","  13","  0","    0","  13"
"1154","mariposa","2020-04-18","   0","    0","   0","  0","    0","   0"
"1155","nevada","2020-04-18","   0","    0","   4","  5","    0","  -1"
"1156","trinity","2020-04-18","   0","    0","   0","  0","    0","   0"
"1157","modoc","2020-04-18","   0","    0","   0","  0","    0","   0"
"1158","glenn","2020-04-18","   0","    0","   0","  0","    0","   0"
"1159","plumas","2020-04-18","   0","    0","   0","  0","    0","   0"
"1160","yuba","2020-04-18","   0","    0","   5","  2","    0","   3"
"1161","san francisco","2020-04-18","   0","    0","  75"," 34","    0","  41"
"1162","mendocino","2020-04-18","   0","    0","   9","  0","    0","   9"
"1163","sonoma","2020-04-18","   0","    0","  32","  2","    0","  30"
"1164","imperial","2020-04-18","   0","    0","   2"," 13","    0"," -11"
"1165","orange","2020-04-18","   0","    0"," 263"," 87","    0"," 176"
"1166","santa barbara","2020-04-18","   0","    0","  60"," 19","    0","  41"
"1167","ventura","2020-04-18","   0","    0","  35"," 14","    0","  21"
"1168","san luis obispo","2020-04-18","   0","    0","  23","  5","    0","  18"
"1169","merced","2020-04-18","   0","    0","   4","  0","    0","   4"
"1170","madera","2020-04-18","   0","    0","   7","  0","    0","   7"
"1171","marin","2020-04-18","   0","    0","  13","  1","    0","  12"
"1172","del norte","2020-04-18","   0","    0","   6","  1","    0","   5"
"1173","humboldt","2020-04-18","   0","    0","   5","  0","    0","   5"
"1174","fresno","2020-04-18","   0","    0","  51"," 15","    0","  36"
"1175","tehama","2020-04-18","   0","    0","   4","  0","    0","   4"
"1176","placer","2020-04-18","   0","    0","   6","  3","    0","   3"
"1177","amador","2020-04-18","   0","    0","   3","  0","    0","   3"
"1178","colusa","2020-04-18","   0","    0","   6","  0","    0","   6"
"1179","lake","2020-04-18","   0","    0","   6","  0","    0","   6"
"1180","contra costa","2020-04-19","   0","    0","  69"," 21","    0","  48"
"1181","santa barbara","2020-04-19","   0","    0","  60"," 17","    0","  43"
"1182","modoc","2020-04-19","   0","    0","   0","  0","    0","   0"
"1183","inyo","2020-04-19","   0","    0","   5","  1","    0","   4"
"1184","fresno","2020-04-19","   0","    0","  59"," 16","    0","  43"
"1185","san bernardino","2020-04-19","   0","    0"," 107"," 79","    0","  28"
"1186","kern","2020-04-19","   0","    0","  49"," 20","    0","  29"
"1187","del norte","2020-04-19","   0","    0","   3","  0","    0","   3"
"1188","mariposa","2020-04-19","   0","    0","   0","  0","    0","   0"
"1189","marin","2020-04-19","   0","    0","  10","  4","    0","   6"
"1190","stanislaus","2020-04-19","   0","    0","  41","  8","    0","  33"
"1191","lassen","2020-04-19","   0","    0","   0","  0","    0","   0"
"1192","placer","2020-04-19","   0","    0","   6","  6","    0","   0"
"1193","napa","2020-04-19","   0","    0","  14","  0","    0","  14"
"1194","yolo","2020-04-19","   0","    0","  21","  0","    0","  21"
"1195","los angeles","2020-04-19","   0","    0"," 577","710","    0","-133"
"1196","colusa","2020-04-19","   0","    0","   6","  0","    0","   6"
"1197","mono","2020-04-19","   0","    0","   2","  0","    0","   2"
"1198","glenn","2020-04-19","   0","    0","   0","  0","    0","   0"
"1199","merced","2020-04-19","   0","    0","   4","  1","    0","   3"
"1200","solano","2020-04-19","   0","    0","  40","  9","    0","  31"
"1201","el dorado","2020-04-19","   0","    0","  11","  3","    0","   8"
"1202","san joaquin","2020-04-19","   0","    0","  32"," 14","    0","  18"
"1203","humboldt","2020-04-19","   0","    0","   7","  0","    0","   7"
"1204","ventura","2020-04-19","   0","    0","  33"," 13","    0","  20"
"1205","san francisco","2020-04-19","   0","    0","  76"," 37","    0","  39"
"1206","santa clara","2020-04-19","   0","    0"," 105"," 72","    0","  33"
"1207","monterey","2020-04-19","   0","    0","  26","  2","    0","  24"
"1208","trinity","2020-04-19","   0","    0","   0","  0","    0","   0"
"1209","shasta","2020-04-19","   0","    0","  11","  1","    0","  10"
"1210","san diego","2020-04-19","   0","    0"," 154","118","    0","  36"
"1211","san benito","2020-04-19","   0","    0","   3","  0","    0","   3"
"1212","alameda","2020-04-19","   0","    0","  61"," 42","    0","  19"
"1213","plumas","2020-04-19","   0","    0","   0","  0","    0","   0"
"1214","orange","2020-04-19","   0","    0"," 248"," 97","    0"," 151"
"1215","madera","2020-04-19","   0","    0","   7","  0","    0","   7"
"1216","siskiyou","2020-04-19","   0","    0","   4","  1","    0","   3"
"1217","imperial","2020-04-19","   0","    0","   1"," 13","    0"," -12"
"1218","tulare","2020-04-19","   0","    0","  13","  9","    0","   4"
"1219","lake","2020-04-19","   0","    0","   5","  0","    0","   5"
"1220","san mateo","2020-04-19","   0","    0","  22"," 18","    0","   4"
"1221","calaveras","2020-04-19","   0","    0","  11","  0","    0","  11"
"1222","tehama","2020-04-19","   0","    0","   5","  0","    0","   5"
"1223","nevada","2020-04-19","   0","    0","   4","  5","    0","  -1"
"1224","sutter","2020-04-19","   0","    0","   0","  0","    0","   0"
"1225","santa cruz","2020-04-19","   0","    0","  13","  1","    0","  12"
"1226","sonoma","2020-04-19","   0","    0","  27","  2","    0","  25"
"1227","tuolumne","2020-04-19","   0","    0","   2","  0","    0","   2"
"1228","mendocino","2020-04-19","   0","    0","   9","  0","    0","   9"
"1229","yuba","2020-04-19","   0","    0","   5","  2","    0","   3"
"1230","kings","2020-04-19","   0","    0","   0","  3","    0","  -3"
"1231","san luis obispo","2020-04-19","   0","    0","  27","  3","    0","  24"
"1232","sacramento","2020-04-19","   0","    0","  59"," 33","    0","  26"
"1233","riverside","2020-04-19","   0","    0"," 145"," 98","    0","  47"
"1234","amador","2020-04-19","   0","    0","   2","  0","    0","   2"
"1235","butte","2020-04-19","   0","    0","  11","  1","    0","  10"
"1236","amador","2020-04-20","   0","    0","   4","  0","    0","   4"
"1237","los angeles","2020-04-20","   0","    0"," 607","718","    0","-111"
"1238","riverside","2020-04-20","   0","    0"," 133","101","    0","  32"
"1239","mono","2020-04-20","   0","    0","   2","  0","    0","   2"
"1240","yuba","2020-04-20","   0","    0","   7","  1","    0","   6"
"1241","tehama","2020-04-20","   0","    0","   6","  0","    0","   6"
"1242","modoc","2020-04-20","   0","    0","   0","  0","    0","   0"
"1243","shasta","2020-04-20","   0","    0","  16","  1","    0","  15"
"1244","monterey","2020-04-20","   0","    0","  23","  3","    0","  20"
"1245","glenn","2020-04-20","   0","    0","   0","  0","    0","   0"
"1246","marin","2020-04-20","   0","    0","  11","  3","    0","   8"
"1247","napa","2020-04-20","   0","    0","   8","  1","    0","   7"
"1248","imperial","2020-04-20","   0","    0","   1"," 13","    0"," -12"
"1249","sacramento","2020-04-20","   0","    0","  62"," 41","    0","  21"
"1250","placer","2020-04-20","   0","    0","  15","  3","    0","  12"
"1251","fresno","2020-04-20","   0","    0","  55"," 16","    0","  39"
"1252","mariposa","2020-04-20","   0","    0","   0","  0","    0","   0"
"1253","merced","2020-04-20","   0","    0","   6","  1","    0","   5"
"1254","san luis obispo","2020-04-20","   0","    0","  28","  2","    0","  26"
"1255","santa barbara","2020-04-20","   0","    0","  61"," 22","    0","  39"
"1256","san benito","2020-04-20","   0","    0","   3","  0","    0","   3"
"1257","san mateo","2020-04-20","   0","    0","  19"," 22","    0","  -3"
"1258","orange","2020-04-20","   0","    0"," 184"," 94","    0","  90"
"1259","plumas","2020-04-20","   0","    0","   0","  0","    0","   0"
"1260","lassen","2020-04-20","   0","    0","   0","  0","    0","   0"
"1261","nevada","2020-04-20","   0","    0","   7","  3","    0","   4"
"1262","san bernardino","2020-04-20","   0","    0"," 150"," 88","    0","  62"
"1263","sutter","2020-04-20","   0","    0","   0","  0","    0","   0"
"1264","kings","2020-04-20","   0","    0","   3","  3","    0","   0"
"1265","inyo","2020-04-20","   0","    0","   4","  1","    0","   3"
"1266","kern","2020-04-20","   0","    0","  51"," 14","    0","  37"
"1267","humboldt","2020-04-20","   0","    0","   4","  0","    0","   4"
"1268","sonoma","2020-04-20","   0","    0","  29","  6","    0","  23"
"1269","trinity","2020-04-20","   0","    0","   0","  0","    0","   0"
"1270","el dorado","2020-04-20","   0","    0","  13","  0","    0","  13"
"1271","san joaquin","2020-04-20","   0","    0","  18"," 20","    0","  -2"
"1272","calaveras","2020-04-20","   0","    0","  11","  0","    0","  11"
"1273","stanislaus","2020-04-20","   0","    0","  34"," 11","    0","  23"
"1274","tuolumne","2020-04-20","   0","    0","   2","  0","    0","   2"
"1275","madera","2020-04-20","   0","    0","   7","  0","    0","   7"
"1276","ventura","2020-04-20","   0","    0","  27"," 10","    0","  17"
"1277","del norte","2020-04-20","   0","    0","   1","  1","    0","   0"
"1278","siskiyou","2020-04-20","   0","    0","   5","  1","    0","   4"
"1279","yolo","2020-04-20","   0","    0","  14","  0","    0","  14"
"1280","solano","2020-04-20","   0","    0","  36","  9","    0","  27"
"1281","colusa","2020-04-20","   0","    0","   5","  0","    0","   5"
"1282","contra costa","2020-04-20","   0","    0","  75"," 21","    0","  54"
"1283","alameda","2020-04-20","   0","    0","  59"," 42","    0","  17"
"1284","butte","2020-04-20","   0","    0","   9","  1","    0","   8"
"1285","san francisco","2020-04-20","   0","    0","  73"," 34","    0","  39"
"1286","santa clara","2020-04-20","   0","    0"," 115"," 76","    0","  39"
"1287","tulare","2020-04-20","   0","    0","  15","  9","    0","   6"
"1288","lake","2020-04-20","   0","    0","   0","  1","    0","  -1"
"1289","mendocino","2020-04-20","   0","    0","   7","  0","    0","   7"
"1290","san diego","2020-04-20","   0","    0"," 149","108","    0","  41"
"1291","santa cruz","2020-04-20","   0","    0","  11","  1","    0","  10"
"1292","san benito","2020-04-21","   1","   25","   2","  0","   24","   2"
"1293","","2020-04-21","   0","    0","   0","  0","    0","   0"
"1294","glenn","2020-04-21","   0","    0","   0","  0","    0","   0"
"1295","stanislaus","2020-04-21","  31"," 1400","  72"," 11"," 1369","  61"
"1296","siskiyou","2020-04-21","   1","   36","   5","  1","   35","   4"
"1297","imperial","2020-04-21","  35","  161","   1"," 12","  126"," -11"
"1298","plumas","2020-04-21","   0","    9","   0","  0","    9","   0"
"1299","colusa","2020-04-21","   1","   80","   4","  1","   79","   3"
"1300","los angeles","2020-04-21","2471","13663"," 941","724","11192"," 217"
"1301","mendocino","2020-04-21","   1","  151","   9","  0","  150","   9"
"1302","san diego","2020-04-21"," 305"," 3776"," 161","119"," 3471","  42"
"1303","el dorado","2020-04-21","   3","  155","  12","  0","  152","  12"
"1304","san joaquin","2020-04-21","  51","  544","  30"," 21","  493","   9"
"1305","san francisco","2020-04-21"," 121","  738","  79"," 34","  617","  45"
"1306","kings","2020-04-21","   8","  223","   6","  3","  215","   3"
"1307","kern","2020-04-21","  43"," 1171","  57"," 14"," 1128","  43"
"1308","sutter","2020-04-21","   0","    0","   0","  0","    0","   0"
"1309","napa","2020-04-21","   2","  387","   9","  1","  385","   8"
"1310","trinity","2020-04-21","   0","   54","   0","  0","   54","   0"
"1311","del norte","2020-04-21","   1","    0","   3","  0","   -1","   3"
"1312","inyo","2020-04-21","   1","   50","   3","  1","   49","   2"
"1313","shasta","2020-04-21","   1","  279","  16","  1","  278","  15"
"1314","calaveras","2020-04-21","   0","   50","  12","  0","   50","  12"
"1315","marin","2020-04-21","   9","  242","  11","  3","  233","   8"
"1316","santa barbara","2020-04-21","  34","  415","  82"," 18","  381","  64"
"1317","placer","2020-04-21","  22","    0","  11","  4","  -22","   7"
"1318","mariposa","2020-04-21","   1","    0","   0","  0","   -1","   0"
"1319","mono","2020-04-21","   0","   17","   2","  0","   17","   2"
"1320","nevada","2020-04-21","   5","   58","   7","  3","   53","   4"
"1321","san mateo","2020-04-21","  67","  395","  33"," 21","  328","  12"
"1322","fresno","2020-04-21","  70","  764","  46"," 18","  694","  28"
"1323","sacramento","2020-04-21","  93","   50","  72"," 29","  -43","  43"
"1324","solano","2020-04-21","  23","  204","  38","  2","  181","  36"
"1325","lake","2020-04-21","   2","   58","   6","  0","   56","   6"
"1326","alameda","2020-04-21"," 144","  591","  66"," 50","  447","  16"
"1327","san bernardino","2020-04-21"," 357"," 2714"," 142"," 87"," 2357","  55"
"1328","modoc","2020-04-21","   1","   20","   0","  0","   19","   0"
"1329","san luis obispo","2020-04-21","   6","  303","  25","  4","  297","  21"
"1330","tehama","2020-04-21","   0","    0","   3","  0","    0","   3"
"1331","amador","2020-04-21","   0","    0","   2","  0","    0","   2"
"1332","yolo","2020-04-21","   7","    0","  15","  1","   -7","  14"
"1333","lassen","2020-04-21","   1","    0","   0","  0","   -1","   0"
"1334","santa clara","2020-04-21"," 178"," 2582"," 120"," 86"," 2404","  34"
"1335","merced","2020-04-21","   3","    0","   4","  2","   -3","   2"
"1336","santa cruz","2020-04-21","   5","  351","  16","  1","  346","  15"
"1337","contra costa","2020-04-21","  77"," 1037","  71"," 24","  960","  47"
"1338","ventura","2020-04-21","  56","  976","  25"," 19","  920","   6"
"1339","tuolumne","2020-04-21","   0","   90","   3","  0","   90","   3"
"1340","tulare","2020-04-21","  27","  276","  15","  9","  249","   6"
"1341","yuba","2020-04-21","   0","  445","  16","  0","  445","  16"
"1342","orange","2020-04-21"," 308"," 4213"," 277","104"," 3905"," 173"
"1343","madera","2020-04-21","   5","    0","  15","  0","   -5","  15"
"1344","monterey","2020-04-21","  11","  875","  68","  3","  864","  65"
"1345","riverside","2020-04-21"," 370"," 2726"," 112","113"," 2356","  -1"
"1346","butte","2020-04-21","   1","  424","  19","  1","  423","  18"
"1347","sonoma","2020-04-21","  19","  575","  28","  6","  556","  22"
"1348","humboldt","2020-04-21","   5","  308","   6","  0","  303","   6"
"1349","yuba","2020-04-22","   0","  445","  13","  0","  445","  13"
"1350","sutter","2020-04-22","   0","    0","   0","  0","    0","   0"
"1351","trinity","2020-04-22","   0","   54","   0","  0","   54","   0"
"1352","solano","2020-04-22","  28","  204","  32","  4","  176","  28"
"1353","san joaquin","2020-04-22","  57","  632","  25"," 18","  575","   7"
"1354","san benito","2020-04-22","   0","   25","   1","  0","   25","   1"
"1355","santa barbara","2020-04-22","  34","  427","  88"," 16","  393","  72"
"1356","sonoma","2020-04-22","  19","  596","  27","  7","  577","  20"
"1357","mendocino","2020-04-22","   0","  151","   7","  0","  151","   7"
"1358","lassen","2020-04-22","   1","   25","   0","  0","   24","   0"
"1359","mono","2020-04-22","   0","   17","   2","  0","   17","   2"
"1360","mariposa","2020-04-22","   0","   30","   0","  0","   30","   0"
"1361","calaveras","2020-04-22","   0","   50","  12","  0","   50","  12"
"1362","siskiyou","2020-04-22","   1","   65","   4","  1","   64","   3"
"1363","san francisco","2020-04-22","  92","  738","  74"," 31","  646","  43"
"1364","fresno","2020-04-22","  79","  748","  52"," 18","  669","  34"
"1365","stanislaus","2020-04-22","  33"," 1421","  58"," 11"," 1388","  47"
"1366","kern","2020-04-22","  57"," 1167","  58"," 15"," 1110","  43"
"1367","contra costa","2020-04-22","  84"," 1031","  75"," 27","  947","  48"
"1368","sacramento","2020-04-22","  70","   50","  79"," 23","  -20","  56"
"1369","san bernardino","2020-04-22"," 345"," 3830"," 167"," 86"," 3485","  81"
"1370","plumas","2020-04-22","   0","    9","   0","  0","    9","   0"
"1371","humboldt","2020-04-22","   8","  310","   8","  1","  302","   7"
"1372","glenn","2020-04-22","   0","    0","   0","  0","    0","   0"
"1373","alameda","2020-04-22"," 145"," 1141","  46"," 55","  996","  -9"
"1374","los angeles","2020-04-22","2448","17405","1215","727","14957"," 488"
"1375","inyo","2020-04-22","   1","   50","   4","  1","   49","   3"
"1376","imperial","2020-04-22","  34","  161","   1"," 12","  127"," -11"
"1377","placer","2020-04-22","  25","    0","  10","  2","  -25","   8"
"1378","marin","2020-04-22","  15","  242","  12","  7","  227","   5"
"1379","madera","2020-04-22","   3","  568","  22","  0","  565","  22"
"1380","tuolumne","2020-04-22","   1","  151","   2","  0","  150","   2"
"1381","amador","2020-04-22","   1","    0","   3","  0","   -1","   3"
"1382","kings","2020-04-22","   9","  192","   3","  3","  183","   0"
"1383","ventura","2020-04-22","  57"," 1049","  33"," 17","  992","  16"
"1384","yolo","2020-04-22","   4","    0","  14","  1","   -4","  13"
"1385","riverside","2020-04-22"," 333"," 3668"," 176","109"," 3335","  67"
"1386","nevada","2020-04-22","   1","   57","   8","  1","   56","   7"
"1387","shasta","2020-04-22","   1","  279","  14","  1","  278","  13"
"1388","merced","2020-04-22","   6","    0","   4","  0","   -6","   4"
"1389","lake","2020-04-22","   3","   58","   4","  1","   55","   3"
"1390","tehama","2020-04-22","   0","    0","   4","  0","    0","   4"
"1391","napa","2020-04-22","   3","  387","  11","  1","  384","  10"
"1392","santa clara","2020-04-22"," 176"," 2741"," 157"," 77"," 2565","  80"
"1393","san luis obispo","2020-04-22","   8","  303","  25","  4","  295","  21"
"1394","monterey","2020-04-22","   9","  875","  95","  3","  866","  92"
"1395","modoc","2020-04-22","   0","   12","   0","  0","   12","   0"
"1396","san diego","2020-04-22"," 318"," 5467"," 365","125"," 5149"," 240"
"1397","orange","2020-04-22"," 283"," 4786"," 293"," 94"," 4503"," 199"
"1398","san mateo","2020-04-22","  67","  395","  32"," 17","  328","  15"
"1399","tulare","2020-04-22","  27","  226","  25","  9","  199","  16"
"1400","del norte","2020-04-22","   2","    0","   3","  1","   -2","   2"
"1401","el dorado","2020-04-22","   5","  165","  13","  1","  160","  12"
"1402","santa cruz","2020-04-22","   7","  351","  10","  2","  344","   8"
"1403","colusa","2020-04-22","   1","   80","   4","  1","   79","   3"
"1404","butte","2020-04-22","   0","  424","  17","  1","  424","  16"
"1405","los angeles","2020-04-23","2458","21107","1263","718","18649"," 545"
"1406","colusa","2020-04-23","   1","   80","   4","  1","   79","   3"
"1407","madera","2020-04-23","   3","  568","  16","  1","  565","  15"
"1408","san mateo","2020-04-23","  72","  517","  35"," 17","  445","  18"
"1409","santa cruz","2020-04-23","   6","  351","   9","  1","  345","   8"
"1410","glenn","2020-04-23","   0","    0","   0","  0","    0","   0"
"1411","riverside","2020-04-23"," 340"," 3526"," 232","107"," 3186"," 125"
"1412","el dorado","2020-04-23","   8","  173","  15","  1","  165","  14"
"1413","fresno","2020-04-23","  78","  748","  52"," 20","  670","  32"
"1414","imperial","2020-04-23","  27","  240","   1","  9","  213","  -8"
"1415","humboldt","2020-04-23","   7","  310","   4","  1","  303","   3"
"1416","santa barbara","2020-04-23","  40","  717","  90"," 17","  677","  73"
"1417","san benito","2020-04-23","   0","   25","   1","  0","   25","   1"
"1418","calaveras","2020-04-23","   1","   50","  11","  1","   49","  10"
"1419","monterey","2020-04-23","  12","  875"," 122","  5","  863"," 117"
"1420","mendocino","2020-04-23","   1","  151","   7","  1","  150","   6"
"1421","lake","2020-04-23","   1","   58","   4","  0","   57","   4"
"1422","modoc","2020-04-23","   0","   12","   0","  0","   12","   0"
"1423","ventura","2020-04-23","  49"," 1305","  47"," 15"," 1256","  32"
"1424","inyo","2020-04-23","   1","   50","   5","  1","   49","   4"
"1425","yuba","2020-04-23","   2","  445","   9","  2","  443","   7"
"1426","mariposa","2020-04-23","   1","   30","   0","  0","   29","   0"
"1427","trinity","2020-04-23","   0","   54","   0","  0","   54","   0"
"1428","del norte","2020-04-23","   6","    0","   3","  3","   -6","   0"
"1429","nevada","2020-04-23","   4","  116","   6","  1","  112","   5"
"1430","alameda","2020-04-23"," 171"," 1129","  95"," 61","  958","  34"
"1431","lassen","2020-04-23","   0","   25","   0","  0","   25","   0"
"1432","tuolumne","2020-04-23","   0","  151","   2","  0","  151","   2"
"1433","san luis obispo","2020-04-23","   5","  526","  30","  2","  521","  28"
"1434","kings","2020-04-23","   9","  192","   4","  3","  183","   1"
"1435","san francisco","2020-04-23"," 104"," 1173","  70"," 37"," 1069","  33"
"1436","santa clara","2020-04-23"," 165"," 2741"," 137"," 72"," 2576","  65"
"1437","napa","2020-04-23","   2","  387","   2","  1","  385","   1"
"1438","tehama","2020-04-23","   0","  106","   4","  0","  106","   4"
"1439","orange","2020-04-23"," 313"," 5251"," 293","100"," 4938"," 193"
"1440","contra costa","2020-04-23","  82"," 1031","  81"," 26","  949","  55"
"1441","kern","2020-04-23","  41"," 1429","  63"," 17"," 1388","  46"
"1442","placer","2020-04-23","  25","    0","  11","  2","  -25","   9"
"1443","tulare","2020-04-23","  31","  882","  16"," 11","  851","   5"
"1444","amador","2020-04-23","   1","    0","   2","  0","   -1","   2"
"1445","sutter","2020-04-23","   0","    0","   0","  0","    0","   0"
"1446","solano","2020-04-23","  26","  204","  31","  9","  178","  22"
"1447","plumas","2020-04-23","   0","    9","   0","  0","    9","   0"
"1448","butte","2020-04-23","   0","  424","  14","  1","  424","  13"
"1449","sonoma","2020-04-23","  20","  615","  48","  5","  595","  43"
"1450","mono","2020-04-23","   0","   17","   2","  0","   17","   2"
"1451","san diego","2020-04-23"," 318"," 5501"," 389","117"," 5183"," 272"
"1452","shasta","2020-04-23","   1","  645","  16","  1","  644","  15"
"1453","yolo","2020-04-23","   4","  130","  14","  1","  126","  13"
"1454","merced","2020-04-23","   2","  206","   7","  0","  204","   7"
"1455","marin","2020-04-23","  17","  242","  12","  6","  225","   6"
"1456","sacramento","2020-04-23","  88","  737","  80"," 24","  649","  56"
"1457","siskiyou","2020-04-23","   1","   65","   4","  1","   64","   3"
"1458","san joaquin","2020-04-23","  65"," 1047","  25"," 21","  982","   4"
"1459","stanislaus","2020-04-23","  31"," 1421","  62","  8"," 1390","  54"
"1460","san bernardino","2020-04-23"," 240"," 4516"," 175"," 73"," 4276"," 102"
"1461","sacramento","2020-04-24","  90","  737"," 121"," 28","  647","  93"
"1462","kern","2020-04-24","  47"," 1715","  59"," 17"," 1668","  42"
"1463","marin","2020-04-24","  13","  242","  12","  4","  229","   8"
"1464","butte","2020-04-24","   4","  424","  18","  3","  420","  15"
"1465","modoc","2020-04-24","   0","   12","   0","  0","   12","   0"
"1466","del norte","2020-04-24","   4","    0","   6","  0","   -4","   6"
"1467","tulare","2020-04-24","  33","  882","  19"," 11","  849","   8"
"1468","sonoma","2020-04-24","  23","  616","  45","  3","  593","  42"
"1469","placer","2020-04-24","  22","    0","  43","  2","  -22","  41"
"1470","santa cruz","2020-04-24","   5","  351","  12","  2","  346","  10"
"1471","mendocino","2020-04-24","   1","  151","   9","  0","  150","   9"
"1472","plumas","2020-04-24","   0","    9","   0","  0","    9","   0"
"1473","mariposa","2020-04-24","   0","   30","   0","  0","   30","   0"
"1474","colusa","2020-04-24","   1","   80","   5","  1","   79","   4"
"1475","fresno","2020-04-24","  78","  748","  47"," 20","  670","  27"
"1476","stanislaus","2020-04-24","  27"," 1421","  58","  8"," 1394","  50"
"1477","humboldt","2020-04-24","   5","  307","   8","  1","  302","   7"
"1478","merced","2020-04-24","   5","  206","   6","  1","  201","   5"
"1479","yolo","2020-04-24","   4","  130","  17","  1","  126","  16"
"1480","amador","2020-04-24","   1","    0","   6","  0","   -1","   6"
"1481","shasta","2020-04-24","   1","  645","  16","  1","  644","  15"
"1482","napa","2020-04-24","   1","  387","   7","  1","  386","   6"
"1483","imperial","2020-04-24","  34","  248","   6","  9","  214","  -3"
"1484","trinity","2020-04-24","   0","   54","   0","  0","   54","   0"
"1485","san luis obispo","2020-04-24","   9","  526","  24","  6","  517","  18"
"1486","san benito","2020-04-24","   0","   25","   2","  0","   25","   2"
"1487","sutter","2020-04-24","   0","    0","   0","  0","    0","   0"
"1488","santa clara","2020-04-24"," 163"," 2741"," 134"," 65"," 2578","  69"
"1489","los angeles","2020-04-24","2406","20782","1378","687","18376"," 691"
"1490","san francisco","2020-04-24","  94"," 1173"," 108"," 35"," 1079","  73"
"1491","mono","2020-04-24","   0","   17","   2","  0","   17","   2"
"1492","alameda","2020-04-24"," 142"," 1127"," 110"," 49","  985","  61"
"1493","solano","2020-04-24","  26","  204","  32","  7","  178","  25"
"1494","san mateo","2020-04-24","  65","  517","  40"," 20","  452","  20"
"1495","riverside","2020-04-24"," 343"," 3524"," 222","108"," 3181"," 114"
"1496","ventura","2020-04-24","  87"," 1283","  40","  9"," 1196","  31"
"1497","madera","2020-04-24","   4","  568","  11","  0","  564","  11"
"1498","yuba","2020-04-24","   2","  445","  10","  2","  443","   8"
"1499","tehama","2020-04-24","   1","  106","   4","  1","  105","   3"
"1500","lassen","2020-04-24","   0","   25","   0","  0","   25","   0"
"1501","lake","2020-04-24","   1","   58","   4","  1","   57","   3"
"1502","san diego","2020-04-24"," 335"," 5606"," 408","120"," 5271"," 288"
"1503","san bernardino","2020-04-24"," 253"," 4516"," 250"," 73"," 4263"," 177"
"1504","santa barbara","2020-04-24","  32","  717","  80"," 17","  685","  63"
"1505","contra costa","2020-04-24","  83"," 1031","  87"," 23","  948","  64"
"1506","san joaquin","2020-04-24","  49"," 1047","  26"," 16","  998","  10"
"1507","siskiyou","2020-04-24","   0","   65","   5","  0","   65","   5"
"1508","glenn","2020-04-24","   0","    0","   0","  0","    0","   0"
"1509","tuolumne","2020-04-24","   0","  151","   4","  0","  151","   4"
"1510","nevada","2020-04-24","   5","  116","   6","  2","  111","   4"
"1511","el dorado","2020-04-24","   7","  173","  12","  3","  166","   9"
"1512","kings","2020-04-24","   9","  192","   4","  2","  183","   2"
"1513","inyo","2020-04-24","   4","   89","   5","  1","   85","   4"
"1514","monterey","2020-04-24","  13","  875"," 112","  5","  862"," 107"
"1515","orange","2020-04-24"," 313"," 5374"," 391"," 92"," 5061"," 299"
"1516","calaveras","2020-04-24","   2","   50","  11","  1","   48","  10"
"1517","madera","2020-04-25","   2","  568","  20","  1","  566","  19"
"1518","orange","2020-04-25"," 310"," 5370"," 394"," 95"," 5060"," 299"
"1519","marin","2020-04-25","  15","  358","  16","  5","  343","  11"
"1520","san mateo","2020-04-25","  74","  790","  43"," 26","  716","  17"
"1521","modoc","2020-04-25","   0","   12","   0","  0","   12","   0"
"1522","colusa","2020-04-25","   2","   80","   4","  2","   78","   2"
"1523","sutter","2020-04-25","   0","    0","   0","  0","    0","   0"
"1524","merced","2020-04-25","   3","  206","   9","  1","  203","   8"
"1525","san luis obispo","2020-04-25","   5","  526","  28","  2","  521","  26"
"1526","el dorado","2020-04-25","   8","  155","  11","  2","  147","   9"
"1527","calaveras","2020-04-25","   1","   50","  11","  0","   49","  11"
"1528","san joaquin","2020-04-25","  47"," 1146","  20"," 17"," 1099","   3"
"1529","santa clara","2020-04-25"," 172"," 3331"," 203"," 77"," 3159"," 126"
"1530","napa","2020-04-25","   2","  387","   1","  2","  385","  -1"
"1531","san francisco","2020-04-25","  91"," 1412"," 132"," 32"," 1321"," 100"
"1532","tuolumne","2020-04-25","   0","  151","   4","  0","  151","   4"
"1533","kern","2020-04-25","  47"," 1715","  56"," 25"," 1668","  31"
"1534","fresno","2020-04-25","  86"," 2014","  86"," 21"," 1928","  65"
"1535","glenn","2020-04-25","   0","    0","   0","  0","    0","   0"
"1536","san benito","2020-04-25","   0","   25","   0","  0","   25","   0"
"1537","imperial","2020-04-25","  32","  249","   5","  9","  217","  -4"
"1538","lassen","2020-04-25","   0","   25","   0","  0","   25","   0"
"1539","tehama","2020-04-25","   1","  106","   4","  1","  105","   3"
"1540","yuba","2020-04-25","   2","  445","   6","  2","  443","   4"
"1541","inyo","2020-04-25","   3","   89","   6","  0","   86","   6"
"1542","kings","2020-04-25","   6","  199","   5","  2","  193","   3"
"1543","shasta","2020-04-25","   1","  645","  11","  1","  644","  10"
"1544","santa cruz","2020-04-25","   8","  354","   4","  5","  346","  -1"
"1545","humboldt","2020-04-25","   3","  308","   4","  0","  305","   4"
"1546","plumas","2020-04-25","   0","    9","   0","  0","    9","   0"
"1547","butte","2020-04-25","   3","  424","  14","  0","  421","  14"
"1548","nevada","2020-04-25","   4","  110","   2","  2","  106","   0"
"1549","monterey","2020-04-25","  14","  875"," 111","  3","  861"," 108"
"1550","santa barbara","2020-04-25","  35","  717","  79"," 20","  682","  59"
"1551","stanislaus","2020-04-25","  44"," 1573","  90","  6"," 1529","  84"
"1552","lake","2020-04-25","   2","   58","   3","  0","   56","   3"
"1553","riverside","2020-04-25"," 356"," 3550"," 235","111"," 3194"," 124"
"1554","san diego","2020-04-25"," 364"," 5561"," 395","129"," 5197"," 266"
"1555","placer","2020-04-25","  34","  340"," 106","  3","  306"," 103"
"1556","sonoma","2020-04-25","  12","  789","  64","  0","  777","  64"
"1557","contra costa","2020-04-25","  78"," 1464"," 154"," 16"," 1386"," 138"
"1558","mariposa","2020-04-25","   0","   30","   0","  0","   30","   0"
"1559","trinity","2020-04-25","   0","   54","   0","  0","   54","   0"
"1560","alameda","2020-04-25"," 136"," 1748"," 197"," 45"," 1612"," 152"
"1561","los angeles","2020-04-25","2417","20233","1359","678","17816"," 681"
"1562","ventura","2020-04-25","  98"," 1286","  51"," 15"," 1188","  36"
"1563","mendocino","2020-04-25","   0","  151","  10","  0","  151","  10"
"1564","siskiyou","2020-04-25","   1","   65","   5","  0","   64","   5"
"1565","sacramento","2020-04-25","  99"," 1261"," 184"," 34"," 1162"," 150"
"1566","mono","2020-04-25","   0","   17","   2","  0","   17","   2"
"1567","tulare","2020-04-25","  26","  882","  22","  7","  856","  15"
"1568","yolo","2020-04-25","   5","  130","  18","  1","  125","  17"
"1569","amador","2020-04-25","   1","    0","   5","  1","   -1","   4"
"1570","del norte","2020-04-25","   4","    0","   0","  0","   -4","   0"
"1571","solano","2020-04-25","  26","  592","  61","  7","  566","  54"
"1572","san bernardino","2020-04-25"," 248"," 4496"," 277"," 67"," 4248"," 210"
"1573","mono","2020-04-26","   0","   17","   2","  0","   17","   2"
"1574","alameda","2020-04-26"," 127"," 1748"," 191"," 47"," 1621"," 144"
"1575","placer","2020-04-26","  25","  340"," 101","  6","  315","  95"
"1576","napa","2020-04-26","   1","  387","   8","  1","  386","   7"
"1577","sutter","2020-04-26","   0","    0","   0","  0","    0","   0"
"1578","yuba","2020-04-26","   2","  445","  10","  1","  443","   9"
"1579","santa clara","2020-04-26"," 182"," 3331"," 194"," 77"," 3149"," 117"
"1580","marin","2020-04-26","  10","  358","  19","  5","  348","  14"
"1581","solano","2020-04-26","  22","  592","  62","  4","  570","  58"
"1582","san joaquin","2020-04-26","  43"," 1146","  23"," 13"," 1103","  10"
"1583","colusa","2020-04-26","   2","   80","   4","  2","   78","   2"
"1584","siskiyou","2020-04-26","   0","   65","   5","  0","   65","   5"
"1585","tehama","2020-04-26","   0","  106","   3","  0","  106","   3"
"1586","san diego","2020-04-26"," 363"," 5552"," 427","135"," 5189"," 292"
"1587","lake","2020-04-26","   1","   58","   5","  0","   57","   5"
"1588","amador","2020-04-26","   0","    0","   6","  0","    0","   6"
"1589","nevada","2020-04-26","   3","  110","   5","  2","  107","   3"
"1590","lassen","2020-04-26","   0","   25","   0","  0","   25","   0"
"1591","modoc","2020-04-26","   0","   12","   0","  0","   12","   0"
"1592","san luis obispo","2020-04-26","   4","  526","  21","  3","  522","  18"
"1593","san benito","2020-04-26","   0","   25","   0","  0","   25","   0"
"1594","madera","2020-04-26","   1","  568","  20","  0","  567","  20"
"1595","kern","2020-04-26","  44"," 1706","  50"," 23"," 1662","  27"
"1596","kings","2020-04-26","   9","  199","   6","  2","  190","   4"
"1597","tuolumne","2020-04-26","   0","  151","   4","  0","  151","   4"
"1598","santa barbara","2020-04-26","  37","  717","  85"," 16","  680","  69"
"1599","glenn","2020-04-26","   0","    0","   0","  0","    0","   0"
"1600","stanislaus","2020-04-26","  47"," 1571","  97"," 11"," 1524","  86"
"1601","humboldt","2020-04-26","   0","  305","   4","  0","  305","   4"
"1602","riverside","2020-04-26"," 367"," 3625"," 230","110"," 3258"," 120"
"1603","san francisco","2020-04-26"," 100"," 1412"," 126"," 34"," 1312","  92"
"1604","tulare","2020-04-26","  26","  882","  21","  8","  856","  13"
"1605","ventura","2020-04-26"," 100"," 1282","  55","  9"," 1182","  46"
"1606","sacramento","2020-04-26","  88"," 1255"," 171"," 22"," 1167"," 149"
"1607","mariposa","2020-04-26","   0","   30","   0","  0","   30","   0"
"1608","contra costa","2020-04-26","  69"," 1464"," 150"," 18"," 1395"," 132"
"1609","calaveras","2020-04-26","   0","   50","  11","  0","   50","  11"
"1610","butte","2020-04-26","   0","  424","  18","  0","  424","  18"
"1611","santa cruz","2020-04-26","   5","  354","   5","  2","  349","   3"
"1612","shasta","2020-04-26","   1","  645","  10","  1","  644","   9"
"1613","san mateo","2020-04-26","  63","  790","  43"," 20","  727","  23"
"1614","orange","2020-04-26"," 289"," 5370"," 378"," 96"," 5081"," 282"
"1615","mendocino","2020-04-26","   0","  151","  12","  0","  151","  12"
"1616","trinity","2020-04-26","   0","   54","   0","  0","   54","   0"
"1617","monterey","2020-04-26","  10","  875"," 113","  5","  865"," 108"
"1618","yolo","2020-04-26","   2","  130","  23","  2","  128","  21"
"1619","imperial","2020-04-26","  38","  252","   5"," 10","  214","  -5"
"1620","el dorado","2020-04-26","   9","  155","   7","  3","  146","   4"
"1621","merced","2020-04-26","   4","  206","   6","  2","  202","   4"
"1622","del norte","2020-04-26","   2","    0","   5","  1","   -2","   4"
"1623","plumas","2020-04-26","   0","    9","   0","  0","    9","   0"
"1624","fresno","2020-04-26","  81"," 2014","  79"," 27"," 1933","  52"
"1625","inyo","2020-04-26","   0","   89","   6","  0","   89","   6"
"1626","san bernardino","2020-04-26"," 229"," 4496"," 201"," 70"," 4267"," 131"
"1627","los angeles","2020-04-26","2462","20162","1262","710","17700"," 552"
"1628","sonoma","2020-04-26","  10","  789","  63","  1","  779","  62"
"1629","modoc","2020-04-27","   0","   12","   0","  0","   12","   0"
"1630","plumas","2020-04-27","   0","    9","   0","  0","    9","   0"
"1631","tulare","2020-04-27"," 329","  898","  27","  7","  569","  20"
"1632","mono","2020-04-27","   0","   17","   2","  0","   17","   2"
"1633","san bernardino","2020-04-27"," 237"," 4556"," 183"," 67"," 4319"," 116"
"1634","placer","2020-04-27","  22","  340"," 111","  4","  318"," 107"
"1635","butte","2020-04-27","   0","  424","  22","  0","  424","  22"
"1636","mariposa","2020-04-27","   1","   30","   0","  0","   29","   0"
"1637","sutter","2020-04-27","   0","    0","   0","  0","    0","   0"
"1638","tuolumne","2020-04-27","   1","  151","   2","  1","  150","   1"
"1639","santa barbara","2020-04-27","  39","  717","  82"," 15","  678","  67"
"1640","san benito","2020-04-27","   0","   25","   0","  0","   25","   0"
"1641","sacramento","2020-04-27","  88"," 1238"," 164"," 29"," 1150"," 135"
"1642","fresno","2020-04-27","  91"," 2013","  89"," 20"," 1922","  69"
"1643","trinity","2020-04-27","   0","   54","   0","  0","   54","   0"
"1644","nevada","2020-04-27","   2","  103","   2","  1","  101","   1"
"1645","riverside","2020-04-27"," 338"," 3649"," 208"," 98"," 3311"," 110"
"1646","colusa","2020-04-27","   2","   80","   4","  2","   78","   2"
"1647","san luis obispo","2020-04-27","   9","  526","  37","  4","  517","  33"
"1648","san diego","2020-04-27"," 336"," 5544"," 377","130"," 5208"," 247"
"1649","calaveras","2020-04-27","   1","   50","  12","  0","   49","  12"
"1650","contra costa","2020-04-27","  68"," 1485"," 158"," 21"," 1417"," 137"
"1651","marin","2020-04-27","   8","  358","  26","  1","  350","  25"
"1652","napa","2020-04-27","   1","  387","   8","  1","  386","   7"
"1653","lake","2020-04-27","   1","   58","   5","  1","   57","   4"
"1654","orange","2020-04-27"," 302"," 5370"," 370"," 99"," 5068"," 271"
"1655","ventura","2020-04-27"," 103"," 1282","  36"," 16"," 1179","  20"
"1656","stanislaus","2020-04-27","  66"," 1573","  90"," 16"," 1507","  74"
"1657","yolo","2020-04-27","   1","  130","  15","  0","  129","  15"
"1658","siskiyou","2020-04-27","   1","   65","   3","  1","   64","   2"
"1659","lassen","2020-04-27","   0","   25","   0","  0","   25","   0"
"1660","santa clara","2020-04-27"," 164"," 3331"," 206"," 66"," 3167"," 140"
"1661","del norte","2020-04-27","   5","    0","   5","  2","   -5","   3"
"1662","el dorado","2020-04-27","   8","  155","   7","  2","  147","   5"
"1663","monterey","2020-04-27","   6","  875"," 120","  3","  869"," 117"
"1664","imperial","2020-04-27","  34","  247","   4"," 12","  213","  -8"
"1665","tehama","2020-04-27","   0","  106","   3","  0","  106","   3"
"1666","inyo","2020-04-27","   0","   50","   6","  0","   50","   6"
"1667","kings","2020-04-27","  11","  199","   5","  2","  188","   3"
"1668","san mateo","2020-04-27","  80","  790","  62"," 20","  710","  42"
"1669","san francisco","2020-04-27"," 101"," 1412"," 149"," 32"," 1311"," 117"
"1670","humboldt","2020-04-27","   3","  305","   4","  0","  302","   4"
"1671","shasta","2020-04-27","   2","  645","  12","  1","  643","  11"
"1672","los angeles","2020-04-27","2549","20205","1226","709","17656"," 517"
"1673","san joaquin","2020-04-27","  47"," 1146","  25"," 16"," 1099","   9"
"1674","kern","2020-04-27","  50"," 1702","  53"," 25"," 1652","  28"
"1675","sonoma","2020-04-27","  13","  789","  63","  2","  776","  61"
"1676","santa cruz","2020-04-27","   3","  354","   3","  1","  351","   2"
"1677","yuba","2020-04-27","   3","  445","  13","  3","  442","  10"
"1678","glenn","2020-04-27","   0","    0","   0","  0","    0","   0"
"1679","merced","2020-04-27","   4","  206","   7","  0","  202","   7"
"1680","alameda","2020-04-27"," 128"," 1748"," 183"," 47"," 1620"," 136"
"1681","solano","2020-04-27","  24","  592","  60","  7","  568","  53"
"1682","mendocino","2020-04-27","   1","  151","   7","  1","  150","   6"
"1683","amador","2020-04-27","   0","    0","   5","  0","    0","   5"
"1684","madera","2020-04-27","   0","  568","  10","  0","  568","  10"
"1685","tuolumne","2020-04-28","   0","  151","   1","  0","  151","   1"
"1686","madera","2020-04-28","   1","  568","  19","  0","  567","  19"
"1687","plumas","2020-04-28","   0","    9","   0","  0","    9","   0"
"1688","santa barbara","2020-04-28","  43","  717","  81"," 16","  674","  65"
"1689","monterey","2020-04-28","   9","  875"," 116","  4","  866"," 112"
"1690","imperial","2020-04-28","  33","  260","   4"," 13","  227","  -9"
"1691","butte","2020-04-28","   1","  424","  19","  0","  423","  19"
"1692","colusa","2020-04-28","   1","   80","   5","  1","   79","   4"
"1693","mono","2020-04-28","   0","   17","   2","  0","   17","   2"
"1694","san bernardino","2020-04-28"," 279"," 4556"," 179"," 82"," 4277","  97"
"1695","sutter","2020-04-28","   0","    0","   0","  0","    0","   0"
"1696","alameda","2020-04-28"," 140"," 1748"," 148"," 50"," 1608","  98"
"1697","glenn","2020-04-28","   0","    0","   0","  0","    0","   0"
"1698","riverside","2020-04-28"," 327"," 3716"," 170"," 98"," 3389","  72"
"1699","santa clara","2020-04-28"," 150"," 3331"," 197"," 56"," 3181"," 141"
"1700","stanislaus","2020-04-28","  61"," 1573","  92","  9"," 1512","  83"
"1701","mendocino","2020-04-28","   0","  151","   8","  0","  151","   8"
"1702","napa","2020-04-28","   1","  387","   5","  0","  386","   5"
"1703","kern","2020-04-28","  45"," 1702","  53"," 25"," 1657","  28"
"1704","san diego","2020-04-28"," 381"," 5605"," 361","130"," 5224"," 231"
"1705","san luis obispo","2020-04-28","   6","  526","  33","  4","  520","  29"
"1706","nevada","2020-04-28","   3","  102","   4","  2","   99","   2"
"1707","yuba","2020-04-28","   2","  445","   8","  1","  443","   7"
"1708","kings","2020-04-28","  11","  199","   8","  2","  188","   6"
"1709","placer","2020-04-28","  26","  340"," 103","  3","  314"," 100"
"1710","lake","2020-04-28","   2","   58","   3","  1","   56","   2"
"1711","san joaquin","2020-04-28","  40"," 1146","  25"," 16"," 1106","   9"
"1712","amador","2020-04-28","   0","    0","   4","  0","    0","   4"
"1713","orange","2020-04-28"," 287"," 5370"," 369","100"," 5083"," 269"
"1714","modoc","2020-04-28","   1","   12","   0","  0","   11","   0"
"1715","san mateo","2020-04-28","  63","  790","  49"," 17","  727","  32"
"1716","santa cruz","2020-04-28","   2","  354","  15","  1","  352","  14"
"1717","merced","2020-04-28","   8","  206","   4","  2","  198","   2"
"1718","fresno","2020-04-28","  83"," 2007","  87"," 21"," 1924","  66"
"1719","lassen","2020-04-28","   0","   25","   0","  0","   25","   0"
"1720","sonoma","2020-04-28","  14","  789","  52","  4","  775","  48"
"1721","yolo","2020-04-28","   0","  130","  10","  1","  130","   9"
"1722","sacramento","2020-04-28","  76"," 1256"," 129"," 25"," 1180"," 104"
"1723","san francisco","2020-04-28"," 104"," 1412"," 132"," 36"," 1308","  96"
"1724","marin","2020-04-28","   8","  358","  19","  2","  350","  17"
"1725","contra costa","2020-04-28","  70"," 1485"," 137"," 23"," 1415"," 114"
"1726","tulare","2020-04-28","  34","  898","  26","  6","  864","  20"
"1727","shasta","2020-04-28","   3","  645","   6","  2","  642","   4"
"1728","siskiyou","2020-04-28","   2","   65","   4","  1","   63","   3"
"1729","trinity","2020-04-28","   0","   54","   0","  0","   54","   0"
"1730","calaveras","2020-04-28","   1","   50","  12","  0","   49","  12"
"1731","el dorado","2020-04-28","   8","  159","   8","  2","  151","   6"
"1732","humboldt","2020-04-28","   6","  305","   5","  1","  299","   4"
"1733","inyo","2020-04-28","   0","   56","   6","  0","   56","   6"
"1734","mariposa","2020-04-28","   1","   30","   0","  0","   29","   0"
"1735","san benito","2020-04-28","   0","   25","   2","  0","   25","   2"
"1736","tehama","2020-04-28","   0","  106","   5","  0","  106","   5"
"1737","ventura","2020-04-28"," 102"," 1295","  26"," 22"," 1193","   4"
"1738","solano","2020-04-28","  28","  592","  61","  5","  564","  56"
"1739","del norte","2020-04-28","   5","    0","   3","  1","   -5","   2"
"1740","los angeles","2020-04-28","2543","20337","1209","727","17794"," 482"
"1741","sacramento","2020-04-29","  78"," 1314"," 137"," 22"," 1236"," 115"
"1742","stanislaus","2020-04-29","  61"," 1573","  97","  9"," 1512","  88"
"1743","riverside","2020-04-29"," 336"," 3728"," 201","110"," 3392","  91"
"1744","san diego","2020-04-29"," 355"," 5619"," 363","136"," 5264"," 227"
"1745","yuba","2020-04-29","   0","  445","  10","  0","  445","  10"
"1746","los angeles","2020-04-29","2550","20960","1167","699","18410"," 468"
"1747","alameda","2020-04-29"," 139"," 1746"," 168"," 46"," 1607"," 122"
"1748","merced","2020-04-29","   9","  206","   5","  2","  197","   3"
"1749","san joaquin","2020-04-29","  41"," 1146","  30"," 16"," 1105","  14"
"1750","orange","2020-04-29"," 302"," 5397"," 373"," 92"," 5095"," 281"
"1751","mariposa","2020-04-29","   1","   30","   0","  0","   29","   0"
"1752","solano","2020-04-29","  28","  592","  56"," 10","  564","  46"
"1753","yolo","2020-04-29","   0","  130","  10","  1","  130","   9"
"1754","marin","2020-04-29","   6","  358","  22","  1","  352","  21"
"1755","ventura","2020-04-29","  57"," 1354","  50"," 17"," 1297","  33"
"1756","nevada","2020-04-29","   3","  102","   4","  2","   99","   2"
"1757","tehama","2020-04-29","   0","  106","   5","  0","  106","   5"
"1758","el dorado","2020-04-29","   4","  156","   6","  2","  152","   4"
"1759","madera","2020-04-29","   1","  568","  22","  0","  567","  22"
"1760","imperial","2020-04-29","  34","  258","   4"," 13","  224","  -9"
"1761","amador","2020-04-29","   0","    0","   4","  0","    0","   4"
"1762","siskiyou","2020-04-29","   3","   65","   2","  1","   62","   1"
"1763","trinity","2020-04-29","   0","   54","   0","  0","   54","   0"
"1764","inyo","2020-04-29","   0","   56","   6","  0","   56","   6"
"1765","kings","2020-04-29","  11","  199","   8","  2","  188","   6"
"1766","santa barbara","2020-04-29","  42","  717","  85"," 14","  675","  71"
"1767","colusa","2020-04-29","   1","   80","   5","  1","   79","   4"
"1768","san bernardino","2020-04-29"," 280"," 4556"," 162"," 79"," 4276","  83"
"1769","calaveras","2020-04-29","   0","   50","  12","  0","   50","  12"
"1770","lassen","2020-04-29","   0","   25","   0","  0","   25","   0"
"1771","kern","2020-04-29","  49"," 1702","  59"," 26"," 1653","  33"
"1772","del norte","2020-04-29","   3","    0","   2","  1","   -3","   1"
"1773","santa cruz","2020-04-29","   2","  354","   8","  1","  352","   7"
"1774","contra costa","2020-04-29","  74"," 1485"," 131"," 23"," 1411"," 108"
"1775","glenn","2020-04-29","   0","    0","   0","  0","    0","   0"
"1776","plumas","2020-04-29","   0","   39","   0","  0","   39","   0"
"1777","sutter","2020-04-29","   0","    0","   0","  0","    0","   0"
"1778","san benito","2020-04-29","   0","   25","   1","  0","   25","   1"
"1779","tulare","2020-04-29","  30","  920","  30","  5","  890","  25"
"1780","monterey","2020-04-29","   7","  875"," 106","  3","  868"," 103"
"1781","shasta","2020-04-29","   2","  645","   5","  2","  643","   3"
"1782","butte","2020-04-29","   2","  424","  20","  1","  422","  19"
"1783","san mateo","2020-04-29","  70","  790","  52"," 17","  720","  35"
"1784","humboldt","2020-04-29","   6","  305","   7","  3","  299","   4"
"1785","napa","2020-04-29","   1","  387","   6","  0","  386","   6"
"1786","santa clara","2020-04-29"," 144"," 3331"," 198"," 48"," 3187"," 150"
"1787","modoc","2020-04-29","   0","   24","   0","  0","   24","   0"
"1788","sonoma","2020-04-29","  19","  789","  51","  4","  770","  47"
"1789","lake","2020-04-29","   2","   58","   1","  1","   56","   0"
"1790","placer","2020-04-29","  33","  340","  80","  4","  307","  76"
"1791","mendocino","2020-04-29","   0","  151","   6","  0","  151","   6"
"1792","san luis obispo","2020-04-29","   5","  526","  34","  3","  521","  31"
"1793","tuolumne","2020-04-29","   0","  151","   0","  0","  151","   0"
"1794","fresno","2020-04-29","  86"," 2007","  91"," 24"," 1921","  67"
"1795","san francisco","2020-04-29"," 104"," 1862"," 107"," 32"," 1758","  75"
"1796","mono","2020-04-29","   0","   17","   1","  0","   17","   1"
"1797","amador","2020-04-30","   0","    0","   4","  0","    0","   4"
"1798","marin","2020-04-30","   3","  358","  19","  0","  355","  19"
"1799","monterey","2020-04-30","  12","  875"," 106","  6","  863"," 100"
"1800","trinity","2020-04-30","   0","   54","   0","  0","   54","   0"
"1801","santa barbara","2020-04-30","  35","  717","  85"," 16","  682","  69"
"1802","madera","2020-04-30","   3","  568","  21","  0","  565","  21"
"1803","placer","2020-04-30","  32","  340","  82","  5","  308","  77"
"1804","calaveras","2020-04-30","   0","   50","  12","  0","   50","  12"
"1805","plumas","2020-04-30","   0","   39","   0","  0","   39","   0"
"1806","yolo","2020-04-30","   0","  130","  12","  0","  130","  12"
"1807","shasta","2020-04-30","   2","  645","  10","  2","  643","   8"
"1808","san luis obispo","2020-04-30","   6","  526","  30","  4","  520","  26"
"1809","tuolumne","2020-04-30","   0","  151","   0","  0","  151","   0"
"1810","el dorado","2020-04-30","   6","  156","  10","  1","  150","   9"
"1811","yuba","2020-04-30","   0","  445","  14","  0","  445","  14"
"1812","nevada","2020-04-30","   1","  104","   4","  1","  103","   3"
"1813","inyo","2020-04-30","   0","   56","   6","  0","   56","   6"
"1814","sutter","2020-04-30","   0","    0","   0","  0","    0","   0"
"1815","riverside","2020-04-30"," 352"," 3310"," 184","115"," 2958","  69"
"1816","san bernardino","2020-04-30"," 258"," 3738"," 184"," 75"," 3480"," 109"
"1817","mono","2020-04-30","   0","   17","   1","  0","   17","   1"
"1818","colusa","2020-04-30","   1","   80","   5","  1","   79","   4"
"1819","siskiyou","2020-04-30","   2","   65","   4","  0","   63","   4"
"1820","sacramento","2020-04-30","  72"," 1332"," 129"," 22"," 1260"," 107"
"1821","san mateo","2020-04-30","  63","  790","  48"," 17","  727","  31"
"1822","alameda","2020-04-30"," 126"," 1746"," 165"," 46"," 1620"," 119"
"1823","kern","2020-04-30","  54"," 1385","  49"," 20"," 1331","  29"
"1824","solano","2020-04-30","  23","  592","  57","  8","  569","  49"
"1825","sonoma","2020-04-30","  12","  789","  50","  5","  777","  45"
"1826","san benito","2020-04-30","   1","   25","   2","  0","   24","   2"
"1827","tulare","2020-04-30","  30","  920","  29","  7","  890","  22"
"1828","imperial","2020-04-30","  32","  261","   4"," 13","  229","  -9"
"1829","santa cruz","2020-04-30","   3","  354","  16","  2","  351","  14"
"1830","merced","2020-04-30","   5","  206","   5","  1","  201","   4"
"1831","mariposa","2020-04-30","   2","   30","   0","  0","   28","   0"
"1832","fresno","2020-04-30","  78"," 1997","  83"," 19"," 1919","  64"
"1833","napa","2020-04-30","   1","  387","   7","  0","  386","   7"
"1834","lake","2020-04-30","   2","   58","   2","  0","   56","   2"
"1835","ventura","2020-04-30","  51"," 1381","  51"," 14"," 1330","  37"
"1836","santa clara","2020-04-30"," 141"," 3331"," 191"," 48"," 3190"," 143"
"1837","humboldt","2020-04-30","   7","  305","   8","  2","  298","   6"
"1838","del norte","2020-04-30","   4","    0","   2","  2","   -4","   0"
"1839","kings","2020-04-30","  10","  199","   3","  2","  189","   1"
"1840","contra costa","2020-04-30","  67"," 1485"," 141"," 15"," 1418"," 126"
"1841","san francisco","2020-04-30","  96"," 1887"," 100"," 33"," 1791","  67"
"1842","butte","2020-04-30","   0","  424","  20","  0","  424","  20"
"1843","modoc","2020-04-30","   0","   41","   0","  0","   41","   0"
"1844","san joaquin","2020-04-30","  41"," 1146","  30"," 12"," 1105","  18"
"1845","los angeles","2020-04-30","2364","18236","1235","684","15872"," 551"
"1846","orange","2020-04-30"," 282"," 4725"," 457"," 87"," 4443"," 370"
"1847","stanislaus","2020-04-30","  62"," 1573"," 100","  8"," 1511","  92"
"1848","tehama","2020-04-30","   0","  106","   4","  0","  106","   4"
"1849","mendocino","2020-04-30","   0","  151","   5","  0","  151","   5"
"1850","san diego","2020-04-30"," 364"," 4933"," 357","141"," 4569"," 216"
"1851","glenn","2020-04-30","   0","    0","   0","  0","    0","   0"
"1852","lassen","2020-04-30","   0","   25","   0","  0","   25","   0"
"1853","kings","2020-05-01","  11","  199","   1","  2","  188","  -1"
"1854","trinity","2020-05-01","   0","   54","   0","  0","   54","   0"
"1855","el dorado","2020-05-01","   2","  156","  11","  1","  154","  10"
"1856","tehama","2020-05-01","   0","  106","   3","  0","  106","   3"
"1857","lassen","2020-05-01","   0","   25","   0","  0","   25","   0"
"1858","ventura","2020-05-01","  41"," 1375","  51"," 14"," 1334","  37"
"1859","tulare","2020-05-01","  30","  920","  23","  7","  890","  16"
"1860","imperial","2020-05-01","  39","  263","   2"," 15","  224"," -13"
"1861","san benito","2020-05-01","   1","   25","   1","  0","   24","   1"
"1862","contra costa","2020-05-01","  58"," 1485"," 143"," 15"," 1427"," 128"
"1863","napa","2020-05-01","   2","  387","   6","  0","  385","   6"
"1864","mendocino","2020-05-01","   0","  151","   6","  0","  151","   6"
"1865","placer","2020-05-01","  20","  340","  80","  4","  320","  76"
"1866","san joaquin","2020-05-01","  33"," 1146","  21"," 14"," 1113","   7"
"1867","yolo","2020-05-01","   0","  130","  14","  0","  130","  14"
"1868","yuba","2020-05-01","   0","  445","   8","  0","  445","   8"
"1869","monterey","2020-05-01","   8","  875"," 105","  4","  867"," 101"
"1870","santa barbara","2020-05-01","  38","  717","  77"," 15","  679","  62"
"1871","calaveras","2020-05-01","   1","   50","  12","  0","   49","  12"
"1872","sacramento","2020-05-01","  64"," 1347"," 122"," 18"," 1283"," 104"
"1873","fresno","2020-05-01","  72"," 2004","  77"," 21"," 1932","  56"
"1874","mariposa","2020-05-01","   2","   30","   0","  0","   28","   0"
"1875","santa cruz","2020-05-01","   4","  354","  13","  2","  350","  11"
"1876","san luis obispo","2020-05-01","   7","  526","  21","  3","  519","  18"
"1877","nevada","2020-05-01","   1","  105","   6","  1","  104","   5"
"1878","orange","2020-05-01"," 319"," 4725"," 374"," 85"," 4406"," 289"
"1879","merced","2020-05-01","   5","  206","   3","  1","  201","   2"
"1880","san bernardino","2020-05-01"," 263"," 3738"," 138"," 70"," 3475","  68"
"1881","kern","2020-05-01","  48"," 1717","  47"," 19"," 1669","  28"
"1882","tuolumne","2020-05-01","   0","  151","   0","  0","  151","   0"
"1883","riverside","2020-05-01"," 362"," 3302"," 217","122"," 2940","  95"
"1884","inyo","2020-05-01","   0","   56","   4","  0","   56","   4"
"1885","madera","2020-05-01","   0","  568","  19","  0","  568","  19"
"1886","stanislaus","2020-05-01","  54"," 1573","  86","  5"," 1519","  81"
"1887","santa clara","2020-05-01"," 140"," 3331"," 197"," 44"," 3191"," 153"
"1888","san francisco","2020-05-01"," 100"," 1887"," 101"," 32"," 1787","  69"
"1889","butte","2020-05-01","   1","  424","  20","  1","  423","  19"
"1890","glenn","2020-05-01","   0","    0","   0","  0","    0","   0"
"1891","modoc","2020-05-01","   0","   41","   0","  0","   41","   0"
"1892","san mateo","2020-05-01","  60","  790","  49"," 18","  730","  31"
"1893","mono","2020-05-01","   0","   17","   1","  0","   17","   1"
"1894","sutter","2020-05-01","   0","    0","   0","  0","    0","   0"
"1895","san diego","2020-05-01"," 350"," 4932"," 365","134"," 4582"," 231"
"1896","colusa","2020-05-01","   1","   80","   5","  1","   79","   4"
"1897","siskiyou","2020-05-01","   2","   65","   4","  0","   63","   4"
"1898","plumas","2020-05-01","   0","   39","   0","  0","   39","   0"
"1899","shasta","2020-05-01","   1","  645","  15","  1","  644","  14"
"1900","alameda","2020-05-01"," 135"," 1746"," 165"," 45"," 1611"," 120"
"1901","amador","2020-05-01","   0","    0","  -2","  0","    0","  -2"
"1902","marin","2020-05-01","   5","  358","  23","  0","  353","  23"
"1903","solano","2020-05-01","  21","  592","  58","  9","  571","  49"
"1904","del norte","2020-05-01","   0","    0","   3","  0","    0","   3"
"1905","humboldt","2020-05-01","   5","  305","   7","  0","  300","   7"
"1906","lake","2020-05-01","   2","   58","   2","  1","   56","   1"
"1907","sonoma","2020-05-01","  19","  789","  52","  5","  770","  47"
"1908","los angeles","2020-05-01","2395","18549","1185","704","16154"," 481"
"1909","san luis obispo","2020-05-02","  13","  526","  21","  5","  513","  16"
"1910","imperial","2020-05-02","  39","  261","   2"," 15","  222"," -13"
"1911","siskiyou","2020-05-02","   0","   65","   6","  0","   65","   6"
"1912","riverside","2020-05-02"," 337"," 3829"," 197","109"," 3492","  88"
"1913","plumas","2020-05-02","   0","   39","   0","  0","   39","   0"
"1914","modoc","2020-05-02","   0","   41","   0","  0","   41","   0"
"1915","butte","2020-05-02","   0","  424","  19","  0","  424","  19"
"1916","santa clara","2020-05-02"," 131"," 3331"," 195"," 46"," 3200"," 149"
"1917","marin","2020-05-02","  11","  358","  24","  0","  347","  24"
"1918","calaveras","2020-05-02","   1","   50","  11","  1","   49","  10"
"1919","orange","2020-05-02"," 322"," 5374"," 376"," 98"," 5052"," 278"
"1920","yuba","2020-05-02","   0","  445","  12","  0","  445","  12"
"1921","sonoma","2020-05-02","  17","  789","  49","  3","  772","  46"
"1922","trinity","2020-05-02","   0","   54","   0","  0","   54","   0"
"1923","lassen","2020-05-02","   0","   25","   0","  0","   25","   0"
"1924","monterey","2020-05-02","  11","  829"," 103","  5","  818","  98"
"1925","santa barbara","2020-05-02","  36","  717","  80"," 17","  681","  63"
"1926","tuolumne","2020-05-02","   0","  151","   2","  0","  151","   2"
"1927","sacramento","2020-05-02","  58"," 1299"," 119"," 26"," 1241","  93"
"1928","el dorado","2020-05-02","   2","  156","  10","  1","  154","   9"
"1929","amador","2020-05-02","   0","    0","   3","  0","    0","   3"
"1930","lake","2020-05-02","   0","   58","   2","  0","   58","   2"
"1931","tehama","2020-05-02","   0","  106","   5","  0","  106","   5"
"1932","nevada","2020-05-02","   2","  118","   6","  1","  116","   5"
"1933","inyo","2020-05-02","   0","   42","   2","  0","   42","   2"
"1934","kings","2020-05-02","  10","  199","   3","  2","  189","   1"
"1935","kern","2020-05-02","  43"," 1723","  41"," 20"," 1680","  21"
"1936","colusa","2020-05-02","   1","   80","   5","  1","   79","   4"
"1937","shasta","2020-05-02","   0","  645","  13","  0","  645","  13"
"1938","san mateo","2020-05-02","  61","  790","  51"," 17","  729","  34"
"1939","san francisco","2020-05-02"," 108"," 1915"," 101"," 36"," 1807","  65"
"1940","solano","2020-05-02","  29","  592","  54"," 13","  563","  41"
"1941","stanislaus","2020-05-02","  66"," 1573","  87","  8"," 1507","  79"
"1942","san joaquin","2020-05-02","  33"," 1146","  22"," 15"," 1113","   7"
"1943","contra costa","2020-05-02","  65"," 1485"," 139"," 17"," 1420"," 122"
"1944","mono","2020-05-02","   0","   17","   1","  0","   17","   1"
"1945","humboldt","2020-05-02","   5","  305","   8","  0","  300","   8"
"1946","napa","2020-05-02","   1","  387","   3","  0","  386","   3"
"1947","san diego","2020-05-02"," 357"," 5513"," 370","141"," 5156"," 229"
"1948","mariposa","2020-05-02","   0","   30","   0","  0","   30","   0"
"1949","fresno","2020-05-02","  81"," 2008","  87"," 19"," 1927","  68"
"1950","placer","2020-05-02","  28","  340","  82","  6","  312","  76"
"1951","yolo","2020-05-02","   0","  130","  11","  0","  130","  11"
"1952","madera","2020-05-02","   0","  568","  20","  0","  568","  20"
"1953","los angeles","2020-05-02","2380","21176","1185","704","18796"," 481"
"1954","santa cruz","2020-05-02","   3","  354","  11","  1","  351","  10"
"1955","mendocino","2020-05-02","   0","  151","   7","  0","  151","   7"
"1956","glenn","2020-05-02","   0","    0","   0","  0","    0","   0"
"1957","san benito","2020-05-02","   1","   25","   2","  0","   24","   2"
"1958","del norte","2020-05-02","   0","    0","   4","  0","    0","   4"
"1959","merced","2020-05-02","   8","  206","   3","  2","  198","   1"
"1960","tulare","2020-05-02","  30","  920","  24","  7","  890","  17"
"1961","sutter","2020-05-02","   0","    0","   0","  0","    0","   0"
"1962","san bernardino","2020-05-02"," 260"," 4419"," 126"," 77"," 4159","  49"
"1963","alameda","2020-05-02"," 132"," 1746"," 163"," 38"," 1614"," 125"
"1964","ventura","2020-05-02","  52"," 1416","  55"," 17"," 1364","  38"
"1965","los angeles","2020-05-03","2299","21621","1178","694","19322"," 484"
"1966","sonoma","2020-05-03","  16","  789","  51","  5","  773","  46"
"1967","shasta","2020-05-03","   0","  645","  12","  0","  645","  12"
"1968","glenn","2020-05-03","   0","    0","   0","  0","    0","   0"
"1969","butte","2020-05-03","   2","  424","  22","  0","  422","  22"
"1970","tehama","2020-05-03","   0","  106","   5","  0","  106","   5"
"1971","yuba","2020-05-03","   1","  445","   7","  1","  444","   6"
"1972","marin","2020-05-03","   6","  358","  24","  0","  352","  24"
"1973","san diego","2020-05-03"," 352"," 5545"," 369","145"," 5193"," 224"
"1974","santa clara","2020-05-03"," 132"," 3331"," 199"," 47"," 3199"," 152"
"1975","fresno","2020-05-03","  88"," 2008","  86"," 22"," 1920","  64"
"1976","madera","2020-05-03","   0","  568","  19","  0","  568","  19"
"1977","placer","2020-05-03","  19","  340","  84","  6","  321","  78"
"1978","san benito","2020-05-03","   0","   25","   2","  0","   25","   2"
"1979","nevada","2020-05-03","   1","  118","   8","  0","  117","   8"
"1980","napa","2020-05-03","   0","  387","   4","  0","  387","   4"
"1981","inyo","2020-05-03","   1","   42","   2","  0","   41","   2"
"1982","plumas","2020-05-03","   2","   29","   0","  0","   27","   0"
"1983","stanislaus","2020-05-03","  48"," 1573","  77","  8"," 1525","  69"
"1984","mariposa","2020-05-03","   0","   30","   0","  0","   30","   0"
"1985","orange","2020-05-03"," 308"," 5374"," 376"," 91"," 5066"," 285"
"1986","santa cruz","2020-05-03","   3","  354","  15","  1","  351","  14"
"1987","mendocino","2020-05-03","   0","  151","   7","  0","  151","   7"
"1988","humboldt","2020-05-03","   3","  305","   8","  0","  302","   8"
"1989","kern","2020-05-03","  42"," 1710","  86"," 18"," 1668","  68"
"1990","contra costa","2020-05-03","  64"," 1485"," 147"," 15"," 1421"," 132"
"1991","san mateo","2020-05-03","  61","  790","  50"," 18","  729","  32"
"1992","siskiyou","2020-05-03","   0","   65","   6","  0","   65","   6"
"1993","riverside","2020-05-03"," 349"," 3809"," 179","112"," 3460","  67"
"1994","sacramento","2020-05-03","  57"," 1293"," 117"," 28"," 1236","  89"
"1995","imperial","2020-05-03","  44","  251","   3"," 14","  207"," -11"
"1996","calaveras","2020-05-03","   1","   50","  11","  1","   49","  10"
"1997","el dorado","2020-05-03","   2","  154","  10","  1","  152","   9"
"1998","san joaquin","2020-05-03","  35"," 1146","  22"," 15"," 1111","   7"
"1999","san bernardino","2020-05-03"," 254"," 4419"," 135"," 75"," 4165","  60"
"2000","mono","2020-05-03","   0","   17","   1","  0","   17","   1"
"2001","san luis obispo","2020-05-03","   9","  526","  22","  4","  517","  18"
"2002","colusa","2020-05-03","   1","   80","   5","  1","   79","   4"
"2003","modoc","2020-05-03","   0","   41","   0","  0","   41","   0"
"2004","sutter","2020-05-03","   0","    0","   0","  0","    0","   0"
"2005","alameda","2020-05-03"," 135"," 1746"," 164"," 48"," 1611"," 116"
"2006","kings","2020-05-03","  10","  199","   2","  2","  189","   0"
"2007","lassen","2020-05-03","   0","   25","   0","  0","   25","   0"
"2008","tulare","2020-05-03","  28","  920","  26","  7","  892","  19"
"2009","del norte","2020-05-03","   0","    0","   7","  0","    0","   7"
"2010","lake","2020-05-03","   3","   58","   2","  1","   55","   1"
"2011","san francisco","2020-05-03"," 101"," 1915"," 107"," 34"," 1814","  73"
"2012","monterey","2020-05-03","   8","  829","  92","  4","  821","  88"
"2013","ventura","2020-05-03","  63"," 1386","  58"," 16"," 1323","  42"
"2014","trinity","2020-05-03","   0","   54","   0","  0","   54","   0"
"2015","merced","2020-05-03","   9","  206","   3","  4","  197","  -1"
"2016","solano","2020-05-03","  25","  592","  58","  9","  567","  49"
"2017","tuolumne","2020-05-03","   0","  151","   2","  0","  151","   2"
"2018","yolo","2020-05-03","   0","  130","   9","  2","  130","   7"
"2019","amador","2020-05-03","   0","    0","   2","  0","    0","   2"
"2020","santa barbara","2020-05-03","  34","  717","  88"," 15","  683","  73"
"2021","shasta","2020-05-04","   0","  667","  12","  0","  667","  12"
"2022","mendocino","2020-05-04","   0","  180","   5","  0","  180","   5"
"2023","glenn","2020-05-04","   0","    0","   0","  0","    0","   0"
"2024","los angeles","2020-05-04","2371","22298","1166","676","19927"," 490"
"2025","fresno","2020-05-04","  86"," 2001","  89"," 25"," 1915","  64"
"2026","sacramento","2020-05-04","  50"," 1284"," 131"," 21"," 1234"," 110"
"2027","placer","2020-05-04","  17","  340","  88","  1","  323","  87"
"2028","mariposa","2020-05-04","   0","   30","   0","  0","   30","   0"
"2029","calaveras","2020-05-04","   1","   50","  11","  0","   49","  11"
"2030","ventura","2020-05-04","  43"," 1383","  55"," 14"," 1340","  41"
"2031","lake","2020-05-04","   4","   58","   4","  0","   54","   4"
"2032","yuba","2020-05-04","   1","  445","   9","  1","  444","   8"
"2033","tehama","2020-05-04","   0","  106","   6","  0","  106","   6"
"2034","trinity","2020-05-04","   0","   54","   0","  0","   54","   0"
"2035","modoc","2020-05-04","   0","   41","   0","  0","   41","   0"
"2036","alameda","2020-05-04"," 135"," 1769"," 163"," 46"," 1634"," 117"
"2037","contra costa","2020-05-04","  51"," 1485"," 142"," 13"," 1434"," 129"
"2038","san bernardino","2020-05-04"," 259"," 4564"," 146"," 69"," 4305","  77"
"2039","riverside","2020-05-04"," 323"," 3898"," 202","104"," 3575","  98"
"2040","san francisco","2020-05-04","  94"," 1887"," 118"," 26"," 1793","  92"
"2041","san diego","2020-05-04"," 354"," 5588"," 373","135"," 5234"," 238"
"2042","kern","2020-05-04","  48"," 1728","  74"," 23"," 1680","  51"
"2043","mono","2020-05-04","   0","   17","   1","  0","   17","   1"
"2044","plumas","2020-05-04","   2","   29","   0","  0","   27","   0"
"2045","solano","2020-05-04","  37","  592","  57","  8","  555","  49"
"2046","san joaquin","2020-05-04","  33"," 1287","  23"," 14"," 1254","   9"
"2047","stanislaus","2020-05-04","  45","  995","  90","  5","  950","  85"
"2048","santa clara","2020-05-04"," 123"," 3331"," 210"," 42"," 3208"," 168"
"2049","butte","2020-05-04","   1","  448","  12","  0","  447","  12"
"2050","humboldt","2020-05-04","   3","  344","   8","  1","  341","   7"
"2051","san mateo","2020-05-04","  59","  790","  54"," 13","  731","  41"
"2052","marin","2020-05-04","   8","  350","  21","  3","  342","  18"
"2053","napa","2020-05-04","   0","  387","   5","  1","  387","   4"
"2054","sonoma","2020-05-04","  16","  789","  57","  3","  773","  54"
"2055","santa barbara","2020-05-04","  39","  717","  97"," 18","  678","  79"
"2056","madera","2020-05-04","   1","  568","  22","  0","  567","  22"
"2057","merced","2020-05-04","  12","  206","   6","  5","  194","   1"
"2058","tulare","2020-05-04","  22","  920","  24","  6","  898","  18"
"2059","amador","2020-05-04","   0","    0","   3","  0","    0","   3"
"2060","tuolumne","2020-05-04","   0","  151","   1","  0","  151","   1"
"2061","del norte","2020-05-04","   0","    0","   5","  0","    0","   5"
"2062","el dorado","2020-05-04","   3","  185","   9","  0","  182","   9"
"2063","yolo","2020-05-04","   0","  130","   9","  2","  130","   7"
"2064","kings","2020-05-04","  10","  199","   4","  2","  189","   2"
"2065","san benito","2020-05-04","   0","   25","   2","  0","   25","   2"
"2066","lassen","2020-05-04","   0","   25","   0","  0","   25","   0"
"2067","nevada","2020-05-04","   1","  122","   3","  0","  121","   3"
"2068","inyo","2020-05-04","   1","   42","   4","  0","   41","   4"
"2069","orange","2020-05-04"," 294"," 5607"," 349"," 88"," 5313"," 261"
"2070","santa cruz","2020-05-04","   3","  354","  15","  0","  351","  15"
"2071","siskiyou","2020-05-04","   0","   65","   6","  0","   65","   6"
"2072","monterey","2020-05-04","   5","  829"," 102","  3","  824","  99"
"2073","imperial","2020-05-04","  56","  252","   1"," 16","  196"," -15"
"2074","san luis obispo","2020-05-04","  11","  526","  24","  4","  515","  20"
"2075","colusa","2020-05-04","   0","   88","   6","  0","   88","   6"
"2076","sutter","2020-05-04","   0","    0","   0","  0","    0","   0"
"2077","butte","2020-05-05","   0","  448","  14","  0","  448","  14"
"2078","mariposa","2020-05-05","   1","   30","   0","  0","   29","   0"
"2079","san diego","2020-05-05"," 363"," 6128"," 345","133"," 5765"," 212"
"2080","sacramento","2020-05-05","  50"," 2323"," 119"," 19"," 2273"," 100"
"2081","mendocino","2020-05-05","   0","  158","   5","  0","  158","   5"
"2082","plumas","2020-05-05","   2","   45","   0","  0","   43","   0"
"2083","madera","2020-05-05","   0","  568","  19","  0","  568","  19"
"2084","amador","2020-05-05","   0","   51","   0","  0","   51","   0"
"2085","tuolumne","2020-05-05","   0","  151","   1","  0","  151","   1"
"2086","tulare","2020-05-05","  24","  920","  18","  5","  896","  13"
"2087","monterey","2020-05-05","   5","  829"," 107","  3","  824"," 104"
"2088","merced","2020-05-05","  10","  242","   4","  4","  232","   0"
"2089","sutter","2020-05-05","   0","   14","   0","  0","   14","   0"
"2090","san mateo","2020-05-05","  58"," 1096","  35"," 18"," 1038","  17"
"2091","siskiyou","2020-05-05","   0","   65","   6","  0","   65","   6"
"2092","marin","2020-05-05","  14","  390","  20","  3","  376","  17"
"2093","humboldt","2020-05-05","  13","  344","  10","  2","  331","   8"
"2094","napa","2020-05-05","   2","  387","   4","  2","  385","   2"
"2095","solano","2020-05-05","  29","  707","  50","  6","  678","  44"
"2096","fresno","2020-05-05","  99"," 2049","  88"," 27"," 1950","  61"
"2097","orange","2020-05-05"," 279"," 5585"," 372"," 85"," 5306"," 287"
"2098","shasta","2020-05-05","   0","  667","   9","  0","  667","   9"
"2099","glenn","2020-05-05","   0","    0","   0","  0","    0","   0"
"2100","imperial","2020-05-05","  58","  255","   1"," 16","  197"," -15"
"2101","santa clara","2020-05-05"," 113"," 3273"," 220"," 39"," 3160"," 181"
"2102","los angeles","2020-05-05","2370","22079","1164","681","19709"," 483"
"2103","riverside","2020-05-05"," 333"," 3898"," 185","114"," 3565","  71"
"2104","san joaquin","2020-05-05","  47"," 1366","  25"," 17"," 1319","   8"
"2105","tehama","2020-05-05","   0","  106","   6","  0","  106","   6"
"2106","placer","2020-05-05","  24","  753","  80","  2","  729","  78"
"2107","kings","2020-05-05","  12","  199","   0","  2","  187","  -2"
"2108","colusa","2020-05-05","   0","   88","   6","  0","   88","   6"
"2109","del norte","2020-05-05","   0","   51","   5","  0","   51","   5"
"2110","yuba","2020-05-05","   1","  445","  10","  1","  444","   9"
"2111","trinity","2020-05-05","   0","   54","   0","  0","   54","   0"
"2112","san luis obispo","2020-05-05","   5","  526","  27","  3","  521","  24"
"2113","calaveras","2020-05-05","   0","   50","  12","  0","   50","  12"
"2114","ventura","2020-05-05","  48"," 1360","  56"," 18"," 1312","  38"
"2115","inyo","2020-05-05","   0","   42","   4","  0","   42","   4"
"2116","el dorado","2020-05-05","   4","  185","   9","  0","  181","   9"
"2117","sonoma","2020-05-05","  16","  871","  60","  3","  855","  57"
"2118","san benito","2020-05-05","   0","   25","   2","  0","   25","   2"
"2119","kern","2020-05-05","  42"," 1737","  80"," 20"," 1695","  60"
"2120","san francisco","2020-05-05"," 103"," 2619"," 101"," 33"," 2516","  68"
"2121","nevada","2020-05-05","   0","  129","   3","  0","  129","   3"
"2122","santa barbara","2020-05-05","  35","  717","  99"," 15","  682","  84"
"2123","lassen","2020-05-05","   0","   25","   0","  0","   25","   0"
"2124","lake","2020-05-05","   2","  110","  -2","  1","  108","  -3"
"2125","san bernardino","2020-05-05"," 260"," 4564"," 139"," 78"," 4304","  61"
"2126","mono","2020-05-05","   0","   17","   2","  0","   17","   2"
"2127","santa cruz","2020-05-05","   3","  397","  12","  1","  394","  11"
"2128","alameda","2020-05-05"," 147"," 2446"," 143"," 42"," 2299"," 101"
"2129","yolo","2020-05-05","   0","  186","  12","  0","  186","  12"
"2130","contra costa","2020-05-05","  69"," 1628"," 119"," 18"," 1559"," 101"
"2131","stanislaus","2020-05-05","  40"," 1369","  87","  4"," 1329","  83"
"2132","modoc","2020-05-05","   0","   41","   0","  0","   41","   0"
"2133","siskiyou","2020-05-06","   0","   65","   5","  0","   65","   5"
"2134","humboldt","2020-05-06","   7","  344","   6","  2","  337","   4"
"2135","yuba","2020-05-06","   0","  445","   7","  0","  445","   7"
"2136","santa cruz","2020-05-06","   3","  397","   7","  1","  394","   6"
"2137","alameda","2020-05-06"," 136"," 2407"," 171"," 43"," 2271"," 128"
"2138","santa clara","2020-05-06"," 111"," 3275"," 210"," 40"," 3164"," 170"
"2139","modoc","2020-05-06","   0","   41","   0","  0","   41","   0"
"2140","glenn","2020-05-06","   0","    0","   0","  0","    0","   0"
"2141","kings","2020-05-06","  13","  199","   2","  2","  186","   0"
"2142","madera","2020-05-06","   0","  568","  15","  0","  568","  15"
"2143","tehama","2020-05-06","   0","  106","   4","  0","  106","   4"
"2144","merced","2020-05-06","   9","  242","   4","  6","  233","  -2"
"2145","amador","2020-05-06","   0","   51","   1","  0","   51","   1"
"2146","san benito","2020-05-06","   0","   25","   1","  0","   25","   1"
"2147","santa barbara","2020-05-06","  36","  717","  81"," 14","  681","  67"
"2148","inyo","2020-05-06","   0","   42","   4","  0","   42","   4"
"2149","kern","2020-05-06","  41"," 1747","  80"," 18"," 1706","  62"
"2150","lassen","2020-05-06","   1","   25","   0","  0","   24","   0"
"2151","san luis obispo","2020-05-06","   4","  526","  31","  4","  522","  27"
"2152","calaveras","2020-05-06","   0","   50","  12","  0","   50","  12"
"2153","sutter","2020-05-06","   0","   14","   0","  0","   14","   0"
"2154","contra costa","2020-05-06","  67"," 1628"," 122"," 20"," 1561"," 102"
"2155","lake","2020-05-06","   3","  110","   4","  1","  107","   3"
"2156","napa","2020-05-06","   2","  387","   6","  1","  385","   5"
"2157","ventura","2020-05-06","  51"," 1352","  45"," 19"," 1301","  26"
"2158","nevada","2020-05-06","   0","  126","   2","  1","  126","   1"
"2159","monterey","2020-05-06","   6","  829"," 106","  3","  823"," 103"
"2160","tulare","2020-05-06","  28","  920","  18","  5","  892","  13"
"2161","imperial","2020-05-06","  63","  252","   7"," 19","  189"," -12"
"2162","mariposa","2020-05-06","   1","   30","   0","  0","   29","   0"
"2163","san francisco","2020-05-06","  88"," 2619"," 113"," 30"," 2531","  83"
"2164","san bernardino","2020-05-06"," 236"," 4564"," 157"," 65"," 4328","  92"
"2165","marin","2020-05-06","  17","  390","  21","  3","  373","  18"
"2166","solano","2020-05-06","  30","  707","  61","  8","  677","  53"
"2167","fresno","2020-05-06","  94"," 2054","  92"," 22"," 1960","  70"
"2168","stanislaus","2020-05-06","  38"," 1369","  88","  3"," 1331","  85"
"2169","placer","2020-05-06","  30","  753","  84","  6","  723","  78"
"2170","san joaquin","2020-05-06","  46"," 1366","  31"," 17"," 1320","  14"
"2171","mono","2020-05-06","   1","   17","   2","  0","   16","   2"
"2172","san diego","2020-05-06"," 379"," 6195"," 339","134"," 5816"," 205"
"2173","sonoma","2020-05-06","  17","  871","  56","  3","  854","  53"
"2174","el dorado","2020-05-06","   4","  175","   8","  0","  171","   8"
"2175","del norte","2020-05-06","   0","   51","   6","  0","   51","   6"
"2176","yolo","2020-05-06","   1","  186","  11","  0","  185","  11"
"2177","colusa","2020-05-06","   0","   88","   6","  0","   88","   6"
"2178","tuolumne","2020-05-06","   0","  151","   1","  0","  151","   1"
"2179","san mateo","2020-05-06","  61"," 1096","  52"," 14"," 1035","  38"
"2180","butte","2020-05-06","   0","  448","  17","  0","  448","  17"
"2181","shasta","2020-05-06","   0","  667","  12","  0","  667","  12"
"2182","orange","2020-05-06"," 279"," 5585"," 372"," 85"," 5306"," 287"
"2183","sacramento","2020-05-06","  67"," 2319"," 115"," 19"," 2252","  96"
"2184","los angeles","2020-05-06","2292","23573","1206","657","21281"," 549"
"2185","trinity","2020-05-06","   0","   54","   0","  0","   54","   0"
"2186","mendocino","2020-05-06","   0","  180","   4","  0","  180","   4"
"2187","plumas","2020-05-06","   2","   45","   0","  0","   43","   0"
"2188","riverside","2020-05-06"," 296"," 3938"," 183","109"," 3642","  74"
"2189","santa cruz","2020-05-07","   4","  397","   9","  0","  393","   9"
"2190","sutter","2020-05-07","   0","   14","   0","  0","   14","   0"
"2191","sacramento","2020-05-07","  51"," 2318","  91"," 19"," 2267","  72"
"2192","inyo","2020-05-07","   0","   42","   4","  0","   42","   4"
"2193","yolo","2020-05-07","   0","  186","  11","  0","  186","  11"
"2194","lake","2020-05-07","   0","  110","   3","  0","  110","   3"
"2195","del norte","2020-05-07","   1","   51","   1","  0","   50","   1"
"2196","colusa","2020-05-07","   1","   88","   6","  0","   87","   6"
"2197","tulare","2020-05-07","  11","  920","  28","  5","  909","  23"
"2198","trinity","2020-05-07","   0","   54","   0","  0","   54","   0"
"2199","lassen","2020-05-07","   0","   25","   0","  0","   25","   0"
"2200","merced","2020-05-07","   8","  242","   4","  4","  234","   0"
"2201","monterey","2020-05-07","   5","  829"," 106","  3","  824"," 103"
"2202","imperial","2020-05-07","  59","  334","   7"," 19","  275"," -12"
"2203","el dorado","2020-05-07","   2","  172","  10","  0","  170","  10"
"2204","ventura","2020-05-07","  58"," 1353","  56"," 20"," 1295","  36"
"2205","shasta","2020-05-07","   0","  667","  17","  0","  667","  17"
"2206","orange","2020-05-07"," 299"," 5585"," 351"," 94"," 5286"," 257"
"2207","santa clara","2020-05-07"," 107"," 3275"," 180"," 35"," 3168"," 145"
"2208","plumas","2020-05-07","   0","   45","   0","  0","   45","   0"
"2209","stanislaus","2020-05-07","  39"," 1369","  75","  5"," 1330","  70"
"2210","fresno","2020-05-07","  88"," 2051","  92"," 18"," 1963","  74"
"2211","mendocino","2020-05-07","   0","  180","   3","  0","  180","   3"
"2212","san joaquin","2020-05-07","  38"," 1366","  31"," 12"," 1328","  19"
"2213","san mateo","2020-05-07","  51"," 1096","  43"," 13"," 1045","  30"
"2214","mono","2020-05-07","   0","   17","   2","  0","   17","   2"
"2215","san francisco","2020-05-07","  93"," 2619","  78"," 31"," 2526","  47"
"2216","solano","2020-05-07","  25","  707","  39"," 10","  682","  29"
"2217","humboldt","2020-05-07","   6","  352","   6","  0","  346","   6"
"2218","san bernardino","2020-05-07"," 226"," 4564"," 165"," 63"," 4338"," 102"
"2219","san diego","2020-05-07"," 387"," 6204"," 338","139"," 5817"," 199"
"2220","tehama","2020-05-07","   0","  106","   5","  0","  106","   5"
"2221","butte","2020-05-07","   2","  448","  19","  0","  446","  19"
"2222","riverside","2020-05-07"," 270"," 3902"," 177"," 99"," 3632","  78"
"2223","placer","2020-05-07","  31","  753","  38","  5","  722","  33"
"2224","mariposa","2020-05-07","   1","   30","   0","  0","   29","   0"
"2225","madera","2020-05-07","   1","  568","  14","  0","  567","  14"
"2226","san luis obispo","2020-05-07","   6","  526","  26","  3","  520","  23"
"2227","contra costa","2020-05-07","  65"," 1628","  97"," 19"," 1563","  78"
"2228","marin","2020-05-07","  13","  390","  14","  2","  377","  12"
"2229","calaveras","2020-05-07","   0","   50","  12","  0","   50","  12"
"2230","nevada","2020-05-07","   0","  112","   4","  0","  112","   4"
"2231","santa barbara","2020-05-07","  39","  717","  82"," 14","  678","  68"
"2232","amador","2020-05-07","   0","   51","   1","  0","   51","   1"
"2233","yuba","2020-05-07","   0","  445","   7","  0","  445","   7"
"2234","kings","2020-05-07","  14","  199","   0","  3","  185","  -3"
"2235","sonoma","2020-05-07","  13","  871","  52","  3","  858","  49"
"2236","los angeles","2020-05-07","2323","23461","1220","638","21138"," 582"
"2237","siskiyou","2020-05-07","   3","   65","   3","  2","   62","   1"
"2238","modoc","2020-05-07","   0","   41","   0","  0","   41","   0"
"2239","napa","2020-05-07","   2","  387","   3","  1","  385","   2"
"2240","alameda","2020-05-07"," 136"," 2446"," 131"," 43"," 2310","  88"
"2241","kern","2020-05-07","  36"," 1734","  79"," 20"," 1698","  59"
"2242","glenn","2020-05-07","   0","    0","   0","  0","    0","   0"
"2243","tuolumne","2020-05-07","   0","  151","   1","  0","  151","   1"
"2244","san benito","2020-05-07","   0","   25","   0","  0","   25","   0"
"2245","yolo","2020-05-08","   0","  186","   4","  0","  186","   4"
"2246","modoc","2020-05-08","   0","   41","   0","  0","   41","   0"
"2247","mariposa","2020-05-08","   1","   30","   0","  0","   29","   0"
"2248","inyo","2020-05-08","   1","   42","   4","  0","   41","   4"
"2249","merced","2020-05-08","   8","  242","   2","  5","  234","  -3"
"2250","fresno","2020-05-08","  81"," 2049","  89"," 19"," 1968","  70"
"2251","los angeles","2020-05-08","2276","23900","1181","617","21624"," 564"
"2252","santa clara","2020-05-08","  95"," 3306"," 180"," 34"," 3211"," 146"
"2253","el dorado","2020-05-08","   4","  171","   7","  0","  167","   7"
"2254","san joaquin","2020-05-08","  47"," 1366","  27"," 14"," 1319","  13"
"2255","humboldt","2020-05-08","   6","  352","   6","  0","  346","   6"
"2256","butte","2020-05-08","   2","  448","  23","  0","  446","  23"
"2257","shasta","2020-05-08","   0","  667","  15","  0","  667","  15"
"2258","san mateo","2020-05-08","  56"," 1096","  43"," 14"," 1040","  29"
"2259","plumas","2020-05-08","   0","   45","   0","  0","   45","   0"
"2260","ventura","2020-05-08","  54"," 1300","  52"," 19"," 1246","  33"
"2261","san benito","2020-05-08","   0","   25","   1","  0","   25","   1"
"2262","solano","2020-05-08","  33","  707","  48","  7","  674","  41"
"2263","sonoma","2020-05-08","  17","  871","  51","  5","  854","  46"
"2264","marin","2020-05-08","   7","  390","  11","  2","  383","   9"
"2265","alameda","2020-05-08"," 136"," 2446"," 126"," 46"," 2310","  80"
"2266","contra costa","2020-05-08","  82"," 1628","  99"," 21"," 1546","  78"
"2267","san francisco","2020-05-08"," 103"," 2619","  92"," 35"," 2516","  57"
"2268","placer","2020-05-08","  26","  753","  32","  3","  727","  29"
"2269","glenn","2020-05-08","   0","    0","   0","  0","    0","   0"
"2270","mono","2020-05-08","   0","   17","   2","  0","   17","   2"
"2271","san bernardino","2020-05-08"," 220"," 4821"," 166"," 63"," 4601"," 103"
"2272","nevada","2020-05-08","   0","  120","   7","  0","  120","   7"
"2273","yuba","2020-05-08","   0","  445","   6","  0","  445","   6"
"2274","colusa","2020-05-08","   2","   88","   5","  1","   86","   4"
"2275","trinity","2020-05-08","   0","   54","   0","  0","   54","   0"
"2276","lassen","2020-05-08","   1","   25","   0","  0","   24","   0"
"2277","santa cruz","2020-05-08","   4","  397","  14","  0","  393","  14"
"2278","monterey","2020-05-08","   9","  829"," 115","  3","  820"," 112"
"2279","santa barbara","2020-05-08","  36","  717","  86"," 13","  681","  73"
"2280","amador","2020-05-08","   0","   51","   2","  0","   51","   2"
"2281","imperial","2020-05-08","  70","  342","   9"," 19","  272"," -10"
"2282","sacramento","2020-05-08","  51"," 2332","  82"," 16"," 2281","  66"
"2283","riverside","2020-05-08"," 277"," 3902"," 158","104"," 3625","  54"
"2284","siskiyou","2020-05-08","   3","   65","   0","  2","   62","  -2"
"2285","san diego","2020-05-08"," 407"," 6156"," 328","144"," 5749"," 184"
"2286","sutter","2020-05-08","   0","   14","   0","  0","   14","   0"
"2287","tehama","2020-05-08","   0","  106","   2","  0","  106","   2"
"2288","tulare","2020-05-08","  26","  920","  20","  7","  894","  13"
"2289","del norte","2020-05-08","   1","   51","   2","  1","   50","   1"
"2290","san luis obispo","2020-05-08","   4","  526","  21","  3","  522","  18"
"2291","kings","2020-05-08","  15","  199","   0","  4","  184","  -4"
"2292","tuolumne","2020-05-08","   0","  151","   2","  0","  151","   2"
"2293","orange","2020-05-08"," 299"," 6836"," 338"," 99"," 6537"," 239"
"2294","calaveras","2020-05-08","   0","   50","  11","  0","   50","  11"
"2295","napa","2020-05-08","   1","  387","   2","  1","  386","   1"
"2296","kern","2020-05-08","  39"," 1726","  81"," 23"," 1687","  58"
"2297","madera","2020-05-08","   1","  530","  26","  0","  529","  26"
"2298","lake","2020-05-08","   1","  110","   2","  0","  109","   2"
"2299","stanislaus","2020-05-08","  36"," 1369","  81","  5"," 1333","  76"
"2300","mendocino","2020-05-08","   0","  180","   4","  0","  180","   4"
"2301","san diego","2020-05-09"," 396"," 6172"," 329","143"," 5776"," 186"
"2302","sonoma","2020-05-09","  15","  871","  50","  5","  856","  45"
"2303","imperial","2020-05-09","  70","  349","   9"," 19","  279"," -10"
"2304","santa clara","2020-05-09"," 102"," 3306"," 183"," 33"," 3204"," 150"
"2305","lassen","2020-05-09","   1","   25","   0","  0","   24","   0"
"2306","plumas","2020-05-09","   1","   45","   0","  0","   44","   0"
"2307","mendocino","2020-05-09","   0","  180","   4","  0","  180","   4"
"2308","solano","2020-05-09","  35","  707","  46","  9","  672","  37"
"2309","santa cruz","2020-05-09","   3","  397","  19","  0","  394","  19"
"2310","san francisco","2020-05-09","  97"," 2619","  97"," 32"," 2522","  65"
"2311","glenn","2020-05-09","   0","    0","   0","  0","    0","   0"
"2312","san bernardino","2020-05-09"," 231"," 4821"," 171"," 68"," 4590"," 103"
"2313","marin","2020-05-09","  13","  390","   6","  4","  377","   2"
"2314","madera","2020-05-09","   1","  530","  30","  0","  529","  30"
"2315","san joaquin","2020-05-09","  44"," 1366","  24"," 11"," 1322","  13"
"2316","shasta","2020-05-09","   0","  667","  17","  0","  667","  17"
"2317","stanislaus","2020-05-09","  29"," 1369","  82","  6"," 1340","  76"
"2318","alameda","2020-05-09"," 139"," 2446"," 122"," 51"," 2307","  71"
"2319","orange","2020-05-09"," 300"," 6836"," 321","104"," 6536"," 217"
"2320","butte","2020-05-09","   3","  448","  24","  2","  445","  22"
"2321","santa barbara","2020-05-09","  32","  717","  80"," 12","  685","  68"
"2322","lake","2020-05-09","   0","  110","   3","  0","  110","   3"
"2323","yuba","2020-05-09","   0","  445","   7","  0","  445","   7"
"2324","amador","2020-05-09","   0","   51","   2","  0","   51","   2"
"2325","tehama","2020-05-09","   0","  106","   2","  0","  106","   2"
"2326","humboldt","2020-05-09","   6","  352","   6","  0","  346","   6"
"2327","mariposa","2020-05-09","   1","   30","   0","  0","   29","   0"
"2328","merced","2020-05-09","  11","  242","   2","  6","  231","  -4"
"2329","calaveras","2020-05-09","   2","   50","   9","  1","   48","   8"
"2330","san luis obispo","2020-05-09","   6","  526","  27","  4","  520","  23"
"2331","contra costa","2020-05-09","  68"," 1628"," 104"," 20"," 1560","  84"
"2332","placer","2020-05-09","  37","  753","  40","  3","  716","  37"
"2333","sacramento","2020-05-09","  53"," 2327","  88"," 17"," 2274","  71"
"2334","nevada","2020-05-09","   0","  108","   4","  0","  108","   4"
"2335","riverside","2020-05-09"," 310"," 3874"," 159","103"," 3564","  56"
"2336","inyo","2020-05-09","   0","   42","   3","  0","   42","   3"
"2337","ventura","2020-05-09","  57"," 1321","  50"," 17"," 1264","  33"
"2338","colusa","2020-05-09","   0","   88","   6","  0","   88","   6"
"2339","kings","2020-05-09","  18","  199","   0","  4","  181","  -4"
"2340","napa","2020-05-09","   2","  387","   8","  1","  385","   7"
"2341","san mateo","2020-05-09","  58"," 1096","  40"," 16"," 1038","  24"
"2342","el dorado","2020-05-09","   4","  171","  11","  0","  167","  11"
"2343","kern","2020-05-09","  51"," 1728","  78"," 27"," 1677","  51"
"2344","monterey","2020-05-09","  10","  829"," 113","  3","  819"," 110"
"2345","san benito","2020-05-09","   0","   25","   3","  0","   25","   3"
"2346","yolo","2020-05-09","   0","  186","   1","  2","  186","  -1"
"2347","mono","2020-05-09","   0","   17","   2","  0","   17","   2"
"2348","tuolumne","2020-05-09","   0","  151","   3","  0","  151","   3"
"2349","tulare","2020-05-09","  30","  920","  27","  9","  890","  18"
"2350","del norte","2020-05-09","   0","   51","   0","  0","   51","   0"
"2351","sutter","2020-05-09","   0","   14","   0","  0","   14","   0"
"2352","trinity","2020-05-09","   0","   54","   0","  0","   54","   0"
"2353","modoc","2020-05-09","   0","   41","   0","  0","   41","   0"
"2354","los angeles","2020-05-09","2221","23877","1213","575","21656"," 638"
"2355","fresno","2020-05-09","  98"," 2049","  88"," 21"," 1951","  67"
"2356","siskiyou","2020-05-09","   0","   65","   4","  0","   65","   4"
"2357","riverside","2020-05-10"," 316"," 3856"," 177","102"," 3540","  75"
"2358","plumas","2020-05-10","   1","   45","   0","  0","   44","   0"
"2359","del norte","2020-05-10","   0","   51","   1","  0","   51","   1"
"2360","shasta","2020-05-10","   0","  667","   8","  1","  667","   7"
"2361","san joaquin","2020-05-10","  43"," 1366","  19"," 10"," 1323","   9"
"2362","siskiyou","2020-05-10","   0","   65","   4","  0","   65","   4"
"2363","alameda","2020-05-10"," 123"," 2446"," 125"," 44"," 2323","  81"
"2364","san mateo","2020-05-10","  52"," 1096","  43"," 17"," 1044","  26"
"2365","trinity","2020-05-10","   0","   54","   0","  0","   54","   0"
"2366","sutter","2020-05-10","   0","   14","   0","  0","   14","   0"
"2367","yolo","2020-05-10","   0","  186","   1","  2","  186","  -1"
"2368","yuba","2020-05-10","   0","  445","   6","  0","  445","   6"
"2369","tuolumne","2020-05-10","   0","  151","   2","  0","  151","   2"
"2370","tulare","2020-05-10","  29","  920","  26","  8","  891","  18"
"2371","lake","2020-05-10","   1","  110","   0","  0","  109","   0"
"2372","glenn","2020-05-10","   0","    0","   0","  0","    0","   0"
"2373","colusa","2020-05-10","   0","   88","   6","  0","   88","   6"
"2374","santa barbara","2020-05-10","  30","  717","  81"," 12","  687","  69"
"2375","lassen","2020-05-10","   1","   25","   0","  0","   24","   0"
"2376","san bernardino","2020-05-10"," 227"," 4821"," 188"," 65"," 4594"," 123"
"2377","inyo","2020-05-10","   0","   42","   3","  0","   42","   3"
"2378","sonoma","2020-05-10","  12","  871","  50","  4","  859","  46"
"2379","placer","2020-05-10","  27","  753","  34","  4","  726","  30"
"2380","sacramento","2020-05-10","  55"," 2310"," 105"," 18"," 2255","  87"
"2381","fresno","2020-05-10","  98"," 2056","  89"," 31"," 1958","  58"
"2382","imperial","2020-05-10","  64","  336","   9"," 17","  272","  -8"
"2383","mono","2020-05-10","   0","   17","   2","  0","   17","   2"
"2384","san luis obispo","2020-05-10","   5","  526","  24","  2","  521","  22"
"2385","nevada","2020-05-10","   1","  107","   5","  0","  106","   5"
"2386","butte","2020-05-10","   3","  448","  21","  1","  445","  20"
"2387","modoc","2020-05-10","   0","   41","   0","  0","   41","   0"
"2388","san francisco","2020-05-10","  91"," 2619"," 102"," 34"," 2528","  68"
"2389","contra costa","2020-05-10","  61"," 1628"," 110"," 16"," 1567","  94"
"2390","marin","2020-05-10","  17","  390","  11","  5","  373","   6"
"2391","santa cruz","2020-05-10","   3","  397","  16","  0","  394","  16"
"2392","madera","2020-05-10","   2","  530","  30","  0","  528","  30"
"2393","calaveras","2020-05-10","   0","   50","   9","  0","   50","   9"
"2394","ventura","2020-05-10","  52"," 1308","  49"," 17"," 1256","  32"
"2395","mendocino","2020-05-10","   0","  180","   4","  0","  180","   4"
"2396","santa clara","2020-05-10"," 111"," 3306"," 179"," 32"," 3195"," 147"
"2397","tehama","2020-05-10","   0","  106","   3","  0","  106","   3"
"2398","merced","2020-05-10","   6","  242","   4","  4","  236","   0"
"2399","amador","2020-05-10","   0","   51","   2","  0","   51","   2"
"2400","orange","2020-05-10"," 308"," 6836"," 353","102"," 6528"," 251"
"2401","los angeles","2020-05-10","2270","23858","1253","588","21588"," 665"
"2402","san diego","2020-05-10"," 390"," 6056"," 357","142"," 5666"," 215"
"2403","monterey","2020-05-10","   9","  829"," 108","  3","  820"," 105"
"2404","solano","2020-05-10","  36","  707","  48","  9","  671","  39"
"2405","stanislaus","2020-05-10","  27"," 1369","  80","  4"," 1342","  76"
"2406","kern","2020-05-10","  51"," 1728","  96"," 29"," 1677","  67"
"2407","humboldt","2020-05-10","   6","  352","   3","  0","  346","   3"
"2408","napa","2020-05-10","   2","  387","   3","  2","  385","   1"
"2409","el dorado","2020-05-10","   2","  171","  15","  0","  169","  15"
"2410","san benito","2020-05-10","   0","   25","   1","  0","   25","   1"
"2411","mariposa","2020-05-10","   0","   30","   0","  0","   30","   0"
"2412","kings","2020-05-10","  17","  199","   3","  4","  182","  -1"
"2413","lassen","2020-05-11","   1","   25","   0","  0","   24","   0"
"2414","yuba","2020-05-11","   1","  445","   9","  1","  444","   8"
"2415","humboldt","2020-05-11","   8","  352","   5","  0","  344","   5"
"2416","el dorado","2020-05-11","   3","  171","   8","  0","  168","   8"
"2417","inyo","2020-05-11","   1","   42","   3","  0","   41","   3"
"2418","tuolumne","2020-05-11","   1","  151","   2","  0","  150","   2"
"2419","san benito","2020-05-11","   1","   25","   2","  0","   24","   2"
"2420","nevada","2020-05-11","   1","  114","   7","  1","  113","   6"
"2421","alameda","2020-05-11"," 131"," 2446"," 125"," 49"," 2315","  76"
"2422","calaveras","2020-05-11","   1","   50","   8","  1","   49","   7"
"2423","stanislaus","2020-05-11","  35"," 1374","  74","  8"," 1339","  66"
"2424","glenn","2020-05-11","   0","    0","   0","  0","    0","   0"
"2425","solano","2020-05-11","  28","  707","  45"," 12","  679","  33"
"2426","marin","2020-05-11","  15","  390","  12","  2","  375","  10"
"2427","fresno","2020-05-11","  93"," 2057","  87"," 30"," 1964","  57"
"2428","placer","2020-05-11","  24","  753","  36","  4","  729","  32"
"2429","yolo","2020-05-11","   0","  186","   4","  0","  186","   4"
"2430","san joaquin","2020-05-11","  30"," 1366","  34","  7"," 1336","  27"
"2431","san bernardino","2020-05-11"," 218"," 4821"," 178"," 65"," 4603"," 113"
"2432","contra costa","2020-05-11","  54"," 1628"," 105"," 18"," 1574","  87"
"2433","santa cruz","2020-05-11","   1","  397","  16","  0","  396","  16"
"2434","san diego","2020-05-11"," 400"," 6089"," 374","144"," 5689"," 230"
"2435","orange","2020-05-11"," 320"," 6836"," 362","110"," 6516"," 252"
"2436","kern","2020-05-11","  43"," 1724","  77"," 28"," 1681","  49"
"2437","santa barbara","2020-05-11","  32","  717","  89"," 12","  685","  77"
"2438","san mateo","2020-05-11","  49"," 1096","  43"," 17"," 1047","  26"
"2439","amador","2020-05-11","   0","   51","   2","  0","   51","   2"
"2440","modoc","2020-05-11","   0","   41","   0","  0","   41","   0"
"2441","madera","2020-05-11","   1","  528","  27","  0","  527","  27"
"2442","colusa","2020-05-11","   0","   88","   6","  0","   88","   6"
"2443","lake","2020-05-11","   0","  110","   5","  0","  110","   5"
"2444","monterey","2020-05-11","   9","  829"," 109","  5","  820"," 104"
"2445","tehama","2020-05-11","   0","  106","   6","  0","  106","   6"
"2446","imperial","2020-05-11","  62","  323","  10"," 17","  261","  -7"
"2447","mono","2020-05-11","   0","   17","   2","  0","   17","   2"
"2448","sutter","2020-05-11","   0","   14","   0","  0","   14","   0"
"2449","sacramento","2020-05-11","  51"," 2335","  93"," 14"," 2284","  79"
"2450","san francisco","2020-05-11","  91"," 2619"," 107"," 34"," 2528","  73"
"2451","merced","2020-05-11","   9","  242","   7","  6","  233","   1"
"2452","del norte","2020-05-11","   0","   51","   0","  0","   51","   0"
"2453","napa","2020-05-11","   1","  387","  13","  1","  386","  12"
"2454","tulare","2020-05-11","  35","  920","  20"," 10","  885","  10"
"2455","mariposa","2020-05-11","   0","   30","   0","  0","   30","   0"
"2456","plumas","2020-05-11","   1","   45","   0","  0","   44","   0"
"2457","trinity","2020-05-11","   0","   54","   0","  0","   54","   0"
"2458","san luis obispo","2020-05-11","   5","  526","  22","  3","  521","  19"
"2459","kings","2020-05-11","  17","  199","   4","  4","  182","   0"
"2460","ventura","2020-05-11","  54"," 1301","  48"," 19"," 1247","  29"
"2461","mendocino","2020-05-11","   0","  180","   5","  0","  180","   5"
"2462","siskiyou","2020-05-11","   0","   65","   5","  0","   65","   5"
"2463","shasta","2020-05-11","   0","  667","   9","  0","  667","   9"
"2464","riverside","2020-05-11"," 290"," 3935"," 184","103"," 3645","  81"
"2465","santa clara","2020-05-11"," 100"," 3306"," 193"," 34"," 3206"," 159"
"2466","los angeles","2020-05-11","2310","23866","1242","584","21556"," 658"
"2467","butte","2020-05-11","   3","  448","  25","  0","  445","  25"
"2468","sonoma","2020-05-11","  14","  871","  50","  6","  857","  44"
"2469","mono","2020-05-12","   0","   17","   2","  0","   17","   2"
"2470","el dorado","2020-05-12","   2","  199","  10","  0","  197","  10"
"2471","san mateo","2020-05-12","  63"," 1096","  35"," 20"," 1033","  15"
"2472","mariposa","2020-05-12","   1","   30","   0","  0","   29","   0"
"2473","inyo","2020-05-12","   0","   42","   4","  0","   42","   4"
"2474","san luis obispo","2020-05-12","   8","  526","  28","  3","  518","  25"
"2475","monterey","2020-05-12","   7","  829"," 106","  5","  822"," 101"
"2476","los angeles","2020-05-12","2248","23941","1267","583","21693"," 684"
"2477","imperial","2020-05-12","  63","  330","   8"," 19","  267"," -11"
"2478","nevada","2020-05-12","   0","  111","   5","  1","  111","   4"
"2479","santa barbara","2020-05-12","  29","  717","  83"," 11","  688","  72"
"2480","siskiyou","2020-05-12","   0","   65","   3","  1","   65","   2"
"2481","san joaquin","2020-05-12","  34"," 1366","  26","  8"," 1332","  18"
"2482","del norte","2020-05-12","   0","   51","   1","  0","   51","   1"
"2483","sutter","2020-05-12","   0","   14","   0","  0","   14","   0"
"2484","calaveras","2020-05-12","   0","   50","   8","  0","   50","   8"
"2485","placer","2020-05-12","  27","  753","  32","  5","  726","  27"
"2486","stanislaus","2020-05-12","  34"," 1369","  81","  3"," 1335","  78"
"2487","lassen","2020-05-12","   0","   25","   0","  0","   25","   0"
"2488","san benito","2020-05-12","   1","   25","   2","  0","   24","   2"
"2489","merced","2020-05-12","  11","  242","   5","  5","  231","   0"
"2490","san bernardino","2020-05-12"," 197"," 4821"," 180"," 58"," 4624"," 122"
"2491","ventura","2020-05-12","  51"," 1319","  42"," 22"," 1268","  20"
"2492","trinity","2020-05-12","   0","   54","   0","  0","   54","   0"
"2493","tehama","2020-05-12","   0","  106","   6","  0","  106","   6"
"2494","kings","2020-05-12","  20","  199","   0","  4","  179","  -4"
"2495","plumas","2020-05-12","   0","   45","   0","  0","   45","   0"
"2496","san diego","2020-05-12"," 385"," 6136"," 357","142"," 5751"," 215"
"2497","marin","2020-05-12","  21","  390","  13","  1","  369","  12"
"2498","fresno","2020-05-12"," 110"," 2061","  84"," 23"," 1951","  61"
"2499","napa","2020-05-12","   1","  387","   6","  1","  386","   5"
"2500","san francisco","2020-05-12","  90"," 2619"," 100"," 27"," 2529","  73"
"2501","contra costa","2020-05-12","  66"," 1628"," 121"," 19"," 1562"," 102"
"2502","tuolumne","2020-05-12","   0","  151","   3","  0","  151","   3"
"2503","yuba","2020-05-12","   1","  445","  11","  1","  444","  10"
"2504","mendocino","2020-05-12","   0","  180","   4","  0","  180","   4"
"2505","yolo","2020-05-12","   0","  186","   5","  0","  186","   5"
"2506","lake","2020-05-12","   1","  110","   1","  1","  109","   0"
"2507","humboldt","2020-05-12","   8","  352","   6","  0","  344","   6"
"2508","santa clara","2020-05-12","  84"," 3306"," 180"," 29"," 3222"," 151"
"2509","sonoma","2020-05-12","  28","  871","  49","  8","  843","  41"
"2510","tulare","2020-05-12","  34","  920","  17"," 11","  886","   6"
"2511","kern","2020-05-12","  52"," 1729","  72"," 29"," 1677","  43"
"2512","amador","2020-05-12","   0","   51","   1","  0","   51","   1"
"2513","santa cruz","2020-05-12","   1","  397","  11","  0","  396","  11"
"2514","madera","2020-05-12","   0","  528","  31","  0","  528","  31"
"2515","sacramento","2020-05-12","  48"," 2373","  94"," 13"," 2325","  81"
"2516","shasta","2020-05-12","   0","  667","   9","  0","  667","   9"
"2517","orange","2020-05-12"," 348"," 6836"," 358","102"," 6488"," 256"
"2518","colusa","2020-05-12","   1","   88","   5","  1","   87","   4"
"2519","glenn","2020-05-12","   0","    0","   0","  0","    0","   0"
"2520","solano","2020-05-12","  29","  707","  48"," 15","  678","  33"
"2521","modoc","2020-05-12","   0","   41","   0","  0","   41","   0"
"2522","alameda","2020-05-12"," 130"," 2446"," 116"," 46"," 2316","  70"
"2523","butte","2020-05-12","   5","  448","  25","  1","  443","  24"
"2524","riverside","2020-05-12"," 306"," 3924"," 172"," 96"," 3618","  76"
"2525","placer","2020-05-13","  30","  753","  37","  4","  723","  33"
"2526","marin","2020-05-13","  19","  390","  16","  1","  371","  15"
"2527","kern","2020-05-13","  40"," 1718","  73"," 28"," 1678","  45"
"2528","fresno","2020-05-13"," 129"," 2051","  78"," 23"," 1922","  55"
"2529","sacramento","2020-05-13","  50"," 2371"," 105","  9"," 2321","  96"
"2530","san diego","2020-05-13"," 380"," 6144"," 346","146"," 5764"," 200"
"2531","contra costa","2020-05-13","  60"," 1628"," 108"," 15"," 1568","  93"
"2532","madera","2020-05-13","   0","  528","  26","  0","  528","  26"
"2533","mono","2020-05-13","   0","   17","   2","  0","   17","   2"
"2534","siskiyou","2020-05-13","   1","   65","   5","  0","   64","   5"
"2535","mendocino","2020-05-13","   0","  180","   2","  0","  180","   2"
"2536","modoc","2020-05-13","   0","   41","   0","  0","   41","   0"
"2537","orange","2020-05-13"," 342"," 7007"," 393","127"," 6665"," 266"
"2538","inyo","2020-05-13","   0","   42","   4","  0","   42","   4"
"2539","alameda","2020-05-13"," 140"," 2446"," 117"," 49"," 2306","  68"
"2540","san benito","2020-05-13","   1","   25","   1","  1","   24","   0"
"2541","san francisco","2020-05-13","  89"," 2619"," 108"," 31"," 2530","  77"
"2542","riverside","2020-05-13"," 265"," 4002"," 180"," 88"," 3737","  92"
"2543","san bernardino","2020-05-13"," 223"," 4821"," 153"," 59"," 4598","  94"
"2544","san joaquin","2020-05-13","  27"," 1366","  32","  5"," 1339","  27"
"2545","glenn","2020-05-13","   0","    0","   0","  0","    0","   0"
"2546","santa clara","2020-05-13","  91"," 3306"," 194"," 27"," 3215"," 167"
"2547","lassen","2020-05-13","   0","   25","   0","  0","   25","   0"
"2548","imperial","2020-05-13","  65","  317","   8"," 19","  252"," -11"
"2549","sonoma","2020-05-13","  25","  871","  53","  4","  846","  49"
"2550","los angeles","2020-05-13","2351","23951","1253","587","21600"," 666"
"2551","calaveras","2020-05-13","   0","   50","  11","  0","   50","  11"
"2552","san mateo","2020-05-13","  69"," 1096","  38"," 19"," 1027","  19"
"2553","butte","2020-05-13","   5","  448","  19","  2","  443","  17"
"2554","shasta","2020-05-13","   0","  667","   5","  0","  667","   5"
"2555","solano","2020-05-13","  34","  707","  41"," 11","  673","  30"
"2556","humboldt","2020-05-13","   8","  352","   5","  2","  344","   3"
"2557","stanislaus","2020-05-13","  31"," 1369","  79","  3"," 1338","  76"
"2558","santa cruz","2020-05-13","   1","  397","  15","  0","  396","  15"
"2559","el dorado","2020-05-13","   2","  199","  11","  0","  197","  11"
"2560","plumas","2020-05-13","   0","   45","   0","  0","   45","   0"
"2561","napa","2020-05-13","   1","  487","  10","  0","  486","  10"
"2562","ventura","2020-05-13","  54"," 1312","  37"," 23"," 1258","  14"
"2563","colusa","2020-05-13","   1","   88","   5","  1","   87","   4"
"2564","kings","2020-05-13","  20","  199","   0","  4","  179","  -4"
"2565","sutter","2020-05-13","   0","   14","   0","  0","   14","   0"
"2566","nevada","2020-05-13","   0","  112","   7","  1","  112","   6"
"2567","tehama","2020-05-13","   0","  106","   5","  0","  106","   5"
"2568","merced","2020-05-13","  11","  242","  10","  4","  231","   6"
"2569","del norte","2020-05-13","   0","   51","   3","  0","   51","   3"
"2570","yuba","2020-05-13","   0","  445","  12","  0","  445","  12"
"2571","santa barbara","2020-05-13","  29","  717","  67"," 11","  688","  56"
"2572","tulare","2020-05-13","  40","  920","  22"," 10","  880","  12"
"2573","tuolumne","2020-05-13","   0","  151","   5","  0","  151","   5"
"2574","san luis obispo","2020-05-13","  10","  526","  24","  3","  516","  21"
"2575","monterey","2020-05-13","   9","  829"," 106","  5","  820"," 101"
"2576","mariposa","2020-05-13","   1","   30","   0","  0","   29","   0"
"2577","lake","2020-05-13","   0","  110","   2","  1","  110","   1"
"2578","amador","2020-05-13","   0","   51","   1","  0","   51","   1"
"2579","yolo","2020-05-13","   1","  186","   6","  1","  185","   5"
"2580","trinity","2020-05-13","   0","   54","   0","  0","   54","   0"
"2581","placer","2020-05-14","  23","  753","  29","  3","  730","  26"
"2582","amador","2020-05-14","   0","   51","   0","  0","   51","   0"
"2583","sonoma","2020-05-14","  28","  871","  51","  6","  843","  45"
"2584","san francisco","2020-05-14","  94"," 2619"," 111"," 30"," 2525","  81"
"2585","merced","2020-05-14","   9","  242","   5","  5","  233","   0"
"2586","yuba","2020-05-14","   0","  445","  10","  0","  445","  10"
"2587","yolo","2020-05-14","   0","  186","   3","  0","  186","   3"
"2588","santa cruz","2020-05-14","   1","  397","  13","  0","  396","  13"
"2589","sacramento","2020-05-14","  52"," 2393","  91"," 16"," 2341","  75"
"2590","marin","2020-05-14","  12","  390","  12","  2","  378","  10"
"2591","contra costa","2020-05-14","  67"," 1628"," 121"," 12"," 1561"," 109"
"2592","solano","2020-05-14","  40","  707","  47"," 10","  667","  37"
"2593","glenn","2020-05-14","   0","    0","   0","  0","    0","   0"
"2594","siskiyou","2020-05-14","   1","   65","   4","  0","   64","   4"
"2595","el dorado","2020-05-14","   3","  199","  11","  0","  196","  11"
"2596","trinity","2020-05-14","   0","   54","   0","  0","   54","   0"
"2597","ventura","2020-05-14","  58"," 1340","  48"," 27"," 1282","  21"
"2598","mariposa","2020-05-14","   1","   30","   0","  0","   29","   0"
"2599","sutter","2020-05-14","   0","   14","   0","  0","   14","   0"
"2600","san benito","2020-05-14","   1","   25","   1","  1","   24","   0"
"2601","orange","2020-05-14"," 327"," 7007"," 385","116"," 6680"," 269"
"2602","san joaquin","2020-05-14","  36"," 1366","  27"," 13"," 1330","  14"
"2603","santa clara","2020-05-14","  91"," 3306"," 172"," 25"," 3215"," 147"
"2604","san diego","2020-05-14"," 399"," 6151"," 354","155"," 5752"," 199"
"2605","san mateo","2020-05-14","  44"," 1096","  45"," 12"," 1052","  33"
"2606","plumas","2020-05-14","   0","   45","   0","  0","   45","   0"
"2607","stanislaus","2020-05-14","  38"," 1369","  85","  3"," 1331","  82"
"2608","calaveras","2020-05-14","   0","   50","  10","  0","   50","  10"
"2609","inyo","2020-05-14","   0","   42","   4","  0","   42","   4"
"2610","lassen","2020-05-14","   0","   25","   0","  0","   25","   0"
"2611","del norte","2020-05-14","   0","   51","   5","  0","   51","   5"
"2612","san bernardino","2020-05-14"," 229"," 4821"," 182"," 62"," 4592"," 120"
"2613","lake","2020-05-14","   0","  110","   2","  0","  110","   2"
"2614","monterey","2020-05-14","   7","  829"," 104","  5","  822","  99"
"2615","fresno","2020-05-14"," 116"," 2134","  82"," 23"," 2018","  59"
"2616","nevada","2020-05-14","   0","  110","   7","  1","  110","   6"
"2617","modoc","2020-05-14","   0","   41","   0","  0","   41","   0"
"2618","mendocino","2020-05-14","   0","  180","   3","  0","  180","   3"
"2619","kern","2020-05-14","  44"," 1721","  58"," 23"," 1677","  35"
"2620","napa","2020-05-14","   1","  487","  10","  0","  486","  10"
"2621","shasta","2020-05-14","   0","  667","   8","  0","  667","   8"
"2622","tulare","2020-05-14","  37","  920","  21"," 10","  883","  11"
"2623","mono","2020-05-14","   0","   17","   2","  0","   17","   2"
"2624","butte","2020-05-14","   3","  448","  19","  0","  445","  19"
"2625","riverside","2020-05-14"," 275"," 4015"," 180"," 94"," 3740","  86"
"2626","colusa","2020-05-14","   0","   88","   6","  0","   88","   6"
"2627","santa barbara","2020-05-14","  30","  717","  64"," 12","  687","  52"
"2628","tuolumne","2020-05-14","   0","  151","   5","  0","  151","   5"
"2629","kings","2020-05-14","  18","  199","   2","  4","  181","  -2"
"2630","madera","2020-05-14","   0","  528","  29","  0","  528","  29"
"2631","san luis obispo","2020-05-14","   5","  526","  21","  1","  521","  20"
"2632","alameda","2020-05-14"," 138"," 2446"," 118"," 50"," 2308","  68"
"2633","humboldt","2020-05-14","  12","  352","   3","  2","  340","   1"
"2634","imperial","2020-05-14","  71","  327","   6"," 20","  256"," -14"
"2635","los angeles","2020-05-14","2207","23919","1230","581","21712"," 649"
"2636","tehama","2020-05-14","   1","  106","   5","  0","  105","   5"
"2637","lassen","2020-05-15","   0","   25","   0","  0","   25","   0"
"2638","san francisco","2020-05-15","  89"," 2619","  85"," 23"," 2530","  62"
"2639","shasta","2020-05-15","   0","  667","   7","  0","  667","   7"
"2640","mariposa","2020-05-15","   0","   30","   0","  0","   30","   0"
"2641","riverside","2020-05-15"," 256"," 4015"," 182"," 92"," 3759","  90"
"2642","mono","2020-05-15","   0","   17","   2","  0","   17","   2"
"2643","imperial","2020-05-15","  71","  262","   0"," 20","  191"," -20"
"2644","madera","2020-05-15","   1","  528","  29","  0","  527","  29"
"2645","kings","2020-05-15","  22","  199","   4","  3","  177","   1"
"2646","sacramento","2020-05-15","  55"," 2410"," 100"," 13"," 2355","  87"
"2647","marin","2020-05-15","  10","  390","  11","  1","  380","  10"
"2648","san luis obispo","2020-05-15","   5","  526","  22","  3","  521","  19"
"2649","sutter","2020-05-15","   0","   14","   0","  0","   14","   0"
"2650","lake","2020-05-15","   0","  110","   2","  0","  110","   2"
"2651","merced","2020-05-15","   8","  242","   7","  4","  234","   3"
"2652","napa","2020-05-15","   1","  387","   6","  1","  386","   5"
"2653","glenn","2020-05-15","   0","    0","   0","  0","    0","   0"
"2654","del norte","2020-05-15","   0","   51","   2","  0","   51","   2"
"2655","monterey","2020-05-15","   7","  829"," 109","  5","  822"," 104"
"2656","plumas","2020-05-15","   0","   45","   0","  0","   45","   0"
"2657","san bernardino","2020-05-15"," 194"," 4821"," 168"," 65"," 4627"," 103"
"2658","tuolumne","2020-05-15","   0","  151","   3","  0","  151","   3"
"2659","santa barbara","2020-05-15","  32","  717","  64"," 14","  685","  50"
"2660","contra costa","2020-05-15","  56"," 1628"," 114"," 16"," 1572","  98"
"2661","modoc","2020-05-15","   0","   41","   0","  0","   41","   0"
"2662","sonoma","2020-05-15","  39","  871","  51","  4","  832","  47"
"2663","tulare","2020-05-15","  39","  920","  15","  9","  881","   6"
"2664","san joaquin","2020-05-15","  45"," 1366","  28"," 16"," 1321","  12"
"2665","los angeles","2020-05-15","2201","23901","1229","571","21700"," 658"
"2666","inyo","2020-05-15","   0","   42","   4","  0","   42","   4"
"2667","nevada","2020-05-15","   0","  119","   7","  1","  119","   6"
"2668","san diego","2020-05-15"," 392"," 6126"," 332","151"," 5734"," 181"
"2669","san benito","2020-05-15","   1","   25","   1","  1","   24","   0"
"2670","trinity","2020-05-15","   0","   54","   0","  0","   54","   0"
"2671","yolo","2020-05-15","   0","  186","   3","  0","  186","   3"
"2672","fresno","2020-05-15","  91"," 2128","  81"," 18"," 2037","  63"
"2673","tehama","2020-05-15","   1","  106","   4","  1","  105","   3"
"2674","solano","2020-05-15","  40","  707","  50","  9","  667","  41"
"2675","santa cruz","2020-05-15","   1","  397","  13","  0","  396","  13"
"2676","humboldt","2020-05-15","   9","  352","   6","  1","  343","   5"
"2677","yuba","2020-05-15","   0","  445","  12","  0","  445","  12"
"2678","amador","2020-05-15","   0","   51","   0","  0","   51","   0"
"2679","santa clara","2020-05-15","  75"," 3318"," 164"," 25"," 3243"," 139"
"2680","orange","2020-05-15"," 310"," 7007"," 339","124"," 6697"," 215"
"2681","san mateo","2020-05-15","  54"," 1096","  40"," 16"," 1042","  24"
"2682","ventura","2020-05-15","  47"," 1340","  54"," 19"," 1293","  35"
"2683","colusa","2020-05-15","   0","   88","   6","  0","   88","   6"
"2684","calaveras","2020-05-15","   1","   50","  10","  1","   49","   9"
"2685","placer","2020-05-15","  29","  753","  32","  5","  724","  27"
"2686","butte","2020-05-15","   4","  448","  14","  1","  444","  13"
"2687","siskiyou","2020-05-15","   0","   65","   5","  0","   65","   5"
"2688","kern","2020-05-15","  52"," 1721","  82"," 18"," 1669","  64"
"2689","alameda","2020-05-15"," 148"," 2446"," 117"," 57"," 2298","  60"
"2690","mendocino","2020-05-15","   0","  180","   4","  0","  180","   4"
"2691","el dorado","2020-05-15","   0","  199","  10","  0","  199","  10"
"2692","stanislaus","2020-05-15","  38"," 1369","  80","  5"," 1331","  75"
"2693","colusa","2020-05-16","   0","   88","   6","  0","   88","   6"
"2694","los angeles","2020-05-16","2086","23918","1207","563","21832"," 644"
"2695","san bernardino","2020-05-16"," 201"," 4821"," 145"," 67"," 4620","  78"
"2696","el dorado","2020-05-16","   4","  199","   8","  1","  195","   7"
"2697","mariposa","2020-05-16","   0","   30","   0","  0","   30","   0"
"2698","placer","2020-05-16","  28","  753","  38","  7","  725","  31"
"2699","modoc","2020-05-16","   0","   41","   0","  0","   41","   0"
"2700","santa cruz","2020-05-16","   1","  397","  15","  0","  396","  15"
"2701","fresno","2020-05-16","  97"," 2139","  85"," 20"," 2042","  65"
"2702","san joaquin","2020-05-16","  30"," 1366","  21"," 12"," 1336","   9"
"2703","mendocino","2020-05-16","   0","  180","   5","  0","  180","   5"
"2704","siskiyou","2020-05-16","   1","   65","   3","  1","   64","   2"
"2705","plumas","2020-05-16","   0","   45","   0","  0","   45","   0"
"2706","butte","2020-05-16","   3","  448","  20","  1","  445","  19"
"2707","yolo","2020-05-16","   1","  186","   2","  0","  185","   2"
"2708","napa","2020-05-16","   4","  387","   6","  1","  383","   5"
"2709","mono","2020-05-16","   0","   17","   2","  0","   17","   2"
"2710","humboldt","2020-05-16","   7","  352","   5","  1","  345","   4"
"2711","lake","2020-05-16","   0","  110","   2","  0","  110","   2"
"2712","tuolumne","2020-05-16","   0","  151","   6","  0","  151","   6"
"2713","kern","2020-05-16","  51"," 1713","  77"," 19"," 1662","  58"
"2714","del norte","2020-05-16","   0","   51","   2","  0","   51","   2"
"2715","san luis obispo","2020-05-16","   6","  526","  25","  2","  520","  23"
"2716","san diego","2020-05-16"," 370"," 6144"," 326","153"," 5774"," 173"
"2717","santa clara","2020-05-16","  90"," 3318"," 177"," 28"," 3228"," 149"
"2718","orange","2020-05-16"," 325"," 7007"," 345","121"," 6682"," 224"
"2719","sacramento","2020-05-16","  46"," 2370"," 100"," 12"," 2324","  88"
"2720","glenn","2020-05-16","   0","    0","   0","  0","    0","   0"
"2721","riverside","2020-05-16"," 266"," 3957"," 194"," 85"," 3691"," 109"
"2722","marin","2020-05-16","  11","  390","  15","  0","  379","  15"
"2723","alameda","2020-05-16"," 145"," 2446"," 114"," 50"," 2301","  64"
"2724","monterey","2020-05-16","   9","  811"," 104","  4","  802"," 100"
"2725","nevada","2020-05-16","   0","  113","   7","  2","  113","   5"
"2726","ventura","2020-05-16","  50"," 1333","  47"," 21"," 1283","  26"
"2727","santa barbara","2020-05-16","  34","  717","  63"," 15","  683","  48"
"2728","kings","2020-05-16","  22","  199","   2","  3","  177","  -1"
"2729","san francisco","2020-05-16","  74"," 2619"," 106"," 24"," 2545","  82"
"2730","san benito","2020-05-16","   1","   25","   2","  1","   24","   1"
"2731","amador","2020-05-16","   0","   51","   2","  0","   51","   2"
"2732","merced","2020-05-16","   7","  242","   4","  5","  235","  -1"
"2733","sonoma","2020-05-16","  36","  871","  54","  2","  835","  52"
"2734","imperial","2020-05-16","  61","  260","   8"," 18","  199"," -10"
"2735","shasta","2020-05-16","   0","  667","   7","  0","  667","   7"
"2736","tulare","2020-05-16","  41","  920","  14"," 10","  879","   4"
"2737","trinity","2020-05-16","   0","   54","   0","  0","   54","   0"
"2738","calaveras","2020-05-16","   0","   50","  10","  0","   50","  10"
"2739","san mateo","2020-05-16","  54"," 1096","  43"," 14"," 1042","  29"
"2740","solano","2020-05-16","  40","  707","  46"," 10","  667","  36"
"2741","contra costa","2020-05-16","  50"," 1628"," 105"," 17"," 1578","  88"
"2742","yuba","2020-05-16","   0","  445","  11","  0","  445","  11"
"2743","stanislaus","2020-05-16","  39"," 1369","  82","  3"," 1330","  79"
"2744","inyo","2020-05-16","   0","   42","   4","  0","   42","   4"
"2745","lassen","2020-05-16","   0","   25","   0","  0","   25","   0"
"2746","madera","2020-05-16","   0","  528","  28","  0","  528","  28"
"2747","sutter","2020-05-16","   0","   14","   0","  0","   14","   0"
"2748","tehama","2020-05-16","   0","  106","   4","  0","  106","   4"
"2749","yuba","2020-05-17","   1","  445","  10","  0","  444","  10"
"2750","kings","2020-05-17","  25","  199","   5","  5","  174","   0"
"2751","colusa","2020-05-17","   0","   88","   6","  0","   88","   6"
"2752","san bernardino","2020-05-17"," 210"," 4821"," 184"," 67"," 4611"," 117"
"2753","trinity","2020-05-17","   0","   54","   0","  0","   54","   0"
"2754","amador","2020-05-17","   0","   51","   1","  0","   51","   1"
"2755","kern","2020-05-17","  48"," 1743","  71"," 18"," 1695","  53"
"2756","santa clara","2020-05-17","  82"," 3318"," 192"," 25"," 3236"," 167"
"2757","lassen","2020-05-17","   0","   25","   0","  0","   25","   0"
"2758","placer","2020-05-17","  27","  753","  38","  7","  726","  31"
"2759","del norte","2020-05-17","   0","   51","   3","  0","   51","   3"
"2760","inyo","2020-05-17","   0","   42","   4","  0","   42","   4"
"2761","san benito","2020-05-17","   1","   25","   1","  1","   24","   0"
"2762","calaveras","2020-05-17","   0","   50","  11","  0","   50","  11"
"2763","imperial","2020-05-17","  71","  268","   5"," 18","  197"," -13"
"2764","san diego","2020-05-17"," 380"," 6131"," 364","150"," 5751"," 214"
"2765","orange","2020-05-17"," 355"," 7007"," 341","135"," 6652"," 206"
"2766","los angeles","2020-05-17","2107","23854","1233","575","21747"," 658"
"2767","shasta","2020-05-17","   0","  667","   6","  1","  667","   5"
"2768","lake","2020-05-17","   0","  110","   1","  0","  110","   1"
"2769","tehama","2020-05-17","   0","  106","   3","  0","  106","   3"
"2770","sacramento","2020-05-17","  56"," 2350"," 107"," 14"," 2294","  93"
"2771","humboldt","2020-05-17","   5","  352","   6","  1","  347","   5"
"2772","el dorado","2020-05-17","   4","  199","  11","  2","  195","   9"
"2773","glenn","2020-05-17","   0","    0","   0","  0","    0","   0"
"2774","butte","2020-05-17","   2","  448","  22","  1","  446","  21"
"2775","fresno","2020-05-17"," 106"," 2133","  94"," 28"," 2027","  66"
"2776","tuolumne","2020-05-17","   0","  151","   3","  0","  151","   3"
"2777","riverside","2020-05-17"," 277"," 3945"," 187"," 86"," 3668"," 101"
"2778","san francisco","2020-05-17","  71"," 2619"," 101"," 23"," 2548","  78"
"2779","contra costa","2020-05-17","  55"," 1628"," 110"," 18"," 1573","  92"
"2780","modoc","2020-05-17","   1","   41","   0","  0","   40","   0"
"2781","napa","2020-05-17","   3","  387","   6","  1","  384","   5"
"2782","san mateo","2020-05-17","  55"," 1096","  40"," 15"," 1041","  25"
"2783","mendocino","2020-05-17","   1","  180","   4","  1","  179","   3"
"2784","solano","2020-05-17","  47","  707","  46"," 10","  660","  36"
"2785","alameda","2020-05-17"," 146"," 2446"," 125"," 53"," 2300","  72"
"2786","nevada","2020-05-17","   0","  117","   7","  1","  117","   6"
"2787","monterey","2020-05-17","  10","  811"," 102","  4","  801","  98"
"2788","ventura","2020-05-17","  44"," 1314","  45"," 13"," 1270","  32"
"2789","santa barbara","2020-05-17","  31","  717","  62"," 16","  686","  46"
"2790","merced","2020-05-17","   9","  242","   4","  5","  233","  -1"
"2791","tulare","2020-05-17","  41","  881","  14"," 10","  840","   4"
"2792","madera","2020-05-17","   0","  528","  53","  0","  528","  53"
"2793","yolo","2020-05-17","   0","  186","   1","  2","  186","  -1"
"2794","marin","2020-05-17","  12","  390","  15","  0","  378","  15"
"2795","mariposa","2020-05-17","   1","   30","   0","  0","   29","   0"
"2796","mono","2020-05-17","   0","   17","   2","  0","   17","   2"
"2797","stanislaus","2020-05-17","  41"," 1369","  85","  3"," 1328","  82"
"2798","siskiyou","2020-05-17","   1","   65","   3","  1","   64","   2"
"2799","sutter","2020-05-17","   0","   14","   0","  0","   14","   0"
"2800","sonoma","2020-05-17","  31","  871","  55","  3","  840","  52"
"2801","santa cruz","2020-05-17","   1","  397","  15","  0","  396","  15"
"2802","plumas","2020-05-17","   0","   45","   0","  0","   45","   0"
"2803","san luis obispo","2020-05-17","   5","  526","  21","  2","  521","  19"
"2804","san joaquin","2020-05-17","  28"," 1366","  21"," 10"," 1338","  11"
"2805","yuba","2020-05-18","   1","  445","  13","  0","  444","  13"
"2806","shasta","2020-05-18","   0","  667","   5","  0","  667","   5"
"2807","santa clara","2020-05-18","  79"," 3318"," 201"," 22"," 3239"," 179"
"2808","sonoma","2020-05-18","  23","  871","  53","  4","  848","  49"
"2809","el dorado","2020-05-18","   4","  199","  13","  2","  195","  11"
"2810","lassen","2020-05-18","   1","   25","   0","  0","   24","   0"
"2811","tulare","2020-05-18","  36","  920","  29"," 10","  884","  19"
"2812","sutter","2020-05-18","   0","   14","   0","  0","   14","   0"
"2813","nevada","2020-05-18","   0","  107","   8","  0","  107","   8"
"2814","alameda","2020-05-18"," 138"," 2968"," 120"," 52"," 2830","  68"
"2815","los angeles","2020-05-18","2051","23910","1221","570","21859"," 651"
"2816","inyo","2020-05-18","   0","   42","   4","  0","   42","   4"
"2817","colusa","2020-05-18","   1","   88","   5","  1","   87","   4"
"2818","orange","2020-05-18"," 341"," 7007"," 387","123"," 6666"," 264"
"2819","del norte","2020-05-18","   0","   51","   2","  0","   51","   2"
"2820","sacramento","2020-05-18","  71"," 2367"," 113"," 18"," 2296","  95"
"2821","contra costa","2020-05-18","  70"," 1628"," 122"," 19"," 1558"," 103"
"2822","san luis obispo","2020-05-18","   3","  526","  22","  2","  523","  20"
"2823","trinity","2020-05-18","   0","   54","   0","  0","   54","   0"
"2824","madera","2020-05-18","   2","  528","   4","  0","  526","   4"
"2825","tuolumne","2020-05-18","   0","  151","   1","  0","  151","   1"
"2826","santa cruz","2020-05-18","   2","  397","  15","  0","  395","  15"
"2827","san bernardino","2020-05-18"," 221"," 4821"," 197"," 66"," 4600"," 131"
"2828","san joaquin","2020-05-18","  32"," 1366","  31","  9"," 1334","  22"
"2829","riverside","2020-05-18"," 281"," 3994"," 210"," 86"," 3713"," 124"
"2830","san mateo","2020-05-18","  60"," 1096","  41"," 15"," 1036","  26"
"2831","glenn","2020-05-18","   0","    0","   0","  0","    0","   0"
"2832","imperial","2020-05-18","  74","  187","  11"," 17","  113","  -6"
"2833","solano","2020-05-18","  43","  707","  42"," 11","  664","  31"
"2834","santa barbara","2020-05-18","  27","  717","  70"," 14","  690","  56"
"2835","lake","2020-05-18","   2","  110","   3","  0","  108","   3"
"2836","tehama","2020-05-18","   1","  106","   3","  0","  105","   3"
"2837","placer","2020-05-18","  35","  753","  40","  4","  718","  36"
"2838","calaveras","2020-05-18","   0","   50","  11","  0","   50","  11"
"2839","monterey","2020-05-18","   9","  811"," 106","  4","  802"," 102"
"2840","mariposa","2020-05-18","   2","   30","   0","  0","   28","   0"
"2841","san benito","2020-05-18","   1","   25","   1","  1","   24","   0"
"2842","merced","2020-05-18","   6","  242","   7","  5","  236","   2"
"2843","siskiyou","2020-05-18","   0","   65","   4","  0","   65","   4"
"2844","humboldt","2020-05-18","   5","  352","   3","  1","  347","   2"
"2845","mono","2020-05-18","   0","   17","   2","  0","   17","   2"
"2846","napa","2020-05-18","   1","  387","  10","  2","  386","   8"
"2847","amador","2020-05-18","   1","   51","   4","  1","   50","   3"
"2848","yolo","2020-05-18","   0","  186","   3","  0","  186","   3"
"2849","modoc","2020-05-18","   1","   41","   0","  0","   40","   0"
"2850","stanislaus","2020-05-18","  38"," 1369","  77","  2"," 1331","  75"
"2851","mendocino","2020-05-18","   1","  180","   4","  1","  179","   3"
"2852","kings","2020-05-18","  25","  199","   2","  6","  174","  -4"
"2853","ventura","2020-05-18","  49"," 1307","  39"," 18"," 1258","  21"
"2854","san diego","2020-05-18"," 378"," 6040"," 341","149"," 5662"," 192"
"2855","plumas","2020-05-18","   0","   45","   0","  0","   45","   0"
"2856","butte","2020-05-18","   3","  448","  22","  1","  445","  21"
"2857","marin","2020-05-18","  12","  390","  17","  3","  378","  14"
"2858","fresno","2020-05-18"," 105"," 2135","  99"," 19"," 2030","  80"
"2859","kern","2020-05-18","  48"," 1704","  72"," 18"," 1656","  54"
"2860","san francisco","2020-05-18","  79"," 2619"," 115"," 31"," 2540","  84"
"2861","solano","2020-05-19","  47","  707","  42"," 12","  660","  30"
"2862","glenn","2020-05-19","   0","    0","   0","  0","    0","   0"
"2863","modoc","2020-05-19","   1","   41","   0","  0","   40","   0"
"2864","yuba","2020-05-19","   1","  445","  10","  0","  444","  10"
"2865","stanislaus","2020-05-19","  48"," 1369","  87","  5"," 1321","  82"
"2866","sacramento","2020-05-19"," 101"," 2392"," 115"," 16"," 2291","  99"
"2867","marin","2020-05-19","  24","  390","  14","  2","  366","  12"
"2868","kern","2020-05-19","  53"," 1735","  72"," 21"," 1682","  51"
"2869","shasta","2020-05-19","   0","  667","   4","  0","  667","   4"
"2870","orange","2020-05-19"," 366"," 7007"," 352","135"," 6641"," 217"
"2871","los angeles","2020-05-19","2136","23675","1216","560","21539"," 656"
"2872","san luis obispo","2020-05-19","   3","  526","  20","  2","  523","  18"
"2873","calaveras","2020-05-19","   0","   50","  11","  0","   50","  11"
"2874","lake","2020-05-19","   1","  110","   1","  1","  109","   0"
"2875","mono","2020-05-19","   0","   17","   2","  0","   17","   2"
"2876","madera","2020-05-19","   1","  528","  23","  0","  527","  23"
"2877","tehama","2020-05-19","   0","  106","   6","  0","  106","   6"
"2878","sutter","2020-05-19","   0","   14","   0","  0","   14","   0"
"2879","monterey","2020-05-19","  11","  811"," 102","  4","  800","  98"
"2880","el dorado","2020-05-19","   2","  199","  10","  2","  197","   8"
"2881","amador","2020-05-19","   0","   51","   3","  0","   51","   3"
"2882","ventura","2020-05-19","  60"," 1336","  41"," 19"," 1276","  22"
"2883","mariposa","2020-05-19","   3","   30","   0","  0","   27","   0"
"2884","san bernardino","2020-05-19"," 210"," 4821"," 206"," 75"," 4611"," 131"
"2885","placer","2020-05-19","  48","  753","  38","  6","  705","  32"
"2886","alameda","2020-05-19"," 191"," 2968"," 122"," 56"," 2777","  66"
"2887","lassen","2020-05-19","   1","   25","   0","  0","   24","   0"
"2888","san francisco","2020-05-19","  74"," 2619"," 114"," 20"," 2545","  94"
"2889","del norte","2020-05-19","   0","   51","   1","  0","   51","   1"
"2890","santa barbara","2020-05-19","  28","  717","  61"," 13","  689","  48"
"2891","trinity","2020-05-19","   0","   54","   0","  0","   54","   0"
"2892","san joaquin","2020-05-19","  33"," 1366","  27"," 12"," 1333","  15"
"2893","butte","2020-05-19","   1","  448","  23","  1","  447","  22"
"2894","santa cruz","2020-05-19","   1","  397","  13","  0","  396","  13"
"2895","colusa","2020-05-19","   1","   88","   5","  1","   87","   4"
"2896","merced","2020-05-19","   8","  242","   2","  4","  234","  -2"
"2897","san benito","2020-05-19","   1","   25","   1","  1","   24","   0"
"2898","kings","2020-05-19","  24","  199","   0","  6","  175","  -6"
"2899","yolo","2020-05-19","   0","  186","   4","  0","  186","   4"
"2900","napa","2020-05-19","   1","  387","  14","  2","  386","  12"
"2901","imperial","2020-05-19","  78","  200","  10"," 19","  122","  -9"
"2902","tuolumne","2020-05-19","   0","  151","   1","  0","  151","   1"
"2903","plumas","2020-05-19","   0","   45","   0","  0","   45","   0"
"2904","san mateo","2020-05-19","  71"," 1096","  26"," 15"," 1025","  11"
"2905","fresno","2020-05-19"," 107"," 2138","  88"," 24"," 2031","  64"
"2906","inyo","2020-05-19","   0","   42","   4","  0","   42","   4"
"2907","humboldt","2020-05-19","   7","  352","   6","  1","  345","   5"
"2908","mendocino","2020-05-19","   1","  180","   6","  1","  179","   5"
"2909","contra costa","2020-05-19","  88"," 1628"," 117"," 17"," 1540"," 100"
"2910","tulare","2020-05-19","  42","  920","  22"," 11","  878","  11"
"2911","nevada","2020-05-19","   0","  113","   9","  0","  113","   9"
"2912","riverside","2020-05-19"," 292"," 3999"," 191","100"," 3707","  91"
"2913","sonoma","2020-05-19","  28","  871","  54","  4","  843","  50"
"2914","san diego","2020-05-19"," 387"," 6142"," 311","155"," 5755"," 156"
"2915","santa clara","2020-05-19"," 100"," 3318"," 195"," 22"," 3218"," 173"
"2916","siskiyou","2020-05-19","   0","   65","   3","  0","   65","   3"
"2917","trinity","2020-05-20","   0","   54","   0","  0","   54","   0"
"2918","riverside","2020-05-20"," 290"," 4010"," 144"," 95"," 3720","  49"
"2919","solano","2020-05-20","  55","  707","  44"," 11","  652","  33"
"2920","glenn","2020-05-20","   0","    0","   0","  0","    0","   0"
"2921","yolo","2020-05-20","   0","  186","   7","  0","  186","   7"
"2922","del norte","2020-05-20","   0","   51","   0","  0","   51","   0"
"2923","lassen","2020-05-20","   1","   25","   0","  0","   24","   0"
"2924","nevada","2020-05-20","   0","  116","   9","  0","  116","   9"
"2925","mariposa","2020-05-20","   2","   30","   0","  0","   28","   0"
"2926","napa","2020-05-20","   1","  387","   6","  2","  386","   4"
"2927","calaveras","2020-05-20","   0","   50","  10","  0","   50","  10"
"2928","el dorado","2020-05-20","   2","  199","   7","  2","  197","   5"
"2929","san francisco","2020-05-20","  79"," 2619"," 113"," 27"," 2540","  86"
"2930","plumas","2020-05-20","   0","   45","   0","  0","   45","   0"
"2931","humboldt","2020-05-20","  12","  352","   4","  2","  340","   2"
"2932","butte","2020-05-20","   5","  448","  20","  2","  443","  18"
"2933","sacramento","2020-05-20"," 103"," 2378"," 106"," 17"," 2275","  89"
"2934","san joaquin","2020-05-20","  38"," 1366","  27","  9"," 1328","  18"
"2935","tehama","2020-05-20","   0","  106","   7","  0","  106","   7"
"2936","amador","2020-05-20","   0","   51","   2","  0","   51","   2"
"2937","mono","2020-05-20","   0","   17","   2","  0","   17","   2"
"2938","placer","2020-05-20","  56","  753","  45","  5","  697","  40"
"2939","imperial","2020-05-20","  83","  214","   8"," 22","  131"," -14"
"2940","sutter","2020-05-20","   0","   14","   0","  0","   14","   0"
"2941","siskiyou","2020-05-20","   0","   65","   4","  0","   65","   4"
"2942","san benito","2020-05-20","   1","   25","   0","  1","   24","  -1"
"2943","merced","2020-05-20","   9","  242","   1","  4","  233","  -3"
"2944","los angeles","2020-05-20","2067","23670","1253","539","21603"," 714"
"2945","yuba","2020-05-20","   1","  445","  11","  0","  444","  11"
"2946","modoc","2020-05-20","   1","   41","   0","  0","   40","   0"
"2947","santa cruz","2020-05-20","   3","  397","  16","  0","  394","  16"
"2948","alameda","2020-05-20"," 215"," 2968"," 112"," 63"," 2753","  49"
"2949","kings","2020-05-20","  26","  199","   5","  5","  173","   0"
"2950","inyo","2020-05-20","   0","   42","   2","  0","   42","   2"
"2951","kern","2020-05-20","  56"," 1735","  66"," 23"," 1679","  43"
"2952","marin","2020-05-20","  29","  390","  20","  0","  361","  20"
"2953","santa clara","2020-05-20","  96"," 3318"," 170"," 21"," 3222"," 149"
"2954","sonoma","2020-05-20","  36","  871","  52","  4","  835","  48"
"2955","stanislaus","2020-05-20","  48"," 1369","  80","  8"," 1321","  72"
"2956","santa barbara","2020-05-20","  27","  717","  60"," 12","  690","  48"
"2957","mendocino","2020-05-20","   1","  180","   7","  1","  179","   6"
"2958","colusa","2020-05-20","   0","   88","   6","  0","   88","   6"
"2959","madera","2020-05-20","   4","  528","  21","  0","  524","  21"
"2960","orange","2020-05-20"," 388"," 7007"," 382","130"," 6619"," 252"
"2961","monterey","2020-05-20","  10","  811"," 103","  4","  801","  99"
"2962","lake","2020-05-20","   2","  110","   3","  0","  108","   3"
"2963","tulare","2020-05-20","  45","  920","  21"," 12","  875","   9"
"2964","san bernardino","2020-05-20"," 216"," 4821"," 213"," 65"," 4605"," 148"
"2965","san mateo","2020-05-20","  74"," 1096","  25"," 17"," 1022","   8"
"2966","san diego","2020-05-20"," 404"," 6207"," 322","150"," 5803"," 172"
"2967","contra costa","2020-05-20","  82"," 1628"," 128"," 15"," 1546"," 113"
"2968","fresno","2020-05-20","  97"," 2140","  97"," 18"," 2043","  79"
"2969","tuolumne","2020-05-20","   0","  151","   4","  0","  151","   4"
"2970","ventura","2020-05-20","  62"," 1339","  39"," 21"," 1277","  18"
"2971","san luis obispo","2020-05-20","   8","  526","  21","  3","  518","  18"
"2972","shasta","2020-05-20","   0","  667","   6","  0","  667","   6"
"2973","mendocino","2020-05-21","   1","  180","   7","  1","  179","   6"
"2974","san luis obispo","2020-05-21","   7","  473","  20","  3","  466","  17"
"2975","tulare","2020-05-21","  40","  920","   9","  9","  880","   0"
"2976","inyo","2020-05-21","   0","   42","   2","  0","   42","   2"
"2977","lake","2020-05-21","   0","  110","   3","  0","  110","   3"
"2978","merced","2020-05-21","   6","  242","   3","  4","  236","  -1"
"2979","tehama","2020-05-21","   0","  106","   8","  0","  106","   8"
"2980","yolo","2020-05-21","   3","  186","   5","  1","  183","   4"
"2981","san diego","2020-05-21"," 378"," 6180"," 313","145"," 5802"," 168"
"2982","kern","2020-05-21","  54"," 1728","  73"," 20"," 1674","  53"
"2983","placer","2020-05-21","  66","  753","  35","  9","  687","  26"
"2984","san joaquin","2020-05-21","  31"," 1366","  28"," 13"," 1335","  15"
"2985","lassen","2020-05-21","   1","   25","   0","  0","   24","   0"
"2986","imperial","2020-05-21","  78","  210","  10"," 22","  132"," -12"
"2987","monterey","2020-05-21","   9","  811"," 103","  4","  802","  99"
"2988","ventura","2020-05-21","  49"," 1329","  44"," 15"," 1280","  29"
"2989","mariposa","2020-05-21","   0","   30","   0","  0","   30","   0"
"2990","santa barbara","2020-05-21","  30","  717","  58"," 10","  687","  48"
"2991","calaveras","2020-05-21","   1","   50","   9","  1","   49","   8"
"2992","trinity","2020-05-21","   0","   54","   0","  0","   54","   0"
"2993","el dorado","2020-05-21","   2","  199","   6","  2","  197","   4"
"2994","sutter","2020-05-21","   0","   14","   0","  0","   14","   0"
"2995","nevada","2020-05-21","   0","  112","   6","  0","  112","   6"
"2996","san benito","2020-05-21","   1","   25","   0","  1","   24","  -1"
"2997","del norte","2020-05-21","   0","   51","   1","  0","   51","   1"
"2998","sonoma","2020-05-21","  35","  871","  49","  8","  836","  41"
"2999","colusa","2020-05-21","   0","   88","   6","  0","   88","   6"
"3000","mono","2020-05-21","   0","   17","   2","  0","   17","   2"
"3001","stanislaus","2020-05-21","  52"," 1369","  82","  8"," 1317","  74"
"3002","contra costa","2020-05-21","  83"," 1628"," 118"," 17"," 1545"," 101"
"3003","solano","2020-05-21","  53","  707","  45"," 13","  654","  32"
"3004","madera","2020-05-21","   0","  528","  18","  0","  528","  18"
"3005","amador","2020-05-21","   0","   51","   1","  0","   51","   1"
"3006","orange","2020-05-21"," 364"," 6993"," 401","130"," 6629"," 271"
"3007","santa cruz","2020-05-21","   5","  397","  14","  1","  392","  13"
"3008","fresno","2020-05-21"," 118"," 2144","  99"," 20"," 2026","  79"
"3009","yuba","2020-05-21","   1","  445","   8","  0","  444","   8"
"3010","kings","2020-05-21","  25","  199","   2","  6","  174","  -4"
"3011","marin","2020-05-21","  33","  390","  18","  0","  357","  18"
"3012","siskiyou","2020-05-21","   0","   65","   4","  0","   65","   4"
"3013","sacramento","2020-05-21"," 107"," 2409"," 108"," 18"," 2302","  90"
"3014","modoc","2020-05-21","   1","   41","   0","  0","   40","   0"
"3015","alameda","2020-05-21"," 239"," 2968"," 114"," 62"," 2729","  52"
"3016","san mateo","2020-05-21","  70"," 1096","  26"," 14"," 1026","  12"
"3017","san francisco","2020-05-21","  80"," 2619"," 103"," 27"," 2539","  76"
"3018","tuolumne","2020-05-21","   0","  151","   2","  0","  151","   2"
"3019","shasta","2020-05-21","   0","  667","   5","  0","  667","   5"
"3020","humboldt","2020-05-21","  16","  352","   5","  3","  336","   2"
"3021","riverside","2020-05-21"," 285"," 4020"," 129"," 82"," 3735","  47"
"3022","san bernardino","2020-05-21"," 224"," 4821"," 225"," 63"," 4597"," 162"
"3023","plumas","2020-05-21","   0","   45","   0","  0","   45","   0"
"3024","glenn","2020-05-21","   0","    0","   0","  0","    0","   0"
"3025","napa","2020-05-21","   1","  387","   0","  2","  386","  -2"
"3026","butte","2020-05-21","   9","  448","  17","  3","  439","  14"
"3027","santa clara","2020-05-21","  99"," 3318"," 167"," 24"," 3219"," 143"
"3028","los angeles","2020-05-21","2105","23620","1199","556","21515"," 643"
"3029","trinity","2020-05-22","   0","   54","   0","  0","   54","   0"
"3030","yuba","2020-05-22","   1","  445","   4","  0","  444","   4"
"3031","madera","2020-05-22","   1","  528","  21","  0","  527","  21"
"3032","imperial","2020-05-22","  77","  210","   9"," 23","  133"," -14"
"3033","san luis obispo","2020-05-22","   3","  469","  21","  2","  466","  19"
"3034","nevada","2020-05-22","   0","  119","   8","  0","  119","   8"
"3035","mariposa","2020-05-22","   0","   30","   0","  0","   30","   0"
"3036","san benito","2020-05-22","   1","   25","   1","  0","   24","   1"
"3037","napa","2020-05-22","   8","  387","   0","  1","  379","  -1"
"3038","yolo","2020-05-22","   0","  186","   7","  0","  186","   7"
"3039","tehama","2020-05-22","   0","  106","   7","  0","  106","   7"
"3040","marin","2020-05-22","   6","  390","  15","  2","  384","  13"
"3041","merced","2020-05-22","   7","  242","   4","  4","  235","   0"
"3042","inyo","2020-05-22","   0","   42","   3","  0","   42","   3"
"3043","el dorado","2020-05-22","   4","  199","   8","  3","  195","   5"
"3044","monterey","2020-05-22","  10","  811"," 104","  4","  801"," 100"
"3045","ventura","2020-05-22","  64"," 1345","  42"," 17"," 1281","  25"
"3046","lake","2020-05-22","   2","  110","   3","  0","  108","   3"
"3047","solano","2020-05-22","  34","  707","  45","  7","  673","  38"
"3048","contra costa","2020-05-22","  41"," 1628"," 113"," 11"," 1587"," 102"
"3049","sutter","2020-05-22","   0","   14","   0","  0","   14","   0"
"3050","sonoma","2020-05-22","  21","  871","  47","  5","  850","  42"
"3051","san mateo","2020-05-22","  52"," 1096","  40"," 14"," 1044","  26"
"3052","stanislaus","2020-05-22","  34"," 1374","  81","  5"," 1340","  76"
"3053","orange","2020-05-22"," 358"," 6993"," 397","145"," 6635"," 252"
"3054","santa cruz","2020-05-22","   5","  397","  11","  1","  392","  10"
"3055","san francisco","2020-05-22","  72"," 2619","  84"," 29"," 2547","  55"
"3056","humboldt","2020-05-22","  17","  352","   3","  2","  335","   1"
"3057","los angeles","2020-05-22","2055","23628","1187","572","21573"," 615"
"3058","del norte","2020-05-22","   0","   51","   4","  0","   51","   4"
"3059","colusa","2020-05-22","   0","   88","   6","  0","   88","   6"
"3060","placer","2020-05-22","  26","  753","  42","  8","  727","  34"
"3061","calaveras","2020-05-22","   0","   50","   9","  0","   50","   9"
"3062","fresno","2020-05-22","  94"," 2135","  89"," 26"," 2041","  63"
"3063","glenn","2020-05-22","   0","    0","   0","  0","    0","   0"
"3064","san bernardino","2020-05-22"," 226"," 4821"," 218"," 55"," 4595"," 163"
"3065","lassen","2020-05-22","   1","   25","   0","  0","   24","   0"
"3066","butte","2020-05-22","   8","  448","  17","  2","  440","  15"
"3067","san joaquin","2020-05-22","  35"," 1366","  23"," 11"," 1331","  12"
"3068","plumas","2020-05-22","   0","   45","   0","  0","   45","   0"
"3069","mendocino","2020-05-22","   1","  180","   6","  1","  179","   5"
"3070","tulare","2020-05-22","  39","  881","  31"," 10","  842","  21"
"3071","santa clara","2020-05-22","  55"," 3318"," 170"," 20"," 3263"," 150"
"3072","santa barbara","2020-05-22","  24","  717","  60","  9","  693","  51"
"3073","kern","2020-05-22","  53"," 1761","  64"," 20"," 1708","  44"
"3074","riverside","2020-05-22"," 310"," 4029"," 130"," 80"," 3719","  50"
"3075","kings","2020-05-22","  28","  199","   4","  8","  171","  -4"
"3076","tuolumne","2020-05-22","   0","  151","   2","  0","  151","   2"
"3077","amador","2020-05-22","   1","   51","   1","  0","   50","   1"
"3078","alameda","2020-05-22"," 160"," 2968"," 119"," 55"," 2808","  64"
"3079","modoc","2020-05-22","   1","   41","   0","  0","   40","   0"
"3080","sacramento","2020-05-22","  23"," 2400"," 106","  4"," 2377"," 102"
"3081","siskiyou","2020-05-22","   2","   65","   5","  1","   63","   4"
"3082","shasta","2020-05-22","   1","  667","  13","  0","  666","  13"
"3083","san diego","2020-05-22"," 381"," 6221"," 333","155"," 5840"," 178"
"3084","mono","2020-05-22","   0","   17","   2","  0","   17","   2"
"3085","san mateo","2020-05-23","  50"," 1096","  42"," 16"," 1046","  26"
"3086","riverside","2020-05-23"," 288"," 3971"," 142"," 79"," 3683","  63"
"3087","kings","2020-05-23","  28","  199","   4","  8","  171","  -4"
"3088","mariposa","2020-05-23","   0","   30","   0","  0","   30","   0"
"3089","placer","2020-05-23","  25","  753","  42","  8","  728","  34"
"3090","contra costa","2020-05-23","  48"," 1628"," 100"," 12"," 1580","  88"
"3091","siskiyou","2020-05-23","   2","   65","   5","  1","   63","   4"
"3092","fresno","2020-05-23"," 103"," 2137","  85"," 27"," 2034","  58"
"3093","alameda","2020-05-23"," 158"," 2968"," 110"," 60"," 2810","  50"
"3094","plumas","2020-05-23","   0","   45","   0","  0","   45","   0"
"3095","modoc","2020-05-23","   1","   41","   0","  0","   40","   0"
"3096","mendocino","2020-05-23","   5","  180","   7","  0","  175","   7"
"3097","santa cruz","2020-05-23","   5","  397","  10","  1","  392","   9"
"3098","san francisco","2020-05-23","  73"," 2619","  83"," 27"," 2546","  56"
"3099","lassen","2020-05-23","   0","   25","   0","  0","   25","   0"
"3100","santa clara","2020-05-23","  54"," 3318"," 178"," 19"," 3264"," 159"
"3101","los angeles","2020-05-23","2006","23605","1257","566","21599"," 691"
"3102","tehama","2020-05-23","   0","  106","   6","  0","  106","   6"
"3103","monterey","2020-05-23","   8","  811"," 104","  4","  803"," 100"
"3104","imperial","2020-05-23","  77","  210","   9"," 23","  133"," -14"
"3105","sonoma","2020-05-23","  22","  871","  49","  5","  849","  44"
"3106","glenn","2020-05-23","   0","    0","   0","  0","    0","   0"
"3107","san diego","2020-05-23"," 386"," 6224"," 323","152"," 5838"," 171"
"3108","yuba","2020-05-23","   1","  445","   9","  0","  444","   9"
"3109","shasta","2020-05-23","   1","  667","  13","  0","  666","  13"
"3110","sacramento","2020-05-23","  24"," 2388"," 101","  3"," 2364","  98"
"3111","el dorado","2020-05-23","   6","  199","   3","  6","  193","  -3"
"3112","yolo","2020-05-23","   0","  186","   0","  2","  186","  -2"
"3113","san bernardino","2020-05-23"," 234"," 4821"," 207"," 62"," 4587"," 145"
"3114","santa barbara","2020-05-23","  24","  717","  66","  9","  693","  57"
"3115","merced","2020-05-23","  11","  242","   4","  6","  231","  -2"
"3116","stanislaus","2020-05-23","  38"," 1369","  87","  8"," 1331","  79"
"3117","tuolumne","2020-05-23","   0","  151","   1","  0","  151","   1"
"3118","humboldt","2020-05-23","  17","  352","   3","  2","  335","   1"
"3119","madera","2020-05-23","   0","  528","  21","  0","  528","  21"
"3120","calaveras","2020-05-23","   0","   50","   9","  0","   50","   9"
"3121","amador","2020-05-23","   0","   51","   2","  0","   51","   2"
"3122","mono","2020-05-23","   0","   17","   2","  0","   17","   2"
"3123","kern","2020-05-23","  58"," 1727","  78"," 24"," 1669","  54"
"3124","lake","2020-05-23","   1","  110","   2","  1","  109","   1"
"3125","san luis obispo","2020-05-23","   2","  462","  27","  1","  460","  26"
"3126","sutter","2020-05-23","   0","   14","   0","  0","   14","   0"
"3127","del norte","2020-05-23","   0","   51","   0","  0","   51","   0"
"3128","inyo","2020-05-23","   0","   42","   4","  0","   42","   4"
"3129","napa","2020-05-23","   2","  387","   2","  1","  385","   1"
"3130","trinity","2020-05-23","   0","   54","   0","  0","   54","   0"
"3131","ventura","2020-05-23","  54"," 1318","  39"," 12"," 1264","  27"
"3132","tulare","2020-05-23","  41","  920","  13"," 10","  879","   3"
"3133","colusa","2020-05-23","   0","   88","   6","  0","   88","   6"
"3134","nevada","2020-05-23","   0","  120","   4","  1","  120","   3"
"3135","san benito","2020-05-23","   1","   25","   2","  0","   24","   2"
"3136","butte","2020-05-23","   5","  448","  20","  2","  443","  18"
"3137","marin","2020-05-23","   6","  390","  15","  3","  384","  12"
"3138","solano","2020-05-23","  32","  707","  43","  6","  675","  37"
"3139","orange","2020-05-23"," 372"," 6993"," 407","135"," 6621"," 272"
"3140","san joaquin","2020-05-23","  31"," 1366","  21"," 13"," 1335","   8"
"3141","mono","2020-05-24","   0","   17","   2","  0","   17","   2"
"3142","tulare","2020-05-24","  44","  920","  13"," 11","  876","   2"
"3143","marin","2020-05-24","   6","  390","  13","  3","  384","  10"
"3144","san benito","2020-05-24","   1","   25","   0","  0","   24","   0"
"3145","shasta","2020-05-24","   0","  667","  15","  0","  667","  15"
"3146","lassen","2020-05-24","   0","   25","   0","  0","   25","   0"
"3147","tehama","2020-05-24","   0","  106","   6","  0","  106","   6"
"3148","napa","2020-05-24","   1","  387","   2","  1","  386","   1"
"3149","trinity","2020-05-24","   0","   54","   0","  0","   54","   0"
"3150","santa barbara","2020-05-24","  27","  717","  71","  8","  690","  63"
"3151","monterey","2020-05-24","   8","  811"," 106","  4","  803"," 102"
"3152","ventura","2020-05-24","  68"," 1331","  46"," 18"," 1263","  28"
"3153","san mateo","2020-05-24","  52"," 1096","  43"," 16"," 1044","  27"
"3154","san francisco","2020-05-24","  88"," 2619","  97"," 30"," 2531","  67"
"3155","siskiyou","2020-05-24","   2","   65","   5","  1","   63","   4"
"3156","santa cruz","2020-05-24","   5","  397","  14","  1","  392","  13"
"3157","humboldt","2020-05-24","   7","  352","   5","  1","  345","   4"
"3158","sonoma","2020-05-24","  22","  871","  50","  6","  849","  44"
"3159","yolo","2020-05-24","   0","  186","   0","  0","  186","   0"
"3160","contra costa","2020-05-24","  42"," 1628"," 102"," 11"," 1586","  91"
"3161","alameda","2020-05-24"," 149"," 2968"," 119"," 55"," 2819","  64"
"3162","stanislaus","2020-05-24","  37"," 1369","  85","  7"," 1332","  78"
"3163","modoc","2020-05-24","   1","   41","   0","  0","   40","   0"
"3164","yuba","2020-05-24","   1","  445","  13","  0","  444","  13"
"3165","kings","2020-05-24","  28","  199","   7"," 10","  171","  -3"
"3166","nevada","2020-05-24","   0","  121","   1","  2","  121","  -1"
"3167","amador","2020-05-24","   0","   51","   0","  0","   51","   0"
"3168","placer","2020-05-24","  26","  753","  39","  9","  727","  30"
"3169","tuolumne","2020-05-24","   0","  151","   1","  0","  151","   1"
"3170","sacramento","2020-05-24","  26"," 2363"," 110","  6"," 2337"," 104"
"3171","solano","2020-05-24","  37","  707","  46","  8","  670","  38"
"3172","calaveras","2020-05-24","   1","   50","  10","  0","   49","  10"
"3173","fresno","2020-05-24"," 106"," 2128","  91"," 23"," 2022","  68"
"3174","riverside","2020-05-24"," 268"," 3944"," 150"," 78"," 3676","  72"
"3175","san joaquin","2020-05-24","  36"," 1366","  17"," 11"," 1330","   6"
"3176","orange","2020-05-24"," 388"," 6993"," 404","131"," 6605"," 273"
"3177","plumas","2020-05-24","   0","   45","   0","  0","   45","   0"
"3178","madera","2020-05-24","   1","  528","  22","  1","  527","  21"
"3179","lake","2020-05-24","   4","  110","   0","  2","  106","  -2"
"3180","mariposa","2020-05-24","   0","   30","   0","  0","   30","   0"
"3181","imperial","2020-05-24","  81","  210","   9"," 23","  129"," -14"
"3182","san diego","2020-05-24"," 370"," 6189"," 321","150"," 5819"," 171"
"3183","los angeles","2020-05-24","1990","23608","1227","549","21618"," 678"
"3184","santa clara","2020-05-24","  54"," 3318"," 195"," 18"," 3264"," 177"
"3185","glenn","2020-05-24","   0","    0","   0","  0","    0","   0"
"3186","mendocino","2020-05-24","   5","  180","   7","  0","  175","   7"
"3187","butte","2020-05-24","   5","  448","  20","  2","  443","  18"
"3188","el dorado","2020-05-24","   5","  199","   4","  5","  194","  -1"
"3189","san bernardino","2020-05-24"," 242"," 4821"," 196"," 70"," 4579"," 126"
"3190","colusa","2020-05-24","   0","   88","   6","  0","   88","   6"
"3191","san luis obispo","2020-05-24","   3","  461","  28","  1","  458","  27"
"3192","merced","2020-05-24","  12","  242","   5","  5","  230","   0"
"3193","kern","2020-05-24","  57"," 1712","  84"," 24"," 1655","  60"
"3194","sutter","2020-05-24","   0","   14","   0","  0","   14","   0"
"3195","inyo","2020-05-24","   0","   42","   4","  0","   42","   4"
"3196","del norte","2020-05-24","   0","   51","   2","  0","   51","   2"
"3197","modoc","2020-05-25","   1","   41","   0","  0","   40","   0"
"3198","tulare","2020-05-25","  42","  920","  22"," 15","  878","   7"
"3199","sonoma","2020-05-25","  27","  871","  46","  9","  844","  37"
"3200","solano","2020-05-25","  41","  707","  44"," 15","  666","  29"
"3201","san benito","2020-05-25","   1","   25","   0","  0","   24","   0"
"3202","alameda","2020-05-25"," 156"," 2968"," 115"," 60"," 2812","  55"
"3203","sacramento","2020-05-25","  26"," 2381"," 116"," 31"," 2355","  85"
"3204","marin","2020-05-25","   7","  390","   9","  7","  383","   2"
"3205","san luis obispo","2020-05-25","   2","  448","  26","  1","  446","  25"
"3206","el dorado","2020-05-25","   4","  199","  11","  4","  195","   7"
"3207","orange","2020-05-25"," 394"," 6993"," 441","138"," 6599"," 303"
"3208","tehama","2020-05-25","   0","  106","   3","  0","  106","   3"
"3209","riverside","2020-05-25"," 281"," 3959"," 159"," 78"," 3678","  81"
"3210","sutter","2020-05-25","   0","   14","   0","  0","   14","   0"
"3211","los angeles","2020-05-25","2041","23620","1453","559","21579"," 894"
"3212","mendocino","2020-05-25","   2","  180","   5","  1","  178","   4"
"3213","santa clara","2020-05-25","  52"," 3318"," 204"," 26"," 3266"," 178"
"3214","mariposa","2020-05-25","   1","   30","   0","  0","   29","   0"
"3215","nevada","2020-05-25","   0","  120","   6","  1","  120","   5"
"3216","butte","2020-05-25","   7","  448","  19","  3","  441","  16"
"3217","napa","2020-05-25","   1","  387","   4","  1","  386","   3"
"3218","ventura","2020-05-25","  63"," 1337","  46"," 14"," 1274","  32"
"3219","mono","2020-05-25","   0","   17","   2","  0","   17","   2"
"3220","lake","2020-05-25","   1","  110","   2","  0","  109","   2"
"3221","lassen","2020-05-25","   0","   25","   0","  0","   25","   0"
"3222","colusa","2020-05-25","   0","   88","   6","  0","   88","   6"
"3223","san diego","2020-05-25"," 385"," 6158"," 385","160"," 5773"," 225"
"3224","stanislaus","2020-05-25","  29"," 1369","  79"," 10"," 1340","  69"
"3225","siskiyou","2020-05-25","   2","   65","   5","  1","   63","   4"
"3226","kings","2020-05-25","  29","  199","   3"," 10","  170","  -7"
"3227","yolo","2020-05-25","   1","  186","   4","  0","  185","   4"
"3228","kern","2020-05-25","  59"," 1707","  77"," 26"," 1648","  51"
"3229","calaveras","2020-05-25","   1","   50","  10","  0","   49","  10"
"3230","san mateo","2020-05-25","  57"," 1096","  46"," 20"," 1039","  26"
"3231","san bernardino","2020-05-25"," 254"," 4821"," 245"," 71"," 4567"," 174"
"3232","san francisco","2020-05-25","  81"," 2619"," 100"," 32"," 2538","  68"
"3233","fresno","2020-05-25"," 104"," 2128","  92"," 20"," 2024","  72"
"3234","yuba","2020-05-25","   1","  445","  11","  0","  444","  11"
"3235","santa cruz","2020-05-25","   7","  397","  15","  1","  390","  14"
"3236","plumas","2020-05-25","   0","   45","   0","  0","   45","   0"
"3237","glenn","2020-05-25","   0","    0","   0","  0","    0","   0"
"3238","san joaquin","2020-05-25","  36"," 1366","  22"," 10"," 1330","  12"
"3239","inyo","2020-05-25","   0","   42","   4","  0","   42","   4"
"3240","humboldt","2020-05-25","  10","  352","   4","  1","  342","   3"
"3241","tuolumne","2020-05-25","   0","  151","   2","  0","  151","   2"
"3242","merced","2020-05-25","  10","  242","  10","  5","  232","   5"
"3243","amador","2020-05-25","   0","   51","   1","  0","   51","   1"
"3244","shasta","2020-05-25","   0","  667","  16","  0","  667","  16"
"3245","placer","2020-05-25","  25","  753","  47","  9","  728","  38"
"3246","santa barbara","2020-05-25","  27","  717","  70","  8","  690","  62"
"3247","trinity","2020-05-25","   0","   54","   0","  0","   54","   0"
"3248","monterey","2020-05-25","  10","  811"," 106","  3","  801"," 103"
"3249","del norte","2020-05-25","   1","   51","   3","  0","   50","   3"
"3250","imperial","2020-05-25","  75","  210","   9"," 23","  135"," -14"
"3251","madera","2020-05-25","   2","  528","  24","  0","  526","  24"
"3252","contra costa","2020-05-25","  48"," 1628"," 103"," 19"," 1580","  84"
"3253","sutter","2020-05-26","   0","   14","   0","  0","   14","   0"
"3254","trinity","2020-05-26","   3","   54","   0","  0","   51","   0"
"3255","inyo","2020-05-26","   0","   42","   4","  0","   42","   4"
"3256","tulare","2020-05-26","  41","  920","  19"," 12","  879","   7"
"3257","del norte","2020-05-26","   1","   51","   2","  0","   50","   2"
"3258","san benito","2020-05-26","   1","   25","   2","  0","   24","   2"
"3259","santa barbara","2020-05-26","  23","  717","  84"," 10","  694","  74"
"3260","riverside","2020-05-26"," 309"," 3959"," 173"," 90"," 3650","  83"
"3261","colusa","2020-05-26","   0","   88","   6","  0","   88","   6"
"3262","napa","2020-05-26","   2","  387","   3","  1","  385","   2"
"3263","merced","2020-05-26","   9","  242","   5","  5","  233","   0"
"3264","glenn","2020-05-26","   0","   47","   0","  0","   47","   0"
"3265","imperial","2020-05-26","  77","  210","  10"," 22","  133"," -12"
"3266","mendocino","2020-05-26","   4","  180","   4","  1","  176","   3"
"3267","ventura","2020-05-26","  62"," 1344","  40"," 16"," 1282","  24"
"3268","mono","2020-05-26","   0","   17","   2","  0","   17","   2"
"3269","plumas","2020-05-26","   0","   45","   0","  0","   45","   0"
"3270","los angeles","2020-05-26","2087","23592","1449","567","21505"," 882"
"3271","alameda","2020-05-26"," 169"," 2968"," 124"," 57"," 2799","  67"
"3272","san joaquin","2020-05-26","  43"," 1366","  24"," 14"," 1323","  10"
"3273","butte","2020-05-26","   5","  448","  20","  3","  443","  17"
"3274","solano","2020-05-26","  35","  707","  45"," 11","  672","  34"
"3275","modoc","2020-05-26","   1","   41","   0","  0","   40","   0"
"3276","shasta","2020-05-26","   1","  667","  13","  0","  666","  13"
"3277","san francisco","2020-05-26","  87"," 2619","  95"," 34"," 2532","  61"
"3278","santa clara","2020-05-26","  53"," 3318"," 195"," 26"," 3265"," 169"
"3279","sonoma","2020-05-26","  25","  871","  59","  6","  846","  53"
"3280","nevada","2020-05-26","   4","  129","   6","  3","  125","   3"
"3281","san luis obispo","2020-05-26","   4","  447","  28","  1","  443","  27"
"3282","el dorado","2020-05-26","   2","  199","   8","  2","  197","   6"
"3283","san mateo","2020-05-26","  54"," 1096","  47"," 20"," 1042","  27"
"3284","calaveras","2020-05-26","   0","   50","  11","  0","   50","  11"
"3285","san bernardino","2020-05-26"," 279"," 4821"," 237"," 76"," 4542"," 161"
"3286","placer","2020-05-26","  27","  753","  43","  8","  726","  35"
"3287","contra costa","2020-05-26","  49"," 1628"," 115"," 20"," 1579","  95"
"3288","mariposa","2020-05-26","   2","   30","   0","  0","   28","   0"
"3289","lassen","2020-05-26","   1","   25","   0","  0","   24","   0"
"3290","sacramento","2020-05-26","  18"," 2376","  98"," 30"," 2358","  68"
"3291","orange","2020-05-26"," 418"," 6993"," 439","137"," 6575"," 302"
"3292","santa cruz","2020-05-26","   5","  397","  14","  1","  392","  13"
"3293","stanislaus","2020-05-26","  32"," 1369","  85"," 12"," 1337","  73"
"3294","kern","2020-05-26","  66"," 1724","  82"," 24"," 1658","  58"
"3295","san diego","2020-05-26"," 383"," 6167"," 375","153"," 5784"," 222"
"3296","fresno","2020-05-26","  98"," 2141","  96"," 22"," 2043","  74"
"3297","marin","2020-05-26","   5","  390","   8","  6","  385","   2"
"3298","madera","2020-05-26","   5","  528","  22","  0","  523","  22"
"3299","yolo","2020-05-26","   1","  186","   5","  0","  185","   5"
"3300","tuolumne","2020-05-26","   1","  151","   0","  1","  150","  -1"
"3301","kings","2020-05-26","  27","  199","   2"," 10","  172","  -8"
"3302","yuba","2020-05-26","   1","  445","  12","  0","  444","  12"
"3303","siskiyou","2020-05-26","   0","   65","   7","  0","   65","   7"
"3304","humboldt","2020-05-26","  10","  352","   3","  2","  342","   1"
"3305","amador","2020-05-26","   0","   51","   3","  0","   51","   3"
"3306","tehama","2020-05-26","   1","  106","   2","  0","  105","   2"
"3307","lake","2020-05-26","   1","  110","   0","  0","  109","   0"
"3308","monterey","2020-05-26","  12","  811"," 105","  4","  799"," 101"
"3309","shasta","2020-05-27","   0","  667","  15","  0","  667","  15"
"3310","santa cruz","2020-05-27","   3","  397","  15","  1","  394","  14"
"3311","solano","2020-05-27","  34","  707","  41"," 10","  673","  31"
"3312","colusa","2020-05-27","   0","   88","   6","  0","   88","   6"
"3313","siskiyou","2020-05-27","   3","   65","   5","  1","   62","   4"
"3314","glenn","2020-05-27","   0","   47","   0","  0","   47","   0"
"3315","modoc","2020-05-27","   0","   41","   0","  0","   41","   0"
"3316","imperial","2020-05-27","  84","  210","  13"," 14","  126","  -1"
"3317","yolo","2020-05-27","   0","  186","   3","  0","  186","   3"
"3318","amador","2020-05-27","   0","   51","   3","  0","   51","   3"
"3319","yuba","2020-05-27","   1","  445","  12","  0","  444","  12"
"3320","stanislaus","2020-05-27","  25"," 1369","  89","  9"," 1344","  80"
"3321","trinity","2020-05-27","   2","   54","   0","  0","   52","   0"
"3322","el dorado","2020-05-27","   3","  199","   7","  3","  196","   4"
"3323","san bernardino","2020-05-27"," 260"," 4821"," 222"," 73"," 4561"," 149"
"3324","calaveras","2020-05-27","   0","   50","  11","  0","   50","  11"
"3325","plumas","2020-05-27","   0","   45","   0","  0","   45","   0"
"3326","contra costa","2020-05-27","  41"," 1628"," 115"," 13"," 1587"," 102"
"3327","tulare","2020-05-27","  41","  920","  13"," 13","  879","   0"
"3328","inyo","2020-05-27","   0","   42","   4","  0","   42","   4"
"3329","sonoma","2020-05-27","  31","  871","  51","  5","  840","  46"
"3330","san benito","2020-05-27","   1","   25","   1","  0","   24","   1"
"3331","san diego","2020-05-27"," 408"," 6215"," 315","156"," 5807"," 159"
"3332","lassen","2020-05-27","   1","   25","   0","  0","   24","   0"
"3333","humboldt","2020-05-27","   9","  352","   3","  1","  343","   2"
"3334","nevada","2020-05-27","   4","  122","   6","  3","  118","   3"
"3335","sutter","2020-05-27","   0","   14","   0","  0","   14","   0"
"3336","del norte","2020-05-27","   0","   51","   4","  0","   51","   4"
"3337","merced","2020-05-27","   8","  242","   3","  4","  234","  -1"
"3338","santa clara","2020-05-27","  52"," 3318"," 188"," 15"," 3266"," 173"
"3339","placer","2020-05-27","  20","  753","  45","  4","  733","  41"
"3340","san mateo","2020-05-27","  41"," 1096","  46"," 19"," 1055","  27"
"3341","napa","2020-05-27","   2","  387","   2","  1","  385","   1"
"3342","kings","2020-05-27","  24","  199","   0","  7","  175","  -7"
"3343","lake","2020-05-27","   0","  110","   0","  0","  110","   0"
"3344","riverside","2020-05-27"," 313"," 4005"," 131"," 87"," 3692","  44"
"3345","madera","2020-05-27","   4","  528","  24","  0","  524","  24"
"3346","tuolumne","2020-05-27","   0","  151","   0","  0","  151","   0"
"3347","san luis obispo","2020-05-27","   6","  464","  22","  3","  458","  19"
"3348","fresno","2020-05-27"," 115"," 2143","  93"," 23"," 2028","  70"
"3349","san joaquin","2020-05-27","  37"," 1366","  21"," 11"," 1329","  10"
"3350","mono","2020-05-27","   0","   17","   2","  0","   17","   2"
"3351","santa barbara","2020-05-27","  27","  717","  94"," 11","  690","  83"
"3352","ventura","2020-05-27","  52"," 1349","  40"," 20"," 1297","  20"
"3353","mariposa","2020-05-27","   2","   30","   0","  0","   28","   0"
"3354","marin","2020-05-27","   2","  390","  10","  1","  388","   9"
"3355","sacramento","2020-05-27","  29"," 2401","  87","  9"," 2372","  78"
"3356","butte","2020-05-27","   7","  448","  21","  3","  441","  18"
"3357","monterey","2020-05-27","  11","  811"," 100","  3","  800","  97"
"3358","mendocino","2020-05-27","   4","  180","   3","  2","  176","   1"
"3359","los angeles","2020-05-27","2090","23626","1275","554","21536"," 721"
"3360","orange","2020-05-27"," 418"," 6993"," 403","144"," 6575"," 259"
"3361","alameda","2020-05-27"," 164"," 2968"," 128"," 47"," 2804","  81"
"3362","tehama","2020-05-27","   0","  106","   3","  0","  106","   3"
"3363","kern","2020-05-27","  68"," 1727","  72"," 28"," 1659","  44"
"3364","san francisco","2020-05-27","  82"," 2619","  98"," 27"," 2537","  71"
"3365","plumas","2020-05-28","   0","   45","   0","  0","   45","   0"
"3366","glenn","2020-05-28","   0","   47","   0","  0","   47","   0"
"3367","shasta","2020-05-28","   0","  667","   9","  0","  667","   9"
"3368","siskiyou","2020-05-28","   0","   65","   6","  0","   65","   6"
"3369","humboldt","2020-05-28","   9","  352","   5","  1","  343","   4"
"3370","san joaquin","2020-05-28","  40"," 1366","  16"," 10"," 1326","   6"
"3371","placer","2020-05-28","  23","  753","  33","  6","  730","  27"
"3372","sacramento","2020-05-28","  41"," 2395","  95"," 12"," 2354","  83"
"3373","san luis obispo","2020-05-28","   2","  475","  24","  2","  473","  22"
"3374","los angeles","2020-05-28","2054","23608","1275","570","21554"," 705"
"3375","calaveras","2020-05-28","   1","   50","  10","  1","   49","   9"
"3376","san benito","2020-05-28","   0","   25","   0","  0","   25","   0"
"3377","yolo","2020-05-28","   0","  186","   8","  0","  186","   8"
"3378","imperial","2020-05-28","  68","  199","  10"," 20","  131"," -10"
"3379","fresno","2020-05-28"," 107"," 2131","  82"," 18"," 2024","  64"
"3380","tuolumne","2020-05-28","   0","  151","   2","  0","  151","   2"
"3381","el dorado","2020-05-28","   6","  199","   8","  6","  193","   2"
"3382","amador","2020-05-28","   1","   51","   4","  0","   50","   4"
"3383","sutter","2020-05-28","   0","   14","   0","  0","   14","   0"
"3384","riverside","2020-05-28"," 301"," 4000"," 134"," 85"," 3699","  49"
"3385","inyo","2020-05-28","   0","   42","   4","  0","   42","   4"
"3386","mono","2020-05-28","   0","   40","   2","  0","   40","   2"
"3387","trinity","2020-05-28","   3","   54","   0","  0","   51","   0"
"3388","kings","2020-05-28","  25","  199","   2","  7","  174","  -5"
"3389","san bernardino","2020-05-28"," 243"," 4821"," 186"," 70"," 4578"," 116"
"3390","nevada","2020-05-28","   3","  128","   5","  2","  125","   3"
"3391","tehama","2020-05-28","   0","  106","   4","  0","  106","   4"
"3392","sonoma","2020-05-28","  38","  871","  46","  4","  833","  42"
"3393","solano","2020-05-28","  35","  707","  40","  8","  672","  32"
"3394","lake","2020-05-28","   1","  110","   0","  0","  109","   0"
"3395","napa","2020-05-28","   2","  387","   1","  1","  385","   0"
"3396","tulare","2020-05-28","  39","  920","   8"," 11","  881","  -3"
"3397","san francisco","2020-05-28","  91"," 2619","  83"," 29"," 2528","  54"
"3398","lassen","2020-05-28","   1","   25","   0","  0","   24","   0"
"3399","modoc","2020-05-28","   0","   41","   0","  0","   41","   0"
"3400","colusa","2020-05-28","   0","   88","   6","  0","   88","   6"
"3401","yuba","2020-05-28","   1","  445","  11","  0","  444","  11"
"3402","san diego","2020-05-28"," 383"," 6238"," 317","153"," 5855"," 164"
"3403","stanislaus","2020-05-28","  23"," 1369","  78","  7"," 1346","  71"
"3404","butte","2020-05-28","   6","  448","  22","  3","  442","  19"
"3405","san mateo","2020-05-28","  49"," 1096","  44"," 18"," 1047","  26"
"3406","contra costa","2020-05-28","  51"," 1628"," 103"," 14"," 1577","  89"
"3407","alameda","2020-05-28"," 153"," 2968"," 106"," 57"," 2815","  49"
"3408","kern","2020-05-28","  66"," 1744","  77"," 25"," 1678","  52"
"3409","marin","2020-05-28","  10","  390","  14","  1","  380","  13"
"3410","del norte","2020-05-28","   0","   51","   4","  0","   51","   4"
"3411","mendocino","2020-05-28","   3","  180","   4","  1","  177","   3"
"3412","santa cruz","2020-05-28","   3","  397","  13","  1","  394","  12"
"3413","monterey","2020-05-28","  11","  811"," 101","  3","  800","  98"
"3414","santa clara","2020-05-28","  40"," 3318"," 180"," 15"," 3278"," 165"
"3415","orange","2020-05-28"," 397"," 6993"," 403","132"," 6596"," 271"
"3416","mariposa","2020-05-28","   2","   30","   0","  0","   28","   0"
"3417","santa barbara","2020-05-28","  26","  717","  74"," 12","  691","  62"
"3418","merced","2020-05-28","   8","  242","   4","  4","  234","   0"
"3419","ventura","2020-05-28","  47"," 1353","  54"," 19"," 1306","  35"
"3420","madera","2020-05-28","   1","  528","  25","  0","  527","  25"
"3421","sutter","2020-05-29","   0","   14","   0","  0","   14","   0"
"3422","contra costa","2020-05-29","  50"," 1628"," 101"," 11"," 1578","  90"
"3423","lake","2020-05-29","   1","  110","   0","  0","  109","   0"
"3424","glenn","2020-05-29","   0","   47","   0","  0","   47","   0"
"3425","tehama","2020-05-29","   0","  106","   1","  0","  106","   1"
"3426","los angeles","2020-05-29","1972","23642","1258","549","21670"," 709"
"3427","fresno","2020-05-29"," 107"," 2145","  86"," 22"," 2038","  64"
"3428","alameda","2020-05-29"," 179"," 2968"," 118"," 54"," 2789","  64"
"3429","del norte","2020-05-29","   0","   51","   3","  0","   51","   3"
"3430","plumas","2020-05-29","   1","   45","   0","  0","   44","   0"
"3431","santa clara","2020-05-29","  48"," 3318"," 182"," 14"," 3270"," 168"
"3432","san bernardino","2020-05-29"," 229"," 4821"," 164"," 63"," 4592"," 101"
"3433","orange","2020-05-29"," 324"," 6993"," 409","108"," 6669"," 301"
"3434","stanislaus","2020-05-29","  24"," 1370","  75","  9"," 1346","  66"
"3435","san diego","2020-05-29"," 358"," 6192"," 291","154"," 5834"," 137"
"3436","merced","2020-05-29","  13","  242","   5","  5","  229","   0"
"3437","san mateo","2020-05-29","  45"," 1096","  47"," 15"," 1051","  32"
"3438","modoc","2020-05-29","   0","   41","   0","  0","   41","   0"
"3439","solano","2020-05-29","  31","  707","  38"," 10","  676","  28"
"3440","kings","2020-05-29","  28","  199","   2","  7","  171","  -5"
"3441","napa","2020-05-29","   0","  387","   4","  1","  387","   3"
"3442","trinity","2020-05-29","   0","   54","   0","  0","   54","   0"
"3443","lassen","2020-05-29","   1","   25","   0","  0","   24","   0"
"3444","colusa","2020-05-29","   0","   88","   6","  0","   88","   6"
"3445","san joaquin","2020-05-29","  41"," 1366","  17"," 11"," 1325","   6"
"3446","sonoma","2020-05-29","  44","  871","  51","  8","  827","  43"
"3447","sacramento","2020-05-29","  37"," 2416","  84"," 17"," 2379","  67"
"3448","tulare","2020-05-29","  40","  920","  17"," 13","  880","   4"
"3449","mariposa","2020-05-29","   2","   30","   0","  0","   28","   0"
"3450","san luis obispo","2020-05-29","   8","  469","  13","  6","  461","   7"
"3451","shasta","2020-05-29","   0","  667","   9","  0","  667","   9"
"3452","el dorado","2020-05-29","   6","  199","   8","  4","  193","   4"
"3453","ventura","2020-05-29","  47"," 1352","  47"," 16"," 1305","  31"
"3454","siskiyou","2020-05-29","   1","   65","   5","  0","   64","   5"
"3455","san benito","2020-05-29","   0","   25","   1","  0","   25","   1"
"3456","santa cruz","2020-05-29","  12","  397","  18","  1","  385","  17"
"3457","butte","2020-05-29","   6","  448","  18","  2","  442","  16"
"3458","inyo","2020-05-29","   0","   42","   3","  0","   42","   3"
"3459","humboldt","2020-05-29","  13","  352","   7","  0","  339","   7"
"3460","yuba","2020-05-29","   1","  445","  11","  0","  444","  11"
"3461","tuolumne","2020-05-29","   0","  151","   2","  0","  151","   2"
"3462","nevada","2020-05-29","   2","  130","   8","  0","  128","   8"
"3463","calaveras","2020-05-29","   2","   50","   9","  2","   48","   7"
"3464","madera","2020-05-29","   0","  528","  22","  0","  528","  22"
"3465","marin","2020-05-29","  10","  390","  19","  2","  380","  17"
"3466","riverside","2020-05-29"," 270"," 3994"," 128"," 76"," 3724","  52"
"3467","monterey","2020-05-29","  11","  811"," 116","  3","  800"," 113"
"3468","mono","2020-05-29","   0","   40","   2","  0","   40","   2"
"3469","kern","2020-05-29","  70"," 1741","  70"," 29"," 1671","  41"
"3470","santa barbara","2020-05-29","  27","  717","  76"," 12","  690","  64"
"3471","yolo","2020-05-29","   0","  186","   5","  0","  186","   5"
"3472","mendocino","2020-05-29","   2","  180","   3","  1","  178","   2"
"3473","amador","2020-05-29","   0","   51","   3","  0","   51","   3"
"3474","placer","2020-05-29","  23","  753","  35","  5","  730","  30"
"3475","san francisco","2020-05-29","  65"," 2619","  88"," 25"," 2554","  63"
"3476","imperial","2020-05-29","  64","  192","  11"," 18","  128","  -7"
"3477","del norte","2020-05-30","   0","   51","   3","  0","   51","   3"
"3478","mono","2020-05-30","   0","   40","   2","  0","   40","   2"
"3479","inyo","2020-05-30","   0","   42","   3","  0","   42","   3"
"3480","amador","2020-05-30","   0","   51","   4","  0","   51","   4"
"3481","calaveras","2020-05-30","   2","   50","   9","  2","   48","   7"
"3482","orange","2020-05-30"," 422"," 6993"," 396","148"," 6571"," 248"
"3483","sacramento","2020-05-30","  37"," 2402","  86"," 17"," 2365","  69"
"3484","colusa","2020-05-30","   0","   88","   6","  0","   88","   6"
"3485","contra costa","2020-05-30","  46"," 1628","  97"," 11"," 1582","  86"
"3486","monterey","2020-05-30","  11","  811","  95","  3","  800","  92"
"3487","ventura","2020-05-30","  46"," 1332","  42"," 23"," 1286","  19"
"3488","mariposa","2020-05-30","   2","   30","   0","  0","   28","   0"
"3489","san mateo","2020-05-30","  57"," 1096","  51"," 15"," 1039","  36"
"3490","placer","2020-05-30","  22","  753","  42","  4","  731","  38"
"3491","fresno","2020-05-30"," 118"," 2147","  89"," 19"," 2029","  70"
"3492","madera","2020-05-30","   3","  528","  17","  0","  525","  17"
"3493","san francisco","2020-05-30","  64"," 2619","  78"," 25"," 2555","  53"
"3494","tuolumne","2020-05-30","   0","  151","   4","  0","  151","   4"
"3495","humboldt","2020-05-30","  17","  352","   4","  1","  335","   3"
"3496","stanislaus","2020-05-30","  22"," 1369","  77"," 10"," 1347","  67"
"3497","plumas","2020-05-30","   1","   45","   0","  0","   44","   0"
"3498","mendocino","2020-05-30","   2","  180","   4","  1","  178","   3"
"3499","shasta","2020-05-30","   1","  667","  10","  1","  666","   9"
"3500","el dorado","2020-05-30","   7","  199","   8","  7","  192","   1"
"3501","san bernardino","2020-05-30"," 225"," 4821"," 203"," 64"," 4596"," 139"
"3502","glenn","2020-05-30","   0","   47","   0","  0","   47","   0"
"3503","sonoma","2020-05-30","  61","  871","  46"," 12","  810","  34"
"3504","los angeles","2020-05-30","1934","23636","1288","540","21702"," 748"
"3505","siskiyou","2020-05-30","   0","   65","   2","  1","   65","   1"
"3506","kings","2020-05-30","  28","  199","   0","  9","  171","  -9"
"3507","tehama","2020-05-30","   0","  106","   8","  0","  106","   8"
"3508","yolo","2020-05-30","   0","  186","   3","  0","  186","   3"
"3509","sutter","2020-05-30","   0","   14","   0","  0","   14","   0"
"3510","tulare","2020-05-30","  39","  920","  19"," 14","  881","   5"
"3511","solano","2020-05-30","  29","  707","  39","  9","  678","  30"
"3512","kern","2020-05-30","  76"," 1564","  72"," 31"," 1488","  41"
"3513","modoc","2020-05-30","   0","   41","   0","  0","   41","   0"
"3514","riverside","2020-05-30"," 269"," 3954"," 133"," 76"," 3685","  57"
"3515","marin","2020-05-30","   8","  390","  18","  1","  382","  17"
"3516","santa cruz","2020-05-30","  12","  397","  18","  1","  385","  17"
"3517","alameda","2020-05-30"," 146"," 2968"," 126"," 50"," 2822","  76"
"3518","butte","2020-05-30","   6","  448","  24","  2","  442","  22"
"3519","san luis obispo","2020-05-30","   5","  464","  13","  3","  459","  10"
"3520","lassen","2020-05-30","   1","   25","   0","  0","   24","   0"
"3521","san joaquin","2020-05-30","  42"," 1366","  15"," 14"," 1324","   1"
"3522","santa clara","2020-05-30","  46"," 3318"," 175"," 11"," 3272"," 164"
"3523","santa barbara","2020-05-30","  26","  717","  90"," 10","  691","  80"
"3524","trinity","2020-05-30","   0","   54","   0","  0","   54","   0"
"3525","imperial","2020-05-30","  81","  217","   6"," 22","  136"," -16"
"3526","lake","2020-05-30","   0","  110","   0","  0","  110","   0"
"3527","napa","2020-05-30","   4","  387","   1","  2","  383","  -1"
"3528","yuba","2020-05-30","   1","  445","  12","  0","  444","  12"
"3529","nevada","2020-05-30","   1","  126","   8","  0","  125","   8"
"3530","san benito","2020-05-30","   0","   25","   2","  0","   25","   2"
"3531","san diego","2020-05-30"," 397"," 6197"," 302","161"," 5800"," 141"
"3532","merced","2020-05-30","  14","  242","   4","  4","  228","   0"
"3533","siskiyou","2020-05-31","   0","   65","   1","  1","   65","   0"
"3534","san francisco","2020-05-31","  69"," 2619","  91"," 26"," 2550","  65"
"3535","modoc","2020-05-31","   0","   41","   0","  0","   41","   0"
"3536","riverside","2020-05-31"," 294"," 3954"," 141"," 77"," 3660","  64"
"3537","imperial","2020-05-31","  80","  217","   6"," 22","  137"," -16"
"3538","inyo","2020-05-31","   0","   42","   4","  0","   42","   4"
"3539","san diego","2020-05-31"," 398"," 6120"," 327","153"," 5722"," 174"
"3540","yuba","2020-05-31","   1","  445","  12","  0","  444","  12"
"3541","madera","2020-05-31","   4","  528","  23","  1","  524","  22"
"3542","sacramento","2020-05-31","  34"," 2393","  94","  9"," 2359","  85"
"3543","trinity","2020-05-31","   1","   54","   0","  0","   53","   0"
"3544","lassen","2020-05-31","   1","   25","   0","  0","   24","   0"
"3545","glenn","2020-05-31","   0","   47","   0","  0","   47","   0"
"3546","del norte","2020-05-31","   1","   51","   4","  1","   50","   3"
"3547","sutter","2020-05-31","   0","   14","   0","  0","   14","   0"
"3548","amador","2020-05-31","   0","   51","   0","  0","   51","   0"
"3549","mariposa","2020-05-31","   0","   30","   0","  0","   30","   0"
"3550","nevada","2020-05-31","   0","  127","   3","  0","  127","   3"
"3551","tulare","2020-05-31","  36","  920","  13"," 13","  884","   0"
"3552","santa barbara","2020-05-31","  26","  717","  89","  9","  691","  80"
"3553","san luis obispo","2020-05-31","   4","  455","  20","  4","  451","  16"
"3554","butte","2020-05-31","   5","  448","  22","  2","  443","  20"
"3555","monterey","2020-05-31","   9","  811","  98","  4","  802","  94"
"3556","humboldt","2020-05-31","  10","  352","   8","  0","  342","   8"
"3557","san mateo","2020-05-31","  56"," 1096","  39"," 27"," 1040","  12"
"3558","ventura","2020-05-31","  46"," 1329","  40"," 16"," 1283","  24"
"3559","lake","2020-05-31","   1","  110","   0","  0","  109","   0"
"3560","calaveras","2020-05-31","   1","   50","   9","  1","   49","   8"
"3561","mendocino","2020-05-31","   1","  180","   2","  1","  179","   1"
"3562","alameda","2020-05-31"," 132"," 2968"," 131"," 45"," 2836","  86"
"3563","marin","2020-05-31","   8","  390","  17","  1","  382","  16"
"3564","sonoma","2020-05-31","  49","  871","  48"," 10","  822","  38"
"3565","napa","2020-05-31","   2","  387","  11","  0","  385","  11"
"3566","stanislaus","2020-05-31","  33"," 1369","  85","  8"," 1336","  77"
"3567","tehama","2020-05-31","   0","  106","   7","  0","  106","   7"
"3568","yolo","2020-05-31","   0","  186","   3","  0","  186","   3"
"3569","mono","2020-05-31","   0","   40","   2","  0","   40","   2"
"3570","solano","2020-05-31","  29","  707","  38","  6","  678","  32"
"3571","kings","2020-05-31","  30","  199","   0"," 10","  169"," -10"
"3572","tuolumne","2020-05-31","   0","  151","   3","  0","  151","   3"
"3573","santa cruz","2020-05-31","  13","  397","  18","  1","  384","  17"
"3574","contra costa","2020-05-31","  43"," 1628","  94"," 12"," 1585","  82"
"3575","san bernardino","2020-05-31"," 209"," 4821"," 205"," 63"," 4612"," 142"
"3576","fresno","2020-05-31"," 120"," 2138","  83"," 28"," 2018","  55"
"3577","placer","2020-05-31","  18","  753","  39","  3","  735","  36"
"3578","shasta","2020-05-31","   1","  667","  11","  1","  666","  10"
"3579","el dorado","2020-05-31","   7","  199","   4","  4","  192","   0"
"3580","colusa","2020-05-31","   1","   88","   6","  0","   87","   6"
"3581","san benito","2020-05-31","   0","   25","   2","  0","   25","   2"
"3582","kern","2020-05-31","  75"," 1732","  64"," 32"," 1657","  32"
"3583","merced","2020-05-31","  11","  242","   5","  4","  231","   1"
"3584","orange","2020-05-31"," 407"," 6993"," 408","142"," 6586"," 266"
"3585","plumas","2020-05-31","   1","   45","   0","  0","   44","   0"
"3586","los angeles","2020-05-31","1908","23606","1316","511","21698"," 805"
"3587","santa clara","2020-05-31","  38"," 3318"," 196"," 11"," 3280"," 185"
"3588","san joaquin","2020-05-31","  45"," 1366","  18"," 14"," 1321","   4"
"3589","lake","2020-06-01","   2","  110","   2","  1","  108","   1"
"3590","riverside","2020-06-01"," 307"," 3969"," 148"," 76"," 3662","  72"
"3591","napa","2020-06-01","   2","  387","   6","  0","  385","   6"
"3592","yuba","2020-06-01","   1","  445","  14","  0","  444","  14"
"3593","sacramento","2020-06-01","  32"," 2409"," 103"," 13"," 2377","  90"
"3594","nevada","2020-06-01","   1","  131","   6","  0","  130","   6"
"3595","calaveras","2020-06-01","   1","   50","   9","  1","   49","   8"
"3596","lassen","2020-06-01","   1","   25","   0","  0","   24","   0"
"3597","san luis obispo","2020-06-01","   6","  454","  22","  3","  448","  19"
"3598","tulare","2020-06-01","  35","  920","  14"," 12","  885","   2"
"3599","butte","2020-06-01","   4","  448","  17","  2","  444","  15"
"3600","marin","2020-06-01","   5","  390","  22","  1","  385","  21"
"3601","humboldt","2020-06-01","  10","  352","   7","  0","  342","   7"
"3602","san mateo","2020-06-01","  46"," 1096","  42"," 11"," 1050","  31"
"3603","stanislaus","2020-06-01","  33"," 1369","  79","  8"," 1336","  71"
"3604","plumas","2020-06-01","   0","   45","   0","  0","   45","   0"
"3605","orange","2020-06-01"," 405"," 6993"," 430","141"," 6588"," 289"
"3606","del norte","2020-06-01","   0","   51","   4","  0","   51","   4"
"3607","shasta","2020-06-01","   1","  667","   8","  1","  666","   7"
"3608","san joaquin","2020-06-01","  48"," 1366","  26"," 16"," 1318","  10"
"3609","san bernardino","2020-06-01"," 217"," 4821"," 186"," 79"," 4604"," 107"
"3610","santa clara","2020-06-01","  40"," 3318"," 192"," 11"," 3278"," 181"
"3611","sonoma","2020-06-01","  67","  871","  50","  7","  804","  43"
"3612","san diego","2020-06-01"," 397"," 6121"," 317","166"," 5724"," 151"
"3613","el dorado","2020-06-01","   6","  199","   8","  4","  193","   4"
"3614","san benito","2020-06-01","   0","   25","   3","  0","   25","   3"
"3615","mono","2020-06-01","   0","   40","   2","  0","   40","   2"
"3616","placer","2020-06-01","  17","  753","  38","  3","  736","  35"
"3617","amador","2020-06-01","   0","   51","   4","  0","   51","   4"
"3618","tuolumne","2020-06-01","   0","  151","   0","  0","  151","   0"
"3619","imperial","2020-06-01","  71","  193","   8"," 21","  122"," -13"
"3620","mariposa","2020-06-01","   0","   30","   0","  0","   30","   0"
"3621","solano","2020-06-01","  37","  707","  41","  9","  670","  32"
"3622","sutter","2020-06-01","   0","   14","   0","  0","   14","   0"
"3623","merced","2020-06-01","   8","  242","   5","  3","  234","   2"
"3624","san francisco","2020-06-01","  74"," 2619","  85"," 20"," 2545","  65"
"3625","inyo","2020-06-01","   0","   42","   4","  0","   42","   4"
"3626","siskiyou","2020-06-01","   3","   65","   5","  1","   62","   4"
"3627","alameda","2020-06-01"," 148"," 2968"," 134"," 46"," 2820","  88"
"3628","fresno","2020-06-01"," 122"," 2142"," 393"," 23"," 2020"," 370"
"3629","monterey","2020-06-01","   9","  811"," 100","  4","  802","  96"
"3630","ventura","2020-06-01","  45"," 1317","  36"," 13"," 1272","  23"
"3631","contra costa","2020-06-01","  30"," 1628"," 100"," 13"," 1598","  87"
"3632","glenn","2020-06-01","   0","   47","   0","  0","   47","   0"
"3633","santa barbara","2020-06-01","  29","  717","  80"," 10","  688","  70"
"3634","modoc","2020-06-01","   0","   41","   0","  0","   41","   0"
"3635","colusa","2020-06-01","   1","   88","   6","  0","   87","   6"
"3636","santa cruz","2020-06-01","   4","  397","  18","  3","  393","  15"
"3637","tehama","2020-06-01","   0","  106","   3","  0","  106","   3"
"3638","mendocino","2020-06-01","   1","  180","   2","  2","  179","   0"
"3639","los angeles","2020-06-01","2018","23614","1305","530","21596"," 775"
"3640","yolo","2020-06-01","   0","  186","   4","  0","  186","   4"
"3641","trinity","2020-06-01","   1","   54","   0","  0","   53","   0"
"3642","kings","2020-06-01","  28","  199","   2","  8","  171","  -6"
"3643","madera","2020-06-01","   3","  528","  22","  1","  525","  21"
"3644","kern","2020-06-01","  77"," 1722","  69"," 33"," 1645","  36"
"3645","nevada","2020-06-02","   1","  135","   7","  0","  134","   7"
"3646","imperial","2020-06-02","  67","  237","   8"," 18","  170"," -10"
"3647","del norte","2020-06-02","   0","   51","   2","  0","   51","   2"
"3648","el dorado","2020-06-02","   8","  199","   2","  6","  191","  -4"
"3649","kings","2020-06-02","  32","  199","   6","  8","  167","  -2"
"3650","san luis obispo","2020-06-02","   4","  460","  23","  2","  456","  21"
"3651","santa barbara","2020-06-02","  28","  717","  84","  9","  689","  75"
"3652","san benito","2020-06-02","   0","   25","   2","  0","   25","   2"
"3653","trinity","2020-06-02","   2","   54","   0","  0","   52","   0"
"3654","lake","2020-06-02","   2","  110","   0","  0","  108","   0"
"3655","tehama","2020-06-02","   0","  106","   4","  0","  106","   4"
"3656","san diego","2020-06-02"," 369"," 6143"," 301","158"," 5774"," 143"
"3657","butte","2020-06-02","   6","  448","  15","  1","  442","  14"
"3658","riverside","2020-06-02"," 305"," 3979"," 127"," 80"," 3674","  47"
"3659","yolo","2020-06-02","   0","  186","   2","  0","  186","   2"
"3660","napa","2020-06-02","   2","  387","   6","  0","  385","   6"
"3661","sonoma","2020-06-02","  72","  871","  52","  7","  799","  45"
"3662","colusa","2020-06-02","   1","   88","   5","  1","   87","   4"
"3663","glenn","2020-06-02","   0","   47","   0","  0","   47","   0"
"3664","contra costa","2020-06-02","  56"," 1628","  94"," 20"," 1572","  74"
"3665","mendocino","2020-06-02","   1","  180","   4","  1","  179","   3"
"3666","solano","2020-06-02","  32","  707","  41","  9","  675","  32"
"3667","merced","2020-06-02","   6","  242","   2","  3","  236","  -1"
"3668","madera","2020-06-02","  10","  528","  19","  2","  518","  17"
"3669","sacramento","2020-06-02","  42"," 2405","  78"," 19"," 2363","  59"
"3670","yuba","2020-06-02","   1","  445","  15","  0","  444","  15"
"3671","tulare","2020-06-02","  34","  920","  25"," 12","  886","  13"
"3672","marin","2020-06-02","  11","  390","  17","  2","  379","  15"
"3673","modoc","2020-06-02","   0","   41","   0","  0","   41","   0"
"3674","santa cruz","2020-06-02","   5","  397","  16","  1","  392","  15"
"3675","lassen","2020-06-02","   1","   25","   0","  0","   24","   0"
"3676","santa clara","2020-06-02","  49"," 3318"," 177"," 17"," 3269"," 160"
"3677","mariposa","2020-06-02","   0","   30","   0","  0","   30","   0"
"3678","mono","2020-06-02","   0","   40","   2","  0","   40","   2"
"3679","monterey","2020-06-02","  12","  811","  98","  4","  799","  94"
"3680","calaveras","2020-06-02","   1","   50","   8","  1","   49","   7"
"3681","san francisco","2020-06-02","  71"," 2647","  76"," 26"," 2576","  50"
"3682","amador","2020-06-02","   0","   51","   3","  0","   51","   3"
"3683","placer","2020-06-02","  27","  753","  38","  4","  726","  34"
"3684","kern","2020-06-02","  82"," 1732","  67"," 34"," 1650","  33"
"3685","san joaquin","2020-06-02","  52"," 1366","  20"," 15"," 1314","   5"
"3686","los angeles","2020-06-02","2027","23620","1276","524","21593"," 752"
"3687","san bernardino","2020-06-02"," 226"," 4821"," 189"," 76"," 4595"," 113"
"3688","fresno","2020-06-02"," 101"," 2126","  90"," 18"," 2025","  72"
"3689","stanislaus","2020-06-02","  36"," 1374","  68"," 10"," 1338","  58"
"3690","san mateo","2020-06-02","  59"," 1096","  31"," 18"," 1037","  13"
"3691","sutter","2020-06-02","   0","   14","   0","  0","   14","   0"
"3692","inyo","2020-06-02","   0","   42","   4","  0","   42","   4"
"3693","shasta","2020-06-02","   1","  667","   6","  1","  666","   5"
"3694","ventura","2020-06-02","  46"," 1343","  34"," 19"," 1297","  15"
"3695","alameda","2020-06-02"," 160"," 2968"," 131"," 38"," 2808","  93"
"3696","tuolumne","2020-06-02","   0","  151","   1","  0","  151","   1"
"3697","siskiyou","2020-06-02","   3","   65","   5","  1","   62","   4"
"3698","orange","2020-06-02"," 398"," 6993"," 388","148"," 6595"," 240"
"3699","humboldt","2020-06-02","   9","  352","   7","  0","  343","   7"
"3700","plumas","2020-06-02","   0","   45","   0","  0","   45","   0"
"3701","yolo","2020-06-03","   0","  186","   3","  0","  186","   3"
"3702","mendocino","2020-06-03","   1","  180","   3","  1","  179","   2"
"3703","inyo","2020-06-03","   0","   42","   4","  0","   42","   4"
"3704","shasta","2020-06-03","   1","  667","   4","  0","  666","   4"
"3705","mono","2020-06-03","   0","   40","   1","  0","   40","   1"
"3706","del norte","2020-06-03","   0","   51","   0","  0","   51","   0"
"3707","madera","2020-06-03","   0","  528","  19","  1","  528","  18"
"3708","nevada","2020-06-03","   0","  131","   6","  0","  131","   6"
"3709","santa cruz","2020-06-03","   3","  397","  12","  1","  394","  11"
"3710","humboldt","2020-06-03","   6","  352","   7","  0","  346","   7"
"3711","el dorado","2020-06-03","   7","  199","  10","  6","  192","   4"
"3712","placer","2020-06-03","  34","  753","  41","  4","  719","  37"
"3713","san benito","2020-06-03","   0","   25","   2","  0","   25","   2"
"3714","modoc","2020-06-03","   0","   41","   0","  0","   41","   0"
"3715","san francisco","2020-06-03","  71"," 2647","  80"," 21"," 2576","  59"
"3716","tulare","2020-06-03","  39","  920","   6","  8","  881","  -2"
"3717","ventura","2020-06-03","  43"," 1337","  34"," 13"," 1294","  21"
"3718","stanislaus","2020-06-03","  41"," 1369","  75","  8"," 1328","  67"
"3719","calaveras","2020-06-03","   1","   50","   8","  1","   49","   7"
"3720","monterey","2020-06-03","  12","  811","  96","  4","  799","  92"
"3721","plumas","2020-06-03","   0","   45","   0","  0","   45","   0"
"3722","santa clara","2020-06-03","  57"," 3318"," 184"," 14"," 3261"," 170"
"3723","alameda","2020-06-03"," 169"," 2968"," 144"," 38"," 2799"," 106"
"3724","san joaquin","2020-06-03","  60"," 1366","  21"," 15"," 1306","   6"
"3725","napa","2020-06-03","   2","  387","   5","  0","  385","   5"
"3726","kern","2020-06-03","  75"," 1759","  74"," 36"," 1684","  38"
"3727","lassen","2020-06-03","   1","   25","   0","  0","   24","   0"
"3728","santa barbara","2020-06-03","  25","  717","  79"," 10","  692","  69"
"3729","san luis obispo","2020-06-03","   3","  466","  21","  3","  463","  18"
"3730","lake","2020-06-03","   1","  110","   2","  0","  109","   2"
"3731","tuolumne","2020-06-03","   0","  151","   0","  0","  151","   0"
"3732","colusa","2020-06-03","   0","   88","   6","  0","   88","   6"
"3733","merced","2020-06-03","   4","  242","   2","  3","  238","  -1"
"3734","riverside","2020-06-03"," 322"," 4001"," 137"," 85"," 3679","  52"
"3735","sonoma","2020-06-03","  79","  871","  50"," 10","  792","  40"
"3736","yuba","2020-06-03","   2","  445","  19","  0","  443","  19"
"3737","san mateo","2020-06-03","  66"," 1101","  36"," 21"," 1035","  15"
"3738","butte","2020-06-03","   4","  448","  22","  0","  444","  22"
"3739","san diego","2020-06-03"," 370"," 6214"," 288","158"," 5844"," 130"
"3740","contra costa","2020-06-03","  67"," 1628"," 101"," 16"," 1561","  85"
"3741","imperial","2020-06-03","  73","  237","   6"," 17","  164"," -11"
"3742","siskiyou","2020-06-03","   1","   65","   6","  1","   64","   5"
"3743","orange","2020-06-03"," 376"," 6993"," 387","134"," 6617"," 253"
"3744","kings","2020-06-03","  32","  199","   2","  7","  167","  -5"
"3745","tehama","2020-06-03","   0","  106","   5","  0","  106","   5"
"3746","solano","2020-06-03","  23","  707","  48","  5","  684","  43"
"3747","mariposa","2020-06-03","   0","   30","   0","  0","   30","   0"
"3748","marin","2020-06-03","  11","  390","  19","  3","  379","  16"
"3749","trinity","2020-06-03","   2","   54","   0","  0","   52","   0"
"3750","san bernardino","2020-06-03"," 232"," 4821"," 178"," 85"," 4589","  93"
"3751","los angeles","2020-06-03","1990","23607","1239","513","21617"," 726"
"3752","fresno","2020-06-03","  97"," 2126","  88"," 19"," 2029","  69"
"3753","sacramento","2020-06-03","  52"," 2418","  94"," 18"," 2366","  76"
"3754","amador","2020-06-03","   0","   51","   2","  0","   51","   2"
"3755","glenn","2020-06-03","   0","   47","   0","  0","   47","   0"
"3756","sutter","2020-06-03","   0","   14","   0","  0","   14","   0"
"3757","san francisco","2020-06-04","  62"," 2647","  87"," 19"," 2585","  68"
"3758","lake","2020-06-04","   4","  110","   1","  1","  106","   0"
"3759","kern","2020-06-04","  76"," 1756","  78"," 35"," 1680","  43"
"3760","shasta","2020-06-04","   2","  667","   5","  0","  665","   5"
"3761","mono","2020-06-04","   0","   40","   2","  0","   40","   2"
"3762","ventura","2020-06-04","  50"," 1333","  34"," 12"," 1283","  22"
"3763","san mateo","2020-06-04","  53"," 1101","  48"," 14"," 1048","  34"
"3764","mariposa","2020-06-04","   0","   30","   0","  0","   30","   0"
"3765","tulare","2020-06-04","  41","  920","   3"," 10","  879","  -7"
"3766","orange","2020-06-04"," 410"," 6993"," 393","141"," 6583"," 252"
"3767","san diego","2020-06-04"," 379"," 6218"," 292","153"," 5839"," 139"
"3768","lassen","2020-06-04","   1","   25","   0","  0","   24","   0"
"3769","kings","2020-06-04","  33","  199","   3","  7","  166","  -4"
"3770","nevada","2020-06-04","   0","  125","   5","  0","  125","   5"
"3771","santa barbara","2020-06-04","  38","  717","  65"," 11","  679","  54"
"3772","plumas","2020-06-04","   0","   45","   0","  0","   45","   0"
"3773","amador","2020-06-04","   0","   51","   2","  0","   51","   2"
"3774","los angeles","2020-06-04","2048","23715","1249","552","21667"," 697"
"3775","santa cruz","2020-06-04","   5","  397","  16","  1","  392","  15"
"3776","humboldt","2020-06-04","   2","  352","   2","  2","  350","   0"
"3777","placer","2020-06-04","  46","  753","  47","  5","  707","  42"
"3778","san luis obispo","2020-06-04","   2","  464","  23","  2","  462","  21"
"3779","monterey","2020-06-04","  14","  811","  95","  3","  797","  92"
"3780","santa clara","2020-06-04","  75"," 3318"," 176"," 21"," 3243"," 155"
"3781","sonoma","2020-06-04","  58","  871","  51","  9","  813","  42"
"3782","yuba","2020-06-04","   3","  445","  14","  1","  442","  13"
"3783","glenn","2020-06-04","   0","   47","   0","  0","   47","   0"
"3784","yolo","2020-06-04","   0","  186","   0","  0","  186","   0"
"3785","siskiyou","2020-06-04","   1","   65","   5","  0","   64","   5"
"3786","tuolumne","2020-06-04","   1","  151","   0","  0","  150","   0"
"3787","sacramento","2020-06-04","  61"," 2423"," 103"," 21"," 2362","  82"
"3788","san joaquin","2020-06-04","  55"," 1366","  18"," 15"," 1311","   3"
"3789","alameda","2020-06-04"," 174"," 2968"," 157"," 41"," 2794"," 116"
"3790","stanislaus","2020-06-04","  45"," 1369","  78"," 10"," 1324","  68"
"3791","contra costa","2020-06-04","  88"," 1628"," 101"," 17"," 1540","  84"
"3792","inyo","2020-06-04","   0","   42","   2","  0","   42","   2"
"3793","el dorado","2020-06-04","   6","  199","   7","  4","  193","   3"
"3794","riverside","2020-06-04"," 317"," 4025"," 122"," 93"," 3708","  29"
"3795","fresno","2020-06-04"," 101"," 2136","  95"," 19"," 2035","  76"
"3796","merced","2020-06-04","   7","  242","   4","  3","  235","   1"
"3797","solano","2020-06-04","  31","  707","  48","  5","  676","  43"
"3798","del norte","2020-06-04","   0","   51","   1","  0","   51","   1"
"3799","imperial","2020-06-04","  77","  237","   4"," 18","  160"," -14"
"3800","mendocino","2020-06-04","   1","  180","   2","  2","  179","   0"
"3801","napa","2020-06-04","   3","  397","   0","  1","  394","  -1"
"3802","san bernardino","2020-06-04"," 238"," 4821"," 169"," 81"," 4583","  88"
"3803","colusa","2020-06-04","   0","   88","   6","  0","   88","   6"
"3804","butte","2020-06-04","   4","  448","  22","  0","  444","  22"
"3805","madera","2020-06-04","   2","  528","  24","  1","  526","  23"
"3806","san benito","2020-06-04","   0","   25","   2","  0","   25","   2"
"3807","sutter","2020-06-04","   0","   14","   0","  0","   14","   0"
"3808","modoc","2020-06-04","   0","   41","   0","  0","   41","   0"
"3809","tehama","2020-06-04","   0","  106","   2","  0","  106","   2"
"3810","calaveras","2020-06-04","   0","   50","  10","  0","   50","  10"
"3811","marin","2020-06-04","  10","  390","  13","  3","  380","  10"
"3812","trinity","2020-06-04","   1","   54","   0","  0","   53","   0"
"3813","san francisco","2020-06-05","  64"," 2658","  98"," 18"," 2594","  80"
"3814","merced","2020-06-05","   5","  242","   3","  2","  237","   1"
"3815","tehama","2020-06-05","   0","  106","   4","  0","  106","   4"
"3816","yuba","2020-06-05","   3","  445","  13","  2","  442","  11"
"3817","madera","2020-06-05","   5","  528","  19","  3","  523","  16"
"3818","amador","2020-06-05","   0","   51","   2","  0","   51","   2"
"3819","santa clara","2020-06-05","  75"," 3375"," 206"," 24"," 3300"," 182"
"3820","colusa","2020-06-05","   0","   88","   6","  0","   88","   6"
"3821","ventura","2020-06-05","  50"," 1357","  45"," 12"," 1307","  33"
"3822","plumas","2020-06-05","   0","   45","   0","  0","   45","   0"
"3823","siskiyou","2020-06-05","   1","   65","   6","  0","   64","   6"
"3824","riverside","2020-06-05"," 326"," 4023"," 129"," 99"," 3697","  30"
"3825","humboldt","2020-06-05","   1","  352","   1","  0","  351","   1"
"3826","imperial","2020-06-05","  82","  237","   7"," 15","  155","  -8"
"3827","marin","2020-06-05","  11","  390","  16","  0","  379","  16"
"3828","orange","2020-06-05"," 395"," 6973"," 401","142"," 6578"," 259"
"3829","fresno","2020-06-05","  97"," 2129","  91"," 19"," 2032","  72"
"3830","nevada","2020-06-05","   2","  130","   4","  0","  128","   4"
"3831","modoc","2020-06-05","   0","   41","   0","  0","   41","   0"
"3832","san luis obispo","2020-06-05","   6","  483","  27","  2","  477","  25"
"3833","sacramento","2020-06-05","  72"," 2424","  95"," 21"," 2352","  74"
"3834","shasta","2020-06-05","   0","  667","   4","  0","  667","   4"
"3835","stanislaus","2020-06-05","  39"," 1369","  76","  9"," 1330","  67"
"3836","del norte","2020-06-05","   0","   51","   2","  0","   51","   2"
"3837","solano","2020-06-05","  33","  707","  45","  5","  674","  40"
"3838","tulare","2020-06-05","  41","  920","   8","  7","  879","   1"
"3839","monterey","2020-06-05","  15","  811","  92","  3","  796","  89"
"3840","kern","2020-06-05","  78"," 1756","  80"," 34"," 1678","  46"
"3841","sonoma","2020-06-05","  72","  871","  54"," 10","  799","  44"
"3842","mono","2020-06-05","   0","   40","   2","  0","   40","   2"
"3843","calaveras","2020-06-05","   0","   50","  10","  0","   50","  10"
"3844","alameda","2020-06-05"," 150"," 2968"," 154"," 40"," 2818"," 114"
"3845","contra costa","2020-06-05","  63"," 1628"," 105"," 12"," 1565","  93"
"3846","mariposa","2020-06-05","   0","   30","   0","  0","   30","   0"
"3847","santa barbara","2020-06-05","  37","  717","  82"," 12","  680","  70"
"3848","yolo","2020-06-05","   0","  186","   3","  0","  186","   3"
"3849","trinity","2020-06-05","   0","   54","   0","  0","   54","   0"
"3850","inyo","2020-06-05","   0","   42","   3","  0","   42","   3"
"3851","butte","2020-06-05","   2","  448","  21","  1","  446","  20"
"3852","sutter","2020-06-05","   0","   14","   0","  0","   14","   0"
"3853","san mateo","2020-06-05","  54"," 1101","  47"," 10"," 1047","  37"
"3854","mendocino","2020-06-05","   1","  180","   2","  1","  179","   1"
"3855","tuolumne","2020-06-05","   1","  151","   2","  0","  150","   2"
"3856","lake","2020-06-05","   1","  110","   2","  0","  109","   2"
"3857","santa cruz","2020-06-05","   5","  397","   9","  1","  392","   8"
"3858","el dorado","2020-06-05","   5","  199","   8","  3","  194","   5"
"3859","kings","2020-06-05","  31","  199","   1","  7","  168","  -6"
"3860","san bernardino","2020-06-05"," 243"," 4821"," 140"," 75"," 4578","  65"
"3861","san diego","2020-06-05"," 368"," 6190"," 320","153"," 5822"," 167"
"3862","san benito","2020-06-05","   0","   25","   1","  0","   25","   1"
"3863","lassen","2020-06-05","   0","   25","   0","  0","   25","   0"
"3864","placer","2020-06-05","  32","  753","  49","  7","  721","  42"
"3865","napa","2020-06-05","   3","  397","   0","  1","  394","  -1"
"3866","san joaquin","2020-06-05","  59"," 1366","  14"," 17"," 1307","  -3"
"3867","glenn","2020-06-05","   0","   47","   0","  0","   47","   0"
"3868","los angeles","2020-06-05","1998","23507","1210","548","21509"," 662"
"3869","lassen","2020-06-06","   0","   25","   0","  0","   25","   0"
"3870","del norte","2020-06-06","   0","   51","   1","  0","   51","   1"
"3871","tehama","2020-06-06","   0","  106","   2","  0","  106","   2"
"3872","kings","2020-06-06","  27","  199","   4"," 10","  172","  -6"
"3873","alameda","2020-06-06"," 155"," 2968"," 156"," 41"," 2813"," 115"
"3874","shasta","2020-06-06","   0","  667","   8","  0","  667","   8"
"3875","marin","2020-06-06","   9","  390","  18","  1","  381","  17"
"3876","solano","2020-06-06","  28","  707","  47","  5","  679","  42"
"3877","placer","2020-06-06","  34","  753","  44","  7","  719","  37"
"3878","lake","2020-06-06","   2","  110","   3","  0","  108","   3"
"3879","san diego","2020-06-06"," 361"," 6170"," 319","146"," 5809"," 173"
"3880","merced","2020-06-06","   5","  242","   4","  2","  237","   2"
"3881","san luis obispo","2020-06-06","   7","  449","  23","  3","  442","  20"
"3882","plumas","2020-06-06","   0","   45","   0","  0","   45","   0"
"3883","modoc","2020-06-06","   0","   41","   0","  0","   41","   0"
"3884","sacramento","2020-06-06","  61"," 2414","  90"," 22"," 2353","  68"
"3885","los angeles","2020-06-06","1981","23617","1233","506","21636"," 727"
"3886","trinity","2020-06-06","   0","   54","   0","  0","   54","   0"
"3887","tuolumne","2020-06-06","   0","  151","   2","  0","  151","   2"
"3888","calaveras","2020-06-06","   0","   50","  10","  0","   50","  10"
"3889","humboldt","2020-06-06","   6","  352","   3","  0","  346","   3"
"3890","santa cruz","2020-06-06","   4","  397","  11","  1","  393","  10"
"3891","madera","2020-06-06","   8","  528","  22","  1","  520","  21"
"3892","orange","2020-06-06"," 376"," 6973"," 396","148"," 6597"," 248"
"3893","ventura","2020-06-06","  61"," 1333","  40"," 17"," 1272","  23"
"3894","san joaquin","2020-06-06","  64"," 1366","  16"," 16"," 1302","   0"
"3895","nevada","2020-06-06","   2","  130","   4","  0","  128","   4"
"3896","santa barbara","2020-06-06","  33","  717","  69"," 10","  684","  59"
"3897","glenn","2020-06-06","   0","   47","   0","  0","   47","   0"
"3898","sonoma","2020-06-06","  75","  871","  52"," 11","  796","  41"
"3899","yuba","2020-06-06","   5","  445","  12","  2","  440","  10"
"3900","san mateo","2020-06-06","  58"," 1101","  53","  7"," 1043","  46"
"3901","riverside","2020-06-06"," 309"," 3958"," 141"," 91"," 3649","  50"
"3902","amador","2020-06-06","   0","   51","   4","  0","   51","   4"
"3903","siskiyou","2020-06-06","   1","   65","   6","  0","   64","   6"
"3904","imperial","2020-06-06","  83","  237","   7"," 19","  154"," -12"
"3905","napa","2020-06-06","   4","  397","   0","  1","  393","  -1"
"3906","contra costa","2020-06-06","  61"," 1628"," 107"," 10"," 1567","  97"
"3907","yolo","2020-06-06","   0","  186","   2","  0","  186","   2"
"3908","butte","2020-06-06","   1","  448","  19","  1","  447","  18"
"3909","stanislaus","2020-06-06","  35"," 1369","  69","  9"," 1334","  60"
"3910","kern","2020-06-06"," 112"," 1756","  89"," 36"," 1644","  53"
"3911","tulare","2020-06-06","  35","  920","  17","  9","  885","   8"
"3912","mendocino","2020-06-06","   1","  180","   2","  1","  179","   1"
"3913","inyo","2020-06-06","   0","   42","   4","  0","   42","   4"
"3914","san bernardino","2020-06-06"," 254"," 4821"," 147"," 84"," 4567","  63"
"3915","mariposa","2020-06-06","   0","   30","   0","  0","   30","   0"
"3916","santa clara","2020-06-06","  73"," 3375"," 202"," 23"," 3302"," 179"
"3917","monterey","2020-06-06","  13","  811","  91","  3","  798","  88"
"3918","sutter","2020-06-06","   0","   14","   0","  0","   14","   0"
"3919","san francisco","2020-06-06","  65"," 2658","  98"," 19"," 2593","  79"
"3920","el dorado","2020-06-06","   5","  199","   8","  5","  194","   3"
"3921","san benito","2020-06-06","   0","   25","   3","  0","   25","   3"
"3922","fresno","2020-06-06"," 111"," 2137","  88"," 19"," 2026","  69"
"3923","mono","2020-06-06","   0","   40","   2","  0","   40","   2"
"3924","colusa","2020-06-06","   0","   88","   4","  2","   88","   2"
"3925","sonoma","2020-06-07","  71","  871","  49"," 12","  800","  37"
"3926","colusa","2020-06-07","   0","   88","   5","  1","   88","   4"
"3927","san diego","2020-06-07"," 359"," 5907"," 333","147"," 5548"," 186"
"3928","alameda","2020-06-07"," 166"," 2968"," 152"," 40"," 2802"," 112"
"3929","santa barbara","2020-06-07","  23","  717","  66","  7","  694","  59"
"3930","napa","2020-06-07","   3","  397","   2","  1","  394","   1"
"3931","san luis obispo","2020-06-07","   5","  454","  25","  2","  449","  23"
"3932","el dorado","2020-06-07","   6","  199","   9","  3","  193","   6"
"3933","plumas","2020-06-07","   0","   45","   0","  0","   45","   0"
"3934","san francisco","2020-06-07","  48"," 2337","  88"," 14"," 2289","  74"
"3935","mendocino","2020-06-07","   1","  180","   2","  1","  179","   1"
"3936","lassen","2020-06-07","   0","   25","   0","  0","   25","   0"
"3937","monterey","2020-06-07","  13","  811","  91","  3","  798","  88"
"3938","glenn","2020-06-07","   0","   47","   0","  0","   47","   0"
"3939","madera","2020-06-07","  11","  528","  21","  2","  517","  19"
"3940","santa cruz","2020-06-07","   4","  397","  11","  1","  393","  10"
"3941","inyo","2020-06-07","   0","   42","   4","  0","   42","   4"
"3942","trinity","2020-06-07","   0","   54","   0","  0","   54","   0"
"3943","shasta","2020-06-07","   0","  667","  12","  0","  667","  12"
"3944","stanislaus","2020-06-07","  37"," 1369","  73","  9"," 1332","  64"
"3945","orange","2020-06-07"," 399"," 6973"," 398","166"," 6574"," 232"
"3946","calaveras","2020-06-07","   1","   50","  12","  0","   49","  12"
"3947","tulare","2020-06-07","  28","  729","   4","  8","  701","  -4"
"3948","contra costa","2020-06-07","  67"," 1628"," 105"," 12"," 1561","  93"
"3949","san mateo","2020-06-07","  57"," 1101","  55","  6"," 1044","  49"
"3950","kings","2020-06-07","  28","  199","   4"," 10","  171","  -6"
"3951","solano","2020-06-07","  30","  707","  46","  5","  677","  41"
"3952","amador","2020-06-07","   1","   51","   0","  0","   50","   0"
"3953","del norte","2020-06-07","   1","   51","   1","  1","   50","   0"
"3954","merced","2020-06-07","   7","  242","   4","  3","  235","   1"
"3955","fresno","2020-06-07"," 100"," 2139","  97"," 20"," 2039","  77"
"3956","kern","2020-06-07"," 107"," 1756","  82"," 38"," 1649","  44"
"3957","lake","2020-06-07","   0","  110","   4","  0","  110","   4"
"3958","mariposa","2020-06-07","   0","   30","   0","  0","   30","   0"
"3959","riverside","2020-06-07"," 296"," 3958"," 134"," 82"," 3662","  52"
"3960","tehama","2020-06-07","   0","  106","   1","  0","  106","   1"
"3961","sutter","2020-06-07","   0","   14","   0","  0","   14","   0"
"3962","yolo","2020-06-07","   2","  186","   2","  2","  184","   0"
"3963","placer","2020-06-07","  34","  753","  46","  6","  719","  40"
"3964","mono","2020-06-07","   0","   40","   2","  0","   40","   2"
"3965","sacramento","2020-06-07","  59"," 2399","  90"," 22"," 2340","  68"
"3966","tuolumne","2020-06-07","   0","  151","   3","  0","  151","   3"
"3967","yuba","2020-06-07","   5","  445","  10","  2","  440","   8"
"3968","humboldt","2020-06-07","   5","  352","   4","  0","  347","   4"
"3969","marin","2020-06-07","   7","  390","  16","  0","  383","  16"
"3970","san benito","2020-06-07","   0","   25","   2","  0","   25","   2"
"3971","san joaquin","2020-06-07","  63"," 1366","  18"," 16"," 1303","   2"
"3972","san bernardino","2020-06-07"," 221"," 4821"," 158"," 83"," 4600","  75"
"3973","los angeles","2020-06-07","2011","23659","1247","519","21648"," 728"
"3974","ventura","2020-06-07","  71"," 1329","  48"," 17"," 1258","  31"
"3975","imperial","2020-06-07","  88","  237","   7"," 18","  149"," -11"
"3976","butte","2020-06-07","   1","  448","  21","  1","  447","  20"
"3977","siskiyou","2020-06-07","   0","   65","   5","  0","   65","   5"
"3978","modoc","2020-06-07","   0","   41","   0","  0","   41","   0"
"3979","santa clara","2020-06-07","  69"," 3375"," 216"," 21"," 3306"," 195"
"3980","nevada","2020-06-07","   1","  127","   6","  0","  126","   6"
"3981","butte","2020-06-08","   4","  448","  19","  2","  444","  17"
"3982","stanislaus","2020-06-08","  39"," 1369","  78"," 12"," 1330","  66"
"3983","santa clara","2020-06-08","  61"," 3375"," 229"," 22"," 3314"," 207"
"3984","tulare","2020-06-08","  36","  743","  10","  8","  707","   2"
"3985","marin","2020-06-08","   2","  390","  16","  2","  388","  14"
"3986","glenn","2020-06-08","   0","   47","   0","  0","   47","   0"
"3987","trinity","2020-06-08","   3","   54","   0","  0","   51","   0"
"3988","san francisco","2020-06-08","  43"," 2647"," 106"," 15"," 2604","  91"
"3989","santa cruz","2020-06-08","   2","  397","  17","  0","  395","  17"
"3990","solano","2020-06-08","  28","  707","  47","  5","  679","  42"
"3991","calaveras","2020-06-08","   0","   50","  10","  0","   50","  10"
"3992","humboldt","2020-06-08","   7","  352","   3","  0","  345","   3"
"3993","sonoma","2020-06-08","  79","  871","  47"," 13","  792","  34"
"3994","el dorado","2020-06-08","   6","  235","  11","  3","  229","   8"
"3995","los angeles","2020-06-08","2053","23736","1301","521","21683"," 780"
"3996","merced","2020-06-08","   8","  242","   5","  3","  234","   2"
"3997","orange","2020-06-08"," 391"," 6976"," 410","160"," 6585"," 250"
"3998","tehama","2020-06-08","   0","  106","   5","  0","  106","   5"
"3999","san joaquin","2020-06-08","  70"," 1366","  18"," 23"," 1296","  -5"
"4000","san mateo","2020-06-08","  39"," 1101","  54","  5"," 1062","  49"
"4001","san benito","2020-06-08","   0","   25","   2","  0","   25","   2"
"4002","contra costa","2020-06-08","  55"," 1628"," 116"," 13"," 1573"," 103"
"4003","yuba","2020-06-08","   5","  445","  17","  2","  440","  15"
"4004","tuolumne","2020-06-08","   0","  151","   5","  0","  151","   5"
"4005","san bernardino","2020-06-08"," 251"," 4821"," 156"," 86"," 4570","  70"
"4006","madera","2020-06-08","   9","  528","  20","  2","  519","  18"
"4007","sutter","2020-06-08","   0","   14","   0","  0","   14","   0"
"4008","ventura","2020-06-08","  69"," 1327","  47"," 22"," 1258","  25"
"4009","mendocino","2020-06-08","   1","  180","   2","  1","  179","   1"
"4010","san diego","2020-06-08"," 371"," 6122"," 332","166"," 5751"," 166"
"4011","colusa","2020-06-08","   1","   88","   5","  1","   87","   4"
"4012","imperial","2020-06-08","  87","  237","   6"," 19","  150"," -13"
"4013","inyo","2020-06-08","   1","   42","   4","  0","   41","   4"
"4014","kern","2020-06-08"," 113"," 1756","  81"," 34"," 1643","  47"
"4015","yolo","2020-06-08","   1","  186","   8","  1","  185","   7"
"4016","amador","2020-06-08","   0","   51","   3","  0","   51","   3"
"4017","kings","2020-06-08","  25","  199","   2","  9","  174","  -7"
"4018","monterey","2020-06-08","  12","  811","  93","  3","  799","  90"
"4019","placer","2020-06-08","  22","  753","  48","  5","  731","  43"
"4020","modoc","2020-06-08","   0","   41","   0","  0","   41","   0"
"4021","riverside","2020-06-08"," 328"," 3987"," 128"," 89"," 3659","  39"
"4022","plumas","2020-06-08","   0","   45","   0","  0","   45","   0"
"4023","napa","2020-06-08","   7","  397","   3","  2","  390","   1"
"4024","siskiyou","2020-06-08","   0","   65","   6","  0","   65","   6"
"4025","mariposa","2020-06-08","   0","   30","   0","  0","   30","   0"
"4026","lassen","2020-06-08","   0","   25","   0","  0","   25","   0"
"4027","nevada","2020-06-08","   2","  120","   4","  1","  118","   3"
"4028","del norte","2020-06-08","   0","   51","   1","  0","   51","   1"
"4029","mono","2020-06-08","   0","   40","   2","  0","   40","   2"
"4030","fresno","2020-06-08"," 107"," 2132","  97"," 17"," 2025","  80"
"4031","alameda","2020-06-08"," 152"," 2968"," 144"," 43"," 2816"," 101"
"4032","san luis obispo","2020-06-08","   3","  480","  26","  2","  477","  24"
"4033","sacramento","2020-06-08","  61"," 2425"," 103"," 23"," 2364","  80"
"4034","santa barbara","2020-06-08","  28","  717","  66"," 10","  689","  56"
"4035","shasta","2020-06-08","   1","  667","   9","  0","  666","   9"
"4036","lake","2020-06-08","   0","  110","   4","  0","  110","   4"
"4037","madera","2020-06-09","  11","  528","  20","  1","  517","  19"
"4038","del norte","2020-06-09","   0","   51","   1","  0","   51","   1"
"4039","santa cruz","2020-06-09","   4","  397","  11","  0","  393","  11"
"4040","san luis obispo","2020-06-09","   5","  453","  24","  2","  448","  22"
"4041","tuolumne","2020-06-09","   0","  151","   3","  0","  151","   3"
"4042","modoc","2020-06-09","   0","   41","   0","  0","   41","   0"
"4043","inyo","2020-06-09","   1","   42","   4","  0","   41","   4"
"4044","mariposa","2020-06-09","   0","   30","   0","  0","   30","   0"
"4045","alameda","2020-06-09"," 146"," 2968"," 137"," 41"," 2822","  96"
"4046","glenn","2020-06-09","   1","   47","   0","  0","   46","   0"
"4047","santa barbara","2020-06-09","  32","  717","  64","  9","  685","  55"
"4048","trinity","2020-06-09","   2","   54","   0","  0","   52","   0"
"4049","nevada","2020-06-09","   3","  125","   7","  2","  122","   5"
"4050","mono","2020-06-09","   0","   40","   2","  0","   40","   2"
"4051","butte","2020-06-09","   6","  448","  16","  3","  442","  13"
"4052","tehama","2020-06-09","   0","  106","   5","  0","  106","   5"
"4053","yuba","2020-06-09","   4","  445","  14","  2","  441","  12"
"4054","placer","2020-06-09","  22","  753","  49","  4","  731","  45"
"4055","san mateo","2020-06-09","  44"," 1101","  47","  9"," 1057","  38"
"4056","yolo","2020-06-09","   1","  186","   2","  2","  185","   0"
"4057","siskiyou","2020-06-09","   1","   65","   5","  1","   64","   4"
"4058","ventura","2020-06-09","  87"," 1350","  41"," 21"," 1263","  20"
"4059","humboldt","2020-06-09","   9","  352","   4","  1","  343","   3"
"4060","amador","2020-06-09","   0","   51","   0","  0","   51","   0"
"4061","merced","2020-06-09","   4","  242","   4","  2","  238","   2"
"4062","napa","2020-06-09","   6","  397","   1","  0","  391","   1"
"4063","riverside","2020-06-09"," 333"," 3987"," 134"," 91"," 3654","  43"
"4064","stanislaus","2020-06-09","  42"," 1369","  78"," 17"," 1327","  61"
"4065","fresno","2020-06-09"," 104"," 2132","  92"," 16"," 2028","  76"
"4066","san bernardino","2020-06-09"," 276"," 4821"," 136"," 94"," 4545","  42"
"4067","tulare","2020-06-09","  44","  743","  12","  7","  699","   5"
"4068","colusa","2020-06-09","   0","   88","   6","  0","   88","   6"
"4069","monterey","2020-06-09","  13","  811","  92","  3","  798","  89"
"4070","calaveras","2020-06-09","   0","   50","   9","  0","   50","   9"
"4071","sacramento","2020-06-09","  52"," 2413","  87"," 20"," 2361","  67"
"4072","los angeles","2020-06-09","2111","23627","1258","507","21516"," 751"
"4073","marin","2020-06-09","  10","  390","  11","  4","  380","   7"
"4074","el dorado","2020-06-09","   3","  235","  13","  0","  232","  13"
"4075","san joaquin","2020-06-09","  76"," 1366","  17"," 25"," 1290","  -8"
"4076","kings","2020-06-09","  30","  199","   0","  8","  169","  -8"
"4077","contra costa","2020-06-09","  61"," 1628"," 106"," 14"," 1567","  92"
"4078","solano","2020-06-09","  42","  707","  44","  7","  665","  37"
"4079","lassen","2020-06-09","   0","   25","   0","  0","   25","   0"
"4080","san benito","2020-06-09","   0","   25","   2","  0","   25","   2"
"4081","san diego","2020-06-09"," 373"," 6182"," 330","153"," 5809"," 177"
"4082","sonoma","2020-06-09","  75","  871","  49","  7","  796","  42"
"4083","imperial","2020-06-09","  85","  212","   2"," 18","  127"," -16"
"4084","plumas","2020-06-09","   0","   45","   0","  0","   45","   0"
"4085","lake","2020-06-09","   1","  110","   1","  1","  109","   0"
"4086","mendocino","2020-06-09","   1","  180","   1","  1","  179","   0"
"4087","shasta","2020-06-09","   1","  667","   9","  0","  666","   9"
"4088","santa clara","2020-06-09","  59"," 3375"," 213"," 21"," 3316"," 192"
"4089","orange","2020-06-09"," 384"," 6976"," 390","165"," 6592"," 225"
"4090","sutter","2020-06-09","   0","   14","   0","  0","   14","   0"
"4091","san francisco","2020-06-09","  49"," 2647"," 100"," 13"," 2598","  87"
"4092","kern","2020-06-09"," 105"," 1742","  75"," 34"," 1637","  41"
"4093","fresno","2020-06-10"," 102"," 2144","  84"," 23"," 2042","  61"
"4094","santa barbara","2020-06-10","  31","  717","  68","  6","  686","  62"
"4095","tuolumne","2020-06-10","   1","  151","   3","  1","  150","   2"
"4096","modoc","2020-06-10","   0","   41","   0","  0","   41","   0"
"4097","sutter","2020-06-10","   0","   14","   0","  0","   14","   0"
"4098","san diego","2020-06-10"," 362"," 6186"," 330","151"," 5824"," 179"
"4099","kern","2020-06-10"," 112"," 1742","  77"," 42"," 1630","  35"
"4100","riverside","2020-06-10"," 333"," 3987"," 127"," 86"," 3654","  41"
"4101","calaveras","2020-06-10","   0","   50","   9","  0","   50","   9"
"4102","tulare","2020-06-10","  43","  780","  10","  8","  737","   2"
"4103","trinity","2020-06-10","   1","   54","   0","  0","   53","   0"
"4104","el dorado","2020-06-10","   1","  235","   9","  0","  234","   9"
"4105","solano","2020-06-10","  33","  707","  46","  5","  674","  41"
"4106","mendocino","2020-06-10","   1","  180","   3","  1","  179","   2"
"4107","imperial","2020-06-10","  79","  212","   2"," 16","  133"," -14"
"4108","madera","2020-06-10","  11","  528","  14","  3","  517","  11"
"4109","yuba","2020-06-10","   6","  445","  10","  2","  439","   8"
"4110","butte","2020-06-10","  30","  448","  17","  9","  418","   8"
"4111","marin","2020-06-10","  11","  390","  10","  3","  379","   7"
"4112","san benito","2020-06-10","   0","   25","   1","  0","   25","   1"
"4113","nevada","2020-06-10","   2","  130","   4","  2","  128","   2"
"4114","lassen","2020-06-10","   0","   25","   0","  0","   25","   0"
"4115","glenn","2020-06-10","   1","   47","   0","  0","   46","   0"
"4116","del norte","2020-06-10","   0","   51","   1","  0","   51","   1"
"4117","lake","2020-06-10","   2","  110","   1","  0","  108","   1"
"4118","merced","2020-06-10","   7","  242","   5","  3","  235","   2"
"4119","yolo","2020-06-10","   0","  186","   3","  0","  186","   3"
"4120","amador","2020-06-10","   0","   51","   3","  0","   51","   3"
"4121","napa","2020-06-10","   6","  397","   0","  1","  391","  -1"
"4122","los angeles","2020-06-10","1953","23634","1258","512","21681"," 746"
"4123","sonoma","2020-06-10","  62","  871","  47","  7","  809","  40"
"4124","shasta","2020-06-10","   1","  667","   4","  5","  666","  -1"
"4125","san bernardino","2020-06-10"," 247"," 4821"," 132"," 92"," 4574","  40"
"4126","contra costa","2020-06-10","  43"," 1628"," 111"," 16"," 1585","  95"
"4127","siskiyou","2020-06-10","   0","   65","   4","  0","   65","   4"
"4128","san luis obispo","2020-06-10","   5","  456","  23","  2","  451","  21"
"4129","inyo","2020-06-10","   1","   42","   4","  0","   41","   4"
"4130","orange","2020-06-10"," 384"," 6976"," 392","153"," 6592"," 239"
"4131","monterey","2020-06-10","  16","  811","  87","  3","  795","  84"
"4132","san francisco","2020-06-10","  50"," 2647","  95"," 14"," 2597","  81"
"4133","mono","2020-06-10","   0","   40","   2","  0","   40","   2"
"4134","kings","2020-06-10","  31","  199","   2"," 10","  168","  -8"
"4135","tehama","2020-06-10","   0","  106","   7","  0","  106","   7"
"4136","santa cruz","2020-06-10","   6","  397","  10","  0","  391","  10"
"4137","placer","2020-06-10","  23","  753","  45","  4","  730","  41"
"4138","alameda","2020-06-10"," 134"," 2968"," 147"," 43"," 2834"," 104"
"4139","san joaquin","2020-06-10","  83"," 1366","  17"," 21"," 1283","  -4"
"4140","plumas","2020-06-10","   0","   45","   0","  0","   45","   0"
"4141","stanislaus","2020-06-10","  41"," 1369","  83"," 15"," 1328","  68"
"4142","san mateo","2020-06-10","  40"," 1049","  50","  9"," 1009","  41"
"4143","mariposa","2020-06-10","   0","   30","   0","  0","   30","   0"
"4144","ventura","2020-06-10"," 100"," 1347","  56"," 17"," 1247","  39"
"4145","humboldt","2020-06-10","  15","  352","   5","  1","  337","   4"
"4146","sacramento","2020-06-10","  62"," 2471","  97"," 18"," 2409","  79"
"4147","colusa","2020-06-10","   0","   88","   6","  0","   88","   6"
"4148","santa clara","2020-06-10","  62"," 3375"," 220"," 21"," 3313"," 199"
"4149","san luis obispo","2020-06-11","   5","  481","  24","  3","  476","  21"
"4150","ventura","2020-06-11","  90"," 1360","  46"," 21"," 1270","  25"
"4151","mariposa","2020-06-11","   0","   30","   0","  0","   30","   0"
"4152","shasta","2020-06-11","   2","  667","   8","  0","  665","   8"
"4153","san joaquin","2020-06-11","  67"," 1366","  17"," 17"," 1299","   0"
"4154","amador","2020-06-11","   0","   51","   2","  0","   51","   2"
"4155","lassen","2020-06-11","   0","   25","   0","  0","   25","   0"
"4156","san mateo","2020-06-11","  33"," 1089","  50","  7"," 1056","  43"
"4157","mendocino","2020-06-11","   0","  180","   3","  0","  180","   3"
"4158","sonoma","2020-06-11","  27","  871","  49","  4","  844","  45"
"4159","plumas","2020-06-11","   0","   45","   0","  0","   45","   0"
"4160","san bernardino","2020-06-11"," 271"," 4821"," 133"," 89"," 4550","  44"
"4161","kern","2020-06-11"," 109"," 1742","  83"," 31"," 1633","  52"
"4162","sacramento","2020-06-11","  62"," 2501"," 105"," 18"," 2439","  87"
"4163","trinity","2020-06-11","   0","   54","   0","  0","   54","   0"
"4164","alameda","2020-06-11"," 124"," 2968"," 145"," 39"," 2844"," 106"
"4165","tulare","2020-06-11","  41","  780","  11","  7","  739","   4"
"4166","solano","2020-06-11","  31","  707","  43","  8","  676","  35"
"4167","sutter","2020-06-11","   0","   14","   0","  0","   14","   0"
"4168","riverside","2020-06-11"," 306"," 4018"," 131"," 83"," 3712","  48"
"4169","calaveras","2020-06-11","   0","   50","   8","  0","   50","   8"
"4170","lake","2020-06-11","   0","  110","   2","  0","  110","   2"
"4171","del norte","2020-06-11","   1","   51","   3","  0","   50","   3"
"4172","imperial","2020-06-11","  87","  237","   0"," 18","  150"," -18"
"4173","nevada","2020-06-11","   2","  127","   4","  2","  125","   2"
"4174","napa","2020-06-11","   3","  397","   3","  0","  394","   3"
"4175","tehama","2020-06-11","   0","  106","   7","  0","  106","   7"
"4176","contra costa","2020-06-11","  51"," 1628"," 112"," 15"," 1577","  97"
"4177","tuolumne","2020-06-11","   0","  151","   0","  0","  151","   0"
"4178","mono","2020-06-11","   1","   40","   2","  0","   39","   2"
"4179","kings","2020-06-11","  31","  199","   5","  8","  168","  -3"
"4180","los angeles","2020-06-11","1973","23666","1220","512","21693"," 708"
"4181","santa clara","2020-06-11","  57"," 3375"," 215"," 20"," 3318"," 195"
"4182","santa cruz","2020-06-11","   6","  397","  11","  0","  391","  11"
"4183","san diego","2020-06-11"," 352"," 6187"," 325","149"," 5835"," 176"
"4184","san francisco","2020-06-11","  51"," 2647","  86"," 15"," 2596","  71"
"4185","orange","2020-06-11"," 392"," 6976"," 368","172"," 6584"," 196"
"4186","fresno","2020-06-11","  99"," 2142","  79"," 18"," 2043","  61"
"4187","modoc","2020-06-11","   0","   41","   0","  0","   41","   0"
"4188","marin","2020-06-11","  10","  390","  13","  3","  380","  10"
"4189","santa barbara","2020-06-11","  37","  717","  64","  8","  680","  56"
"4190","butte","2020-06-11","  42","  448","  15"," 10","  406","   5"
"4191","madera","2020-06-11","  11","  528","   5","  4","  517","   1"
"4192","merced","2020-06-11","   5","  242","   3","  3","  237","   0"
"4193","yolo","2020-06-11","   1","  186","   2","  0","  185","   2"
"4194","inyo","2020-06-11","   1","   42","   2","  0","   41","   2"
"4195","placer","2020-06-11","  18","  753","  48","  4","  735","  44"
"4196","glenn","2020-06-11","   1","   47","   0","  0","   46","   0"
"4197","monterey","2020-06-11","  17","  811","  85","  5","  794","  80"
"4198","san benito","2020-06-11","   0","   25","   1","  0","   25","   1"
"4199","yuba","2020-06-11","   6","  445","   6","  2","  439","   4"
"4200","humboldt","2020-06-11","   9","  352","   2","  0","  343","   2"
"4201","el dorado","2020-06-11","   1","  235","  10","  1","  234","   9"
"4202","siskiyou","2020-06-11","   0","   65","   4","  0","   65","   4"
"4203","stanislaus","2020-06-11","  47"," 1369","  82"," 14"," 1322","  68"
"4204","colusa","2020-06-11","   0","   88","   6","  0","   88","   6"
"4205","calaveras","2020-06-12","   0","   50","  10","  0","   50","  10"
"4206","lake","2020-06-12","   2","  110","   0","  2","  108","  -2"
"4207","sonoma","2020-06-12","  42","  871","  42","  6","  829","  36"
"4208","solano","2020-06-12","  27","  707","  46","  8","  680","  38"
"4209","contra costa","2020-06-12","  42"," 1628"," 111"," 13"," 1586","  98"
"4210","los angeles","2020-06-12","1870","23655","1228","492","21785"," 736"
"4211","yolo","2020-06-12","   0","  186","   4","  0","  186","   4"
"4212","el dorado","2020-06-12","   3","  235","  14","  3","  232","  11"
"4213","tulare","2020-06-12","  25","  780","  25","  8","  755","  17"
"4214","san bernardino","2020-06-12"," 283"," 4821"," 138"," 93"," 4538","  45"
"4215","yuba","2020-06-12","   6","  445","   9","  2","  439","   7"
"4216","shasta","2020-06-12","   1","  667","   7","  0","  666","   7"
"4217","kings","2020-06-12","  34","  199","   5"," 10","  165","  -5"
"4218","napa","2020-06-12","   8","  397","   1","  1","  389","   0"
"4219","inyo","2020-06-12","   1","   42","   3","  0","   41","   3"
"4220","san joaquin","2020-06-12","  68"," 1366","  16"," 17"," 1298","  -1"
"4221","stanislaus","2020-06-12","  68"," 1369","  84"," 16"," 1301","  68"
"4222","mono","2020-06-12","   0","   40","   2","  0","   40","   2"
"4223","fresno","2020-06-12"," 102"," 2140","  87"," 20"," 2038","  67"
"4224","placer","2020-06-12","  15","  753","  46","  2","  738","  44"
"4225","ventura","2020-06-12"," 109"," 1361","  42"," 23"," 1252","  19"
"4226","san luis obispo","2020-06-12","   5","  471","  24","  2","  466","  22"
"4227","madera","2020-06-12","   9","  528","  14","  2","  519","  12"
"4228","amador","2020-06-12","   0","   51","   0","  0","   51","   0"
"4229","mendocino","2020-06-12","   0","  180","   5","  0","  180","   5"
"4230","san francisco","2020-06-12","  52"," 2647","  91"," 16"," 2595","  75"
"4231","kern","2020-06-12"," 111"," 1742","  72"," 37"," 1631","  35"
"4232","tuolumne","2020-06-12","   0","  151","   2","  0","  151","   2"
"4233","marin","2020-06-12","  11","  390","  12","  4","  379","   8"
"4234","humboldt","2020-06-12","  14","  352","   0","  2","  338","  -2"
"4235","butte","2020-06-12","   5","  448","  20","  3","  443","  17"
"4236","santa cruz","2020-06-12","  10","  397","  15","  0","  387","  15"
"4237","alameda","2020-06-12"," 126"," 2968"," 120"," 41"," 2842","  79"
"4238","sacramento","2020-06-12","  67"," 2474","  91"," 21"," 2407","  70"
"4239","orange","2020-06-12"," 428"," 6976"," 384","177"," 6548"," 207"
"4240","santa clara","2020-06-12","  60"," 3375"," 223"," 20"," 3315"," 203"
"4241","monterey","2020-06-12","  15","  811","  87","  2","  796","  85"
"4242","merced","2020-06-12","   6","  242","   3","  3","  236","   0"
"4243","sutter","2020-06-12","   0","   14","   0","  0","   14","   0"
"4244","riverside","2020-06-12"," 319"," 4018"," 139"," 88"," 3699","  51"
"4245","san diego","2020-06-12"," 316"," 6210"," 328","144"," 5894"," 184"
"4246","colusa","2020-06-12","   0","   88","   6","  0","   88","   6"
"4247","del norte","2020-06-12","   0","   51","   4","  0","   51","   4"
"4248","lassen","2020-06-12","   0","   25","   0","  0","   25","   0"
"4249","imperial","2020-06-12","  82","  237","   2"," 16","  155"," -14"
"4250","mariposa","2020-06-12","   0","   30","   0","  0","   30","   0"
"4251","san mateo","2020-06-12","  32"," 1089","  51","  8"," 1057","  43"
"4252","modoc","2020-06-12","   0","   41","   0","  0","   41","   0"
"4253","tehama","2020-06-12","   1","  106","   6","  1","  105","   5"
"4254","santa barbara","2020-06-12","  34","  717","  58","  9","  683","  49"
"4255","san benito","2020-06-12","   0","   25","   1","  0","   25","   1"
"4256","nevada","2020-06-12","   0","  136","   6","  0","  136","   6"
"4257","trinity","2020-06-12","   0","   54","   0","  0","   54","   0"
"4258","siskiyou","2020-06-12","   1","   65","   5","  1","   64","   4"
"4259","glenn","2020-06-12","   1","   47","   0","  0","   46","   0"
"4260","plumas","2020-06-12","   0","   45","   0","  0","   45","   0"
"4261","nevada","2020-06-13","   0","  128","   4","  0","  128","   4"
"4262","el dorado","2020-06-13","   3","  235","  11","  3","  232","   8"
"4263","placer","2020-06-13","  13","  753","  50","  4","  740","  46"
"4264","orange","2020-06-13"," 406"," 6976"," 402","164"," 6570"," 238"
"4265","santa cruz","2020-06-13","   9","  397","  10","  0","  388","  10"
"4266","mendocino","2020-06-13","   0","  180","   5","  0","  180","   5"
"4267","butte","2020-06-13","   3","  448","  20","  4","  445","  16"
"4268","plumas","2020-06-13","   0","   45","   0","  0","   45","   0"
"4269","lassen","2020-06-13","   0","   25","   0","  0","   25","   0"
"4270","del norte","2020-06-13","   0","   51","   2","  0","   51","   2"
"4271","shasta","2020-06-13","   1","  667","   6","  0","  666","   6"
"4272","kern","2020-06-13"," 107"," 1742","  78"," 37"," 1635","  41"
"4273","riverside","2020-06-13"," 336"," 3992"," 137"," 85"," 3656","  52"
"4274","tehama","2020-06-13","   0","  106","   6","  0","  106","   6"
"4275","fresno","2020-06-13","  98"," 2140","  83"," 24"," 2042","  59"
"4276","siskiyou","2020-06-13","   1","   65","   3","  1","   64","   2"
"4277","glenn","2020-06-13","   1","   47","   0","  0","   46","   0"
"4278","contra costa","2020-06-13","  47"," 1628"," 108"," 14"," 1581","  94"
"4279","alameda","2020-06-13"," 114"," 2968"," 150"," 36"," 2854"," 114"
"4280","imperial","2020-06-13","  86","  237","   0"," 18","  151"," -18"
"4281","monterey","2020-06-13","  18","  811","  91","  2","  793","  89"
"4282","yuba","2020-06-13","   6","  445","  14","  2","  439","  12"
"4283","santa clara","2020-06-13","  49"," 3423"," 211"," 15"," 3374"," 196"
"4284","mariposa","2020-06-13","   0","   30","   0","  0","   30","   0"
"4285","humboldt","2020-06-13","  14","  352","   0","  2","  338","  -2"
"4286","yolo","2020-06-13","   0","  186","   2","  2","  186","   0"
"4287","stanislaus","2020-06-13","  62"," 1369","  86"," 20"," 1307","  66"
"4288","santa barbara","2020-06-13","  42","  717","  58"," 10","  675","  48"
"4289","mono","2020-06-13","   0","   40","   2","  0","   40","   2"
"4290","ventura","2020-06-13","  94"," 1354","  51"," 21"," 1260","  30"
"4291","san joaquin","2020-06-13","  71"," 1366","  10"," 20"," 1295"," -10"
"4292","san luis obispo","2020-06-13","   8","  449","  23","  3","  441","  20"
"4293","los angeles","2020-06-13","1768","23688","1262","483","21920"," 779"
"4294","inyo","2020-06-13","   1","   42","   2","  0","   41","   2"
"4295","colusa","2020-06-13","   0","   88","   6","  0","   88","   6"
"4296","san diego","2020-06-13"," 342"," 6195"," 324","136"," 5853"," 188"
"4297","amador","2020-06-13","   0","   51","   3","  0","   51","   3"
"4298","sonoma","2020-06-13","  11","  871","  47","  2","  860","  45"
"4299","sacramento","2020-06-13","  51"," 2444","  84"," 16"," 2393","  68"
"4300","san bernardino","2020-06-13"," 285"," 4821"," 129","101"," 4536","  28"
"4301","lake","2020-06-13","   1","  110","   0","  1","  109","  -1"
"4302","modoc","2020-06-13","   0","   41","   0","  0","   41","   0"
"4303","napa","2020-06-13","   5","  397","   3","  0","  392","   3"
"4304","merced","2020-06-13","   4","  242","   5","  2","  238","   3"
"4305","madera","2020-06-13","   8","  528","   8","  2","  520","   6"
"4306","marin","2020-06-13","  12","  390","  12","  3","  378","   9"
"4307","tuolumne","2020-06-13","   0","  151","   0","  0","  151","   0"
"4308","tulare","2020-06-13","  36","  780","   6","  8","  744","  -2"
"4309","calaveras","2020-06-13","   0","   50","  12","  0","   50","  12"
"4310","san francisco","2020-06-13","  50"," 2647","  94"," 14"," 2597","  80"
"4311","san mateo","2020-06-13","  27"," 1089","  55","  8"," 1062","  47"
"4312","sutter","2020-06-13","   0","   14","   0","  0","   14","   0"
"4313","trinity","2020-06-13","   1","   54","   0","  0","   53","   0"
"4314","san benito","2020-06-13","   0","   25","   0","  0","   25","   0"
"4315","kings","2020-06-13","  34","  199","   6"," 10","  165","  -4"
"4316","solano","2020-06-13","  22","  707","  49","  7","  685","  42"
"4317","siskiyou","2020-06-14","   1","   65","   3","  1","   64","   2"
"4318","tehama","2020-06-14","   0","  106","   6","  0","  106","   6"
"4319","madera","2020-06-14","   5","  528","   8","  2","  523","   6"
"4320","kings","2020-06-14","  40","  199","   3","  9","  159","  -6"
"4321","inyo","2020-06-14","   0","   42","   3","  0","   42","   3"
"4322","colusa","2020-06-14","   0","   88","   6","  0","   88","   6"
"4323","santa clara","2020-06-14","  54"," 3423"," 204"," 15"," 3369"," 189"
"4324","placer","2020-06-14","  13","  753","  49","  4","  740","  45"
"4325","sonoma","2020-06-14","  34","  871","  52","  2","  837","  50"
"4326","plumas","2020-06-14","   0","   45","   0","  0","   45","   0"
"4327","san joaquin","2020-06-14","  74"," 1366","  10"," 18"," 1292","  -8"
"4328","san francisco","2020-06-14","  49"," 2647","  96"," 15"," 2598","  81"
"4329","mono","2020-06-14","   0","   40","   2","  0","   40","   2"
"4330","modoc","2020-06-14","   0","   41","   0","  0","   41","   0"
"4331","yuba","2020-06-14","   7","  445","  13","  3","  438","  10"
"4332","contra costa","2020-06-14","  42"," 1628"," 121"," 12"," 1586"," 109"
"4333","tulare","2020-06-14","  40","  780","  23","  7","  740","  16"
"4334","stanislaus","2020-06-14","  56"," 1369","  87"," 17"," 1313","  70"
"4335","el dorado","2020-06-14","   4","  235","  10","  4","  231","   6"
"4336","yolo","2020-06-14","   0","  186","   2","  2","  186","   0"
"4337","fresno","2020-06-14","  93"," 2135","  79"," 24"," 2042","  55"
"4338","santa barbara","2020-06-14","  41","  717","  59"," 10","  676","  49"
"4339","santa cruz","2020-06-14","   9","  397","  12","  0","  388","  12"
"4340","mendocino","2020-06-14","   0","  180","   4","  0","  180","   4"
"4341","kern","2020-06-14"," 103"," 1742","  76"," 35"," 1639","  41"
"4342","san mateo","2020-06-14","  29"," 1089","  51"," 10"," 1060","  41"
"4343","sutter","2020-06-14","   0","   14","   0","  0","   14","   0"
"4344","nevada","2020-06-14","   1","  128","   4","  1","  127","   3"
"4345","riverside","2020-06-14"," 320"," 3992"," 120"," 89"," 3672","  31"
"4346","amador","2020-06-14","   0","   51","   1","  0","   51","   1"
"4347","trinity","2020-06-14","   0","   54","   0","  0","   54","   0"
"4348","orange","2020-06-14"," 421"," 6976"," 414","164"," 6555"," 250"
"4349","humboldt","2020-06-14","   4","  352","   3","  0","  348","   3"
"4350","calaveras","2020-06-14","   0","   50","  10","  0","   50","  10"
"4351","sacramento","2020-06-14","  51"," 2441","  90"," 17"," 2390","  73"
"4352","merced","2020-06-14","   4","  242","   5","  2","  238","   3"
"4353","san luis obispo","2020-06-14","  12","  449","  20","  6","  437","  14"
"4354","monterey","2020-06-14","  15","  811","  95","  1","  796","  94"
"4355","san benito","2020-06-14","   0","   25","   0","  0","   25","   0"
"4356","imperial","2020-06-14","  90","  237","   0"," 20","  147"," -20"
"4357","lake","2020-06-14","   1","  110","   0","  1","  109","  -1"
"4358","glenn","2020-06-14","   1","   47","   0","  0","   46","   0"
"4359","shasta","2020-06-14","   0","  667","   7","  0","  667","   7"
"4360","san diego","2020-06-14"," 366"," 6145"," 323","132"," 5779"," 191"
"4361","los angeles","2020-06-14","1797","23703","1283","477","21906"," 806"
"4362","san bernardino","2020-06-14"," 295"," 4821"," 140"," 95"," 4526","  45"
"4363","del norte","2020-06-14","   0","   51","   0","  0","   51","   0"
"4364","lassen","2020-06-14","   0","   25","   0","  0","   25","   0"
"4365","alameda","2020-06-14"," 124"," 2968"," 149"," 42"," 2844"," 107"
"4366","marin","2020-06-14","  11","  390","  12","  3","  379","   9"
"4367","solano","2020-06-14","  21","  707","  49","  7","  686","  42"
"4368","butte","2020-06-14","   3","  448","  19","  3","  445","  16"
"4369","tuolumne","2020-06-14","   0","  151","   0","  0","  151","   0"
"4370","ventura","2020-06-14","  89"," 1354","  55"," 19"," 1265","  36"
"4371","mariposa","2020-06-14","   0","   30","   0","  0","   30","   0"
"4372","napa","2020-06-14","   3","  397","   2","  1","  394","   1"
"4373","tuolumne","2020-06-15","   0","  151","   2","  0","  151","   2"
"4374","amador","2020-06-15","   1","   51","   0","  0","   50","   0"
"4375","contra costa","2020-06-15","  33"," 1628"," 115","  9"," 1595"," 106"
"4376","riverside","2020-06-15"," 335"," 4071"," 136"," 81"," 3736","  55"
"4377","trinity","2020-06-15","   0","   54","   0","  0","   54","   0"
"4378","fresno","2020-06-15","  86"," 2111","  86"," 24"," 2025","  62"
"4379","san benito","2020-06-15","   0","   25","   0","  0","   25","   0"
"4380","alameda","2020-06-15"," 129"," 2968"," 148"," 46"," 2839"," 102"
"4381","madera","2020-06-15","   7","  528","   7","  2","  521","   5"
"4382","placer","2020-06-15","  13","  753","  48","  5","  740","  43"
"4383","yuba","2020-06-15","   6","  445","  16","  2","  439","  14"
"4384","kern","2020-06-15"," 107"," 1742","  78"," 41"," 1635","  37"
"4385","mono","2020-06-15","   0","   40","   2","  0","   40","   2"
"4386","inyo","2020-06-15","   0","   42","   2","  0","   42","   2"
"4387","glenn","2020-06-15","   1","   47","   0","  0","   46","   0"
"4388","santa barbara","2020-06-15","  49","  717","  63","  9","  668","  54"
"4389","yolo","2020-06-15","   0","  186","   3","  0","  186","   3"
"4390","los angeles","2020-06-15","1956","23659","1333","492","21703"," 841"
"4391","ventura","2020-06-15","  83"," 1350","  55"," 20"," 1267","  35"
"4392","tehama","2020-06-15","   0","  106","   7","  0","  106","   7"
"4393","siskiyou","2020-06-15","   0","   65","   0","  0","   65","   0"
"4394","san mateo","2020-06-15","  22"," 1089","  50","  7"," 1067","  43"
"4395","colusa","2020-06-15","   0","   88","   6","  0","   88","   6"
"4396","sutter","2020-06-15","   0","   14","   0","  0","   14","   0"
"4397","san diego","2020-06-15"," 360"," 6129"," 356","133"," 5769"," 223"
"4398","lassen","2020-06-15","   0","   25","   0","  0","   25","   0"
"4399","lake","2020-06-15","   0","  110","   0","  0","  110","   0"
"4400","kings","2020-06-15","  39","  199","   2"," 10","  160","  -8"
"4401","san luis obispo","2020-06-15","   4","  447","  26","  2","  443","  24"
"4402","merced","2020-06-15","   3","  242","   5","  2","  239","   3"
"4403","sonoma","2020-06-15","  36","  871","  46","  3","  835","  43"
"4404","solano","2020-06-15","  23","  707","  44","  7","  684","  37"
"4405","butte","2020-06-15","   5","  448","  14","  4","  443","  10"
"4406","santa clara","2020-06-15","  54"," 3423"," 239"," 15"," 3369"," 224"
"4407","napa","2020-06-15","   6","  397","   5","  2","  391","   3"
"4408","sacramento","2020-06-15","  48"," 2428"," 104"," 20"," 2380","  84"
"4409","del norte","2020-06-15","   0","   51","   0","  0","   51","   0"
"4410","orange","2020-06-15"," 425"," 6976"," 417","159"," 6551"," 258"
"4411","plumas","2020-06-15","   0","   45","   0","  0","   45","   0"
"4412","san francisco","2020-06-15","  45"," 2647","  94"," 10"," 2602","  84"
"4413","tulare","2020-06-15","  49","  780","  12","  9","  731","   3"
"4414","el dorado","2020-06-15","   2","  235","   6","  2","  233","   4"
"4415","santa cruz","2020-06-15","   5","  397","   8","  0","  392","   8"
"4416","imperial","2020-06-15","  82","  237","   2"," 19","  155"," -17"
"4417","mendocino","2020-06-15","   1","  180","   5","  1","  179","   4"
"4418","humboldt","2020-06-15","   5","  352","   2","  1","  347","   1"
"4419","mariposa","2020-06-15","   0","   30","   0","  0","   30","   0"
"4420","nevada","2020-06-15","   2","  131","   5","  2","  129","   3"
"4421","calaveras","2020-06-15","   0","   50","   9","  0","   50","   9"
"4422","modoc","2020-06-15","   0","   41","   0","  0","   41","   0"
"4423","marin","2020-06-15","   9","  390","  15","  1","  381","  14"
"4424","san joaquin","2020-06-15","  59"," 1376","  16"," 20"," 1317","  -4"
"4425","monterey","2020-06-15","  16","  811","  93","  1","  795","  92"
"4426","stanislaus","2020-06-15","  61"," 1364","  88"," 16"," 1303","  72"
"4427","san bernardino","2020-06-15"," 295"," 4821"," 149"," 95"," 4526","  54"
"4428","shasta","2020-06-15","   0","  667","   9","  0","  667","   9"
"4429","sonoma","2020-06-16","  18","  871","  51","  3","  853","  48"
"4430","santa clara","2020-06-16","  48"," 3423"," 228"," 15"," 3375"," 213"
"4431","tehama","2020-06-16","   0","  106","   4","  0","  106","   4"
"4432","siskiyou","2020-06-16","   1","   65","   4","  1","   64","   3"
"4433","monterey","2020-06-16","  17","  824","  93","  2","  807","  91"
"4434","san benito","2020-06-16","   0","   25","   0","  0","   25","   0"
"4435","inyo","2020-06-16","   0","   42","   2","  0","   42","   2"
"4436","modoc","2020-06-16","   0","   41","   0","  0","   41","   0"
"4437","san joaquin","2020-06-16","  61"," 1376","  20"," 20"," 1315","   0"
"4438","sacramento","2020-06-16","  57"," 2457","  87"," 21"," 2400","  66"
"4439","santa barbara","2020-06-16","  50","  717","  57"," 14","  667","  43"
"4440","solano","2020-06-16","  25","  707","  45","  7","  682","  38"
"4441","calaveras","2020-06-16","   0","   50","   9","  0","   50","   9"
"4442","madera","2020-06-16","   8","  528","  11","  3","  520","   8"
"4443","tulare","2020-06-16","  53","  780","  24"," 11","  727","  13"
"4444","yuba","2020-06-16","   6","  445","  17","  2","  439","  15"
"4445","san mateo","2020-06-16","  28"," 1089","  54","  7"," 1061","  47"
"4446","alameda","2020-06-16"," 133"," 2968"," 142"," 48"," 2835","  94"
"4447","contra costa","2020-06-16","  40"," 1628"," 108"," 13"," 1588","  95"
"4448","riverside","2020-06-16"," 341"," 4071"," 136"," 83"," 3730","  53"
"4449","shasta","2020-06-16","   0","  667","   9","  0","  667","   9"
"4450","colusa","2020-06-16","   1","   88","   6","  0","   87","   6"
"4451","napa","2020-06-16","  10","  397","   6","  1","  387","   5"
"4452","del norte","2020-06-16","   0","   51","   2","  0","   51","   2"
"4453","merced","2020-06-16","   8","  242","   5","  3","  234","   2"
"4454","orange","2020-06-16"," 429"," 6976"," 455","169"," 6547"," 286"
"4455","sutter","2020-06-16","   0","   14","   0","  0","   14","   0"
"4456","butte","2020-06-16","   3","  448","  10","  3","  445","   7"
"4457","imperial","2020-06-16","  85","  237","   0"," 21","  152"," -21"
"4458","los angeles","2020-06-16","1947","23667","1175","499","21720"," 676"
"4459","humboldt","2020-06-16","   8","  352","   0","  1","  344","  -1"
"4460","kern","2020-06-16"," 110"," 1742","  80"," 41"," 1632","  39"
"4461","ventura","2020-06-16","  92"," 1347","  58"," 22"," 1255","  36"
"4462","yolo","2020-06-16","   1","  186","   6","  0","  185","   6"
"4463","el dorado","2020-06-16","   1","  235","   7","  1","  234","   6"
"4464","san diego","2020-06-16"," 343"," 6168"," 320","142"," 5825"," 178"
"4465","san luis obispo","2020-06-16","  13","  471","  27","  7","  458","  20"
"4466","nevada","2020-06-16","   1","  134","   7","  0","  133","   7"
"4467","san bernardino","2020-06-16"," 293"," 4821"," 156"," 90"," 4528","  66"
"4468","glenn","2020-06-16","   1","   47","   0","  0","   46","   0"
"4469","stanislaus","2020-06-16","  64"," 1369","  89"," 19"," 1305","  70"
"4470","santa cruz","2020-06-16","   4","  397","   7","  0","  393","   7"
"4471","mendocino","2020-06-16","   0","  180","   4","  0","  180","   4"
"4472","mono","2020-06-16","   0","   40","   2","  0","   40","   2"
"4473","trinity","2020-06-16","   0","   54","   0","  0","   54","   0"
"4474","fresno","2020-06-16"," 103"," 2129","  86"," 24"," 2026","  62"
"4475","marin","2020-06-16","   9","  390","  14","  1","  381","  13"
"4476","plumas","2020-06-16","   0","   45","   0","  0","   45","   0"
"4477","san francisco","2020-06-16","  42"," 2647","  91","  8"," 2605","  83"
"4478","amador","2020-06-16","   1","   51","   3","  0","   50","   3"
"4479","lake","2020-06-16","   2","  110","   0","  1","  108","  -1"
"4480","kings","2020-06-16","  47","  199","   2"," 10","  152","  -8"
"4481","tuolumne","2020-06-16","   0","  151","   0","  0","  151","   0"
"4482","mariposa","2020-06-16","   0","   30","   0","  0","   30","   0"
"4483","placer","2020-06-16","  18","  753","  51","  5","  735","  46"
"4484","lassen","2020-06-16","   0","   25","   0","  0","   25","   0"
"4485","nevada","2020-06-17","   2","  145","   9","  0","  143","   9"
"4486","el dorado","2020-06-17","   2","   88","  11","  0","   86","  11"
"4487","fresno","2020-06-17"," 103"," 2138","  81"," 17"," 2035","  64"
"4488","san benito","2020-06-17","   0","   25","   0","  0","   25","   0"
"4489","lake","2020-06-17","   1","  110","   0","  0","  109","   0"
"4490","marin","2020-06-17","   8","  390","   9","  3","  382","   6"
"4491","san francisco","2020-06-17","  44"," 2647","  86"," 11"," 2603","  75"
"4492","glenn","2020-06-17","   1","   47","   0","  0","   46","   0"
"4493","siskiyou","2020-06-17","   4","   65","   2","  1","   61","   1"
"4494","san joaquin","2020-06-17","  61"," 1376","  23"," 19"," 1315","   4"
"4495","inyo","2020-06-17","   0","   42","   3","  0","   42","   3"
"4496","calaveras","2020-06-17","   0","   50","   9","  0","   50","   9"
"4497","yolo","2020-06-17","   2","  186","   6","  0","  184","   6"
"4498","imperial","2020-06-17","  89","  237","   0"," 20","  148"," -20"
"4499","santa cruz","2020-06-17","   7","  397","   9","  3","  390","   6"
"4500","monterey","2020-06-17","  17","  824","  85","  3","  807","  82"
"4501","ventura","2020-06-17"," 101"," 1368","  45"," 23"," 1267","  22"
"4502","tuolumne","2020-06-17","   0","  151","   0","  0","  151","   0"
"4503","merced","2020-06-17","  10","  242","   3","  3","  232","   0"
"4504","solano","2020-06-17","  19","  707","  52","  4","  688","  48"
"4505","trinity","2020-06-17","   2","   54","   0","  0","   52","   0"
"4506","modoc","2020-06-17","   0","   41","   0","  0","   41","   0"
"4507","shasta","2020-06-17","   0","  667","  12","  0","  667","  12"
"4508","lassen","2020-06-17","   0","   25","   0","  0","   25","   0"
"4509","plumas","2020-06-17","   0","   45","   0","  0","   45","   0"
"4510","butte","2020-06-17","   3","  448","   4","  3","  445","   1"
"4511","san mateo","2020-06-17","  20"," 1089","  50","  7"," 1069","  43"
"4512","alameda","2020-06-17"," 137"," 2968"," 135"," 49"," 2831","  86"
"4513","tulare","2020-06-17","  49","  780","  23"," 11","  731","  12"
"4514","del norte","2020-06-17","   0","   51","   2","  0","   51","   2"
"4515","san diego","2020-06-17"," 343"," 6235"," 324","147"," 5892"," 177"
"4516","colusa","2020-06-17","   0","   88","   6","  0","   88","   6"
"4517","sutter","2020-06-17","   0","   14","   0","  0","   14","   0"
"4518","santa barbara","2020-06-17","  48","  717","  35"," 15","  669","  20"
"4519","mendocino","2020-06-17","   0","  180","   4","  0","  180","   4"
"4520","contra costa","2020-06-17","  32"," 1628","  96"," 13"," 1596","  83"
"4521","orange","2020-06-17"," 425"," 6976"," 407","165"," 6551"," 242"
"4522","los angeles","2020-06-17","1958","23646","1151","475","21688"," 676"
"4523","santa clara","2020-06-17","  55"," 3438"," 204"," 15"," 3383"," 189"
"4524","tehama","2020-06-17","   0","  106","   6","  0","  106","   6"
"4525","san bernardino","2020-06-17"," 297"," 4821"," 146"," 88"," 4524","  58"
"4526","humboldt","2020-06-17","   3","  352","   0","  1","  349","  -1"
"4527","mono","2020-06-17","   0","   40","   2","  0","   40","   2"
"4528","kings","2020-06-17","  49","  199","   4"," 10","  150","  -6"
"4529","mariposa","2020-06-17","   0","   30","   0","  0","   30","   0"
"4530","sonoma","2020-06-17","  19","  871","  47","  5","  852","  42"
"4531","kern","2020-06-17"," 123"," 1412","  31"," 45"," 1289"," -14"
"4532","riverside","2020-06-17"," 379"," 4071","  91"," 94"," 3692","  -3"
"4533","yuba","2020-06-17","   5","  445","  18","  1","  440","  17"
"4534","napa","2020-06-17","   9","  397","   6","  0","  388","   6"
"4535","san luis obispo","2020-06-17","   7","  365","  73","  3","  358","  70"
"4536","madera","2020-06-17","   7","  528","   7","  5","  521","   2"
"4537","stanislaus","2020-06-17","  74"," 1369","  84"," 17"," 1295","  67"
"4538","placer","2020-06-17","  16","  753","  51","  3","  737","  48"
"4539","amador","2020-06-17","   1","   51","   1","  0","   50","   1"
"4540","sacramento","2020-06-17","  52"," 2395","  77"," 19"," 2343","  58"
"4541","madera","2020-06-18","  16","  528","  11","  6","  512","   5"
"4542","sonoma","2020-06-18","  16","  871","  64","  4","  855","  60"
"4543","humboldt","2020-06-18","   3","  352","   4","  1","  349","   3"
"4544","mono","2020-06-18","   0","   40","   2","  0","   40","   2"
"4545","riverside","2020-06-18"," 421"," 4017","  97"," 97"," 3596","   0"
"4546","sutter","2020-06-18","   0","   14","   0","  0","   14","   0"
"4547","fresno","2020-06-18","  98"," 2131","  70"," 13"," 2033","  57"
"4548","placer","2020-06-18","  19","  753","  60","  5","  734","  55"
"4549","plumas","2020-06-18","   0","   45","   0","  0","   45","   0"
"4550","tulare","2020-06-18","  51","  780","  11","  8","  729","   3"
"4551","yuba","2020-06-18","   4","  445","   8","  1","  441","   7"
"4552","inyo","2020-06-18","   0","   42","   2","  0","   42","   2"
"4553","merced","2020-06-18","  17","  242","   6","  3","  225","   3"
"4554","el dorado","2020-06-18","   3","  227","   8","  3","  224","   5"
"4555","yolo","2020-06-18","   3","  186","   4","  0","  183","   4"
"4556","kern","2020-06-18"," 103"," 1742","  87"," 41"," 1639","  46"
"4557","marin","2020-06-18","   6","  390","   9","  2","  384","   7"
"4558","colusa","2020-06-18","   0","   88","   6","  0","   88","   6"
"4559","lassen","2020-06-18","   0","   25","   0","  0","   25","   0"
"4560","del norte","2020-06-18","   0","   51","   2","  0","   51","   2"
"4561","san benito","2020-06-18","   0","   25","   1","  0","   25","   1"
"4562","santa clara","2020-06-18","  49"," 3438"," 205"," 19"," 3389"," 186"
"4563","napa","2020-06-18","   7","  397","   5","  0","  390","   5"
"4564","imperial","2020-06-18","  73","  237","   6"," 16","  164"," -10"
"4565","los angeles","2020-06-18","1900","23644","1195","491","21744"," 704"
"4566","santa barbara","2020-06-18","  48","  717","  33"," 15","  669","  18"
"4567","san luis obispo","2020-06-18","   8","  450","  19","  3","  442","  16"
"4568","tuolumne","2020-06-18","   0","  151","   0","  0","  151","   0"
"4569","sacramento","2020-06-18","  47"," 2462"," 180"," 14"," 2415"," 166"
"4570","calaveras","2020-06-18","   1","   50","   8","  0","   49","   8"
"4571","amador","2020-06-18","   2","   51","   1","  1","   49","   0"
"4572","ventura","2020-06-18","  77"," 1372","  39"," 23"," 1295","  16"
"4573","orange","2020-06-18"," 422"," 6976"," 412","156"," 6554"," 256"
"4574","modoc","2020-06-18","   0","   41","   0","  0","   41","   0"
"4575","siskiyou","2020-06-18","   1","   65","   4","  1","   64","   3"
"4576","kings","2020-06-18","  50","  199","   1"," 10","  149","  -9"
"4577","shasta","2020-06-18","   1","  667","   8","  0","  666","   8"
"4578","tehama","2020-06-18","   0","  106","   4","  0","  106","   4"
"4579","trinity","2020-06-18","   2","   54","   0","  0","   52","   0"
"4580","nevada","2020-06-18","   3","  123","   9","  0","  120","   9"
"4581","san bernardino","2020-06-18"," 313"," 4821"," 156"," 95"," 4508","  61"
"4582","santa cruz","2020-06-18","   4","  397","  10","  1","  393","   9"
"4583","san joaquin","2020-06-18","  76"," 1376","  23"," 27"," 1300","  -4"
"4584","mariposa","2020-06-18","   0","   30","   0","  0","   30","   0"
"4585","lake","2020-06-18","   2","  110","   1","  0","  108","   1"
"4586","stanislaus","2020-06-18","  93"," 1369","  88"," 24"," 1276","  64"
"4587","contra costa","2020-06-18","  43"," 1628"," 146"," 14"," 1585"," 132"
"4588","glenn","2020-06-18","   1","   47","   0","  0","   46","   0"
"4589","butte","2020-06-18","   4","  448","   6","  2","  444","   4"
"4590","monterey","2020-06-18","  21","  824","  89","  5","  803","  84"
"4591","san francisco","2020-06-18","  45"," 2647"," 155"," 10"," 2602"," 145"
"4592","san diego","2020-06-18"," 351"," 6190"," 313","151"," 5839"," 162"
"4593","mendocino","2020-06-18","   0","  180","   4","  0","  180","   4"
"4594","san mateo","2020-06-18","  24"," 1089","  59","  8"," 1065","  51"
"4595","alameda","2020-06-18"," 130"," 2968"," 195"," 54"," 2838"," 141"
"4596","solano","2020-06-18","  29","  707","  53","  5","  678","  48"
"4597","alameda","2020-06-19"," 137"," 2968"," 192"," 56"," 2831"," 136"
"4598","san benito","2020-06-19","   0","   25","   2","  0","   25","   2"
"4599","del norte","2020-06-19","   0","   51","   5","  0","   51","   5"
"4600","humboldt","2020-06-19","   1","  352","   1","  1","  351","   0"
"4601","lake","2020-06-19","   0","  110","   1","  0","  110","   1"
"4602","solano","2020-06-19","  24","  707","  49","  6","  683","  43"
"4603","monterey","2020-06-19","  19","  824","  87","  5","  805","  82"
"4604","los angeles","2020-06-19","1920","23649","1197","481","21729"," 716"
"4605","merced","2020-06-19","  10","  242","   5","  3","  232","   2"
"4606","mariposa","2020-06-19","   0","   30","   0","  0","   30","   0"
"4607","el dorado","2020-06-19","   3","  235","   9","  3","  232","   6"
"4608","placer","2020-06-19","  22","  753","  65","  5","  731","  60"
"4609","amador","2020-06-19","   0","   51","   2","  0","   51","   2"
"4610","imperial","2020-06-19","  80","  237","   5"," 17","  157"," -12"
"4611","siskiyou","2020-06-19","   1","   65","   3","  1","   64","   2"
"4612","modoc","2020-06-19","   0","   41","   0","  0","   41","   0"
"4613","shasta","2020-06-19","   1","  667","   1","  1","  666","   0"
"4614","san mateo","2020-06-19","  20"," 1089","  61","  5"," 1069","  56"
"4615","contra costa","2020-06-19","  41"," 1628"," 150"," 10"," 1587"," 140"
"4616","mendocino","2020-06-19","   4","  180","   4","  0","  176","   4"
"4617","santa clara","2020-06-19","  60"," 3438"," 209"," 21"," 3378"," 188"
"4618","mono","2020-06-19","   0","   40","   2","  0","   40","   2"
"4619","colusa","2020-06-19","   0","   88","   6","  0","   88","   6"
"4620","san francisco","2020-06-19","  39"," 2647"," 151"," 12"," 2608"," 139"
"4621","tehama","2020-06-19","   0","  106","   1","  0","  106","   1"
"4622","sacramento","2020-06-19","  54"," 2479"," 180"," 21"," 2425"," 159"
"4623","lassen","2020-06-19","   0","   25","   0","  0","   25","   0"
"4624","inyo","2020-06-19","   0","   42","   2","  0","   42","   2"
"4625","san bernardino","2020-06-19"," 318"," 4821"," 147"," 99"," 4503","  48"
"4626","butte","2020-06-19","   5","  448","   9","  3","  443","   6"
"4627","glenn","2020-06-19","   0","   47","   0","  0","   47","   0"
"4628","san luis obispo","2020-06-19","   7","  440","  15","  3","  433","  12"
"4629","nevada","2020-06-19","   5","  123","   5","  0","  118","   5"
"4630","calaveras","2020-06-19","   1","   50","   9","  0","   49","   9"
"4631","yolo","2020-06-19","   2","  186","   4","  0","  184","   4"
"4632","stanislaus","2020-06-19","  93"," 1364","  86"," 27"," 1271","  59"
"4633","yuba","2020-06-19","   4","  445","   7","  1","  441","   6"
"4634","fresno","2020-06-19"," 101"," 2135","  72"," 18"," 2034","  54"
"4635","madera","2020-06-19","  11","  528","  11","  5","  517","   6"
"4636","marin","2020-06-19","   5","  390","  12","  3","  385","   9"
"4637","san diego","2020-06-19"," 359"," 6214"," 302","153"," 5855"," 149"
"4638","santa barbara","2020-06-19","  50","  717","  53"," 18","  667","  35"
"4639","san joaquin","2020-06-19","  74"," 1376","  56"," 21"," 1302","  35"
"4640","napa","2020-06-19","  11","  397","   4","  0","  386","   4"
"4641","santa cruz","2020-06-19","   8","  397","   7","  3","  389","   4"
"4642","sutter","2020-06-19","   0","   14","   0","  0","   14","   0"
"4643","riverside","2020-06-19"," 386"," 4013","  91"," 97"," 3627","  -6"
"4644","tulare","2020-06-19","  50","  780","   9"," 12","  730","  -3"
"4645","sonoma","2020-06-19","   8","  871","  57","  4","  863","  53"
"4646","plumas","2020-06-19","   0","   45","   0","  0","   45","   0"
"4647","ventura","2020-06-19","  81"," 1348","  39"," 20"," 1267","  19"
"4648","trinity","2020-06-19","   4","   54","   0","  0","   50","   0"
"4649","kern","2020-06-19"," 103"," 1742","  87"," 38"," 1639","  49"
"4650","kings","2020-06-19","  50","  199","   4"," 10","  149","  -6"
"4651","orange","2020-06-19"," 410"," 6976"," 420","149"," 6566"," 271"
"4652","tuolumne","2020-06-19","   0","  151","   2","  0","  151","   2"
"4653","stanislaus","2020-06-20","  97"," 1364","  97"," 27"," 1267","  70"
"4654","tuolumne","2020-06-20","   0","  151","   4","  0","  151","   4"
"4655","san joaquin","2020-06-20","  87"," 1376","  61"," 28"," 1289","  33"
"4656","amador","2020-06-20","   0","   51","   1","  0","   51","   1"
"4657","san luis obispo","2020-06-20","   9","  464","  22","  3","  455","  19"
"4658","orange","2020-06-20"," 446"," 6976"," 410","167"," 6530"," 243"
"4659","los angeles","2020-06-20","1969","23631","1276","495","21662"," 781"
"4660","nevada","2020-06-20","   6","  123","   4","  1","  117","   3"
"4661","fresno","2020-06-20"," 115"," 2134","  80"," 17"," 2019","  63"
"4662","mendocino","2020-06-20","   0","  180","   6","  0","  180","   6"
"4663","tehama","2020-06-20","   0","  106","   2","  0","  106","   2"
"4664","humboldt","2020-06-20","   1","  352","   4","  1","  351","   3"
"4665","san bernardino","2020-06-20"," 330"," 4821"," 149"," 99"," 4491","  50"
"4666","inyo","2020-06-20","   0","   42","   3","  0","   42","   3"
"4667","ventura","2020-06-20","  73"," 1352","  40"," 16"," 1279","  24"
"4668","mariposa","2020-06-20","   0","   30","   0","  0","   30","   0"
"4669","placer","2020-06-20","  21","  753","  62","  4","  732","  58"
"4670","sacramento","2020-06-20","  53"," 2452"," 171"," 23"," 2399"," 148"
"4671","butte","2020-06-20","   3","  448","  11","  3","  445","   8"
"4672","san diego","2020-06-20"," 330"," 6169"," 308","148"," 5839"," 160"
"4673","sutter","2020-06-20","   0","   14","   0","  0","   14","   0"
"4674","modoc","2020-06-20","   0","   41","   0","  0","   41","   0"
"4675","san mateo","2020-06-20","  21"," 1089","  62","  7"," 1068","  55"
"4676","contra costa","2020-06-20","  51"," 1628"," 145"," 14"," 1577"," 131"
"4677","alameda","2020-06-20"," 121"," 2968"," 203"," 45"," 2847"," 158"
"4678","napa","2020-06-20","  10","  397","   5","  0","  387","   5"
"4679","lake","2020-06-20","   0","  110","   1","  0","  110","   1"
"4680","sonoma","2020-06-20","   5","  871","  92","  3","  866","  89"
"4681","san benito","2020-06-20","   0","   25","   3","  0","   25","   3"
"4682","santa cruz","2020-06-20","   7","  397","   9","  2","  390","   7"
"4683","santa clara","2020-06-20","  55"," 3438"," 212"," 21"," 3383"," 191"
"4684","calaveras","2020-06-20","   2","   50","   9","  1","   48","   8"
"4685","madera","2020-06-20","  10","  528","   8","  3","  518","   5"
"4686","san francisco","2020-06-20","  56"," 2647"," 140"," 15"," 2591"," 125"
"4687","merced","2020-06-20","  10","  242","   3","  4","  232","  -1"
"4688","santa barbara","2020-06-20","  57","  717","  46"," 17","  660","  29"
"4689","glenn","2020-06-20","   0","   47","   0","  0","   47","   0"
"4690","el dorado","2020-06-20","   2","  235","   9","  2","  233","   7"
"4691","imperial","2020-06-20","  89","  237","   4"," 20","  148"," -16"
"4692","del norte","2020-06-20","   0","   51","   5","  0","   51","   5"
"4693","kern","2020-06-20"," 116"," 1742","  89"," 42"," 1626","  47"
"4694","shasta","2020-06-20","   1","  667","   3","  1","  666","   2"
"4695","colusa","2020-06-20","   0","   88","   6","  0","   88","   6"
"4696","kings","2020-06-20","  44","  199","   2","  8","  155","  -6"
"4697","mono","2020-06-20","   0","   40","   2","  0","   40","   2"
"4698","plumas","2020-06-20","   0","   45","   0","  0","   45","   0"
"4699","lassen","2020-06-20","   0","   25","   0","  0","   25","   0"
"4700","tulare","2020-06-20","  49","  780","   8"," 11","  731","  -3"
"4701","trinity","2020-06-20","   4","   54","   0","  0","   50","   0"
"4702","yolo","2020-06-20","   3","  186","   3","  1","  183","   2"
"4703","riverside","2020-06-20"," 366"," 3959"," 113","100"," 3593","  13"
"4704","marin","2020-06-20","   5","  390","   9","  3","  385","   6"
"4705","yuba","2020-06-20","   3","  445","  11","  1","  442","  10"
"4706","monterey","2020-06-20","  19","  824","  81","  5","  805","  76"
"4707","solano","2020-06-20","  32","  707","  47","  7","  675","  40"
"4708","siskiyou","2020-06-20","   1","   65","   4","  1","   64","   3"
"4709","santa cruz","2020-06-21","   9","  397","  11","  2","  388","   9"
"4710","santa clara","2020-06-21","  61"," 3438"," 229"," 21"," 3377"," 208"
"4711","orange","2020-06-21"," 446"," 6976"," 406","171"," 6530"," 235"
"4712","san luis obispo","2020-06-21","   6","  461","  26","  2","  455","  24"
"4713","mariposa","2020-06-21","   0","   30","   0","  0","   30","   0"
"4714","calaveras","2020-06-21","   1","   50","  10","  0","   49","  10"
"4715","sacramento","2020-06-21","  61"," 2450"," 184"," 28"," 2389"," 156"
"4716","alameda","2020-06-21"," 119"," 2968"," 203"," 42"," 2849"," 161"
"4717","kings","2020-06-21","  45","  199","   3","  7","  154","  -4"
"4718","monterey","2020-06-21","  18","  824","  82","  6","  806","  76"
"4719","riverside","2020-06-21"," 405"," 3960"," 105","110"," 3555","  -5"
"4720","napa","2020-06-21","   8","  397","   5","  0","  389","   5"
"4721","sonoma","2020-06-21","   7","  871","  62","  3","  864","  59"
"4722","marin","2020-06-21","  11","  390","  10","  3","  379","   7"
"4723","tulare","2020-06-21","  54","  780","  13"," 11","  726","   2"
"4724","contra costa","2020-06-21","  51"," 1628"," 147"," 17"," 1577"," 130"
"4725","san francisco","2020-06-21","  44"," 2647"," 149"," 13"," 2603"," 136"
"4726","butte","2020-06-21","   6","  448","  10","  5","  442","   5"
"4727","plumas","2020-06-21","   0","   45","   0","  0","   45","   0"
"4728","shasta","2020-06-21","   3","  667","   2","  2","  664","   0"
"4729","tuolumne","2020-06-21","   0","  151","   5","  0","  151","   5"
"4730","stanislaus","2020-06-21","  91"," 1369","  96"," 27"," 1278","  69"
"4731","siskiyou","2020-06-21","   1","   65","   4","  1","   64","   3"
"4732","del norte","2020-06-21","   0","   51","   6","  0","   51","   6"
"4733","sutter","2020-06-21","   0","   14","   0","  0","   14","   0"
"4734","san bernardino","2020-06-21"," 344"," 4821"," 159","108"," 4477","  51"
"4735","mendocino","2020-06-21","   0","  180","  10","  0","  180","  10"
"4736","inyo","2020-06-21","   0","   42","   3","  0","   42","   3"
"4737","mono","2020-06-21","   0","   40","   2","  0","   40","   2"
"4738","yuba","2020-06-21","   3","  445","  11","  2","  442","   9"
"4739","san mateo","2020-06-21","  27"," 1089","  63","  9"," 1062","  54"
"4740","nevada","2020-06-21","   7","  123","   3","  2","  116","   1"
"4741","imperial","2020-06-21","  95","  237","   1"," 21","  142"," -20"
"4742","lassen","2020-06-21","   0","   25","   0","  0","   25","   0"
"4743","trinity","2020-06-21","   3","   54","   0","  0","   51","   0"
"4744","fresno","2020-06-21"," 104"," 2126","  83"," 20"," 2022","  63"
"4745","amador","2020-06-21","   1","   51","   0","  1","   50","  -1"
"4746","placer","2020-06-21","  20","  753","  56","  2","  733","  54"
"4747","el dorado","2020-06-21","   2","  235","   8","  2","  233","   6"
"4748","san joaquin","2020-06-21"," 102"," 1376","  58"," 26"," 1274","  32"
"4749","yolo","2020-06-21","   4","  186","   0","  2","  182","  -2"
"4750","madera","2020-06-21","   7","  528","  12","  3","  521","   9"
"4751","los angeles","2020-06-21","2001","23624","1316","492","21623"," 824"
"4752","san diego","2020-06-21"," 326"," 6088"," 330","152"," 5762"," 178"
"4753","solano","2020-06-21","  29","  707","  45","  9","  678","  36"
"4754","lake","2020-06-21","   1","  110","   2","  0","  109","   2"
"4755","san benito","2020-06-21","   0","   25","   3","  0","   25","   3"
"4756","kern","2020-06-21"," 125"," 1742","  90"," 41"," 1617","  49"
"4757","humboldt","2020-06-21","   1","  352","   3","  1","  351","   2"
"4758","santa barbara","2020-06-21","  54","  717","  43"," 21","  663","  22"
"4759","colusa","2020-06-21","   1","   88","   6","  0","   87","   6"
"4760","tehama","2020-06-21","   0","  106","   5","  0","  106","   5"
"4761","glenn","2020-06-21","   0","   47","   0","  0","   47","   0"
"4762","merced","2020-06-21","  12","  242","   3","  3","  230","   0"
"4763","modoc","2020-06-21","   0","   41","   0","  0","   41","   0"
"4764","ventura","2020-06-21","  88"," 1345","  37"," 24"," 1257","  13"
"4765","madera","2020-06-22","   7","  528","  15","  2","  521","  13"
"4766","butte","2020-06-22","   9","  448","  11","  5","  439","   6"
"4767","sonoma","2020-06-22","   7","  871","  58","  5","  864","  53"
"4768","contra costa","2020-06-22","  51"," 1579"," 164"," 13"," 1528"," 151"
"4769","alameda","2020-06-22"," 112"," 2968"," 196"," 38"," 2856"," 158"
"4770","tuolumne","2020-06-22","   0","  151","   4","  0","  151","   4"
"4771","santa cruz","2020-06-22","  10","  397","  13","  2","  387","  11"
"4772","san benito","2020-06-22","   0","   25","   1","  0","   25","   1"
"4773","tulare","2020-06-22","  57","  780","   6"," 10","  723","  -4"
"4774","kern","2020-06-22"," 129"," 1742","  89"," 44"," 1613","  45"
"4775","napa","2020-06-22","  10","  397","   6","  2","  387","   4"
"4776","stanislaus","2020-06-22","  92"," 1374","  86"," 29"," 1282","  57"
"4777","imperial","2020-06-22","  95","  237","   0"," 17","  142"," -17"
"4778","mono","2020-06-22","   0","   40","   2","  0","   40","   2"
"4779","shasta","2020-06-22","   2","  667","   4","  1","  665","   3"
"4780","modoc","2020-06-22","   0","   41","   0","  0","   41","   0"
"4781","monterey","2020-06-22","  21","  824","  91","  7","  803","  84"
"4782","solano","2020-06-22","  26","  707","  46","  8","  681","  38"
"4783","mendocino","2020-06-22","   0","  180","  10","  0","  180","  10"
"4784","amador","2020-06-22","   0","   51","   0","  0","   51","   0"
"4785","placer","2020-06-22","  20","  753","  58","  2","  733","  56"
"4786","calaveras","2020-06-22","   0","   50","  10","  0","   50","  10"
"4787","mariposa","2020-06-22","   0","   30","   0","  0","   30","   0"
"4788","san luis obispo","2020-06-22","   7","  445","  21","  4","  438","  17"
"4789","orange","2020-06-22"," 466"," 6976"," 413","176"," 6510"," 237"
"4790","san diego","2020-06-22"," 346"," 6067"," 357","155"," 5721"," 202"
"4791","los angeles","2020-06-22","2090","23612","1398","482","21522"," 916"
"4792","lake","2020-06-22","   0","  110","   2","  0","  110","   2"
"4793","humboldt","2020-06-22","   1","  352","   3","  0","  351","   3"
"4794","san bernardino","2020-06-22"," 385"," 4821"," 128","123"," 4436","   5"
"4795","sacramento","2020-06-22","  54"," 2458"," 181"," 20"," 2404"," 161"
"4796","san joaquin","2020-06-22"," 141"," 1376","  58"," 27"," 1235","  31"
"4797","san francisco","2020-06-22","  47"," 2337"," 140"," 14"," 2290"," 126"
"4798","el dorado","2020-06-22","   1","  235","   7","  1","  234","   6"
"4799","yolo","2020-06-22","   1","  186","   0","  1","  185","  -1"
"4800","merced","2020-06-22","   9","  242","   4","  3","  233","   1"
"4801","ventura","2020-06-22"," 105"," 1342","  38"," 27"," 1237","  11"
"4802","santa barbara","2020-06-22","  58","  717","  36"," 21","  659","  15"
"4803","tehama","2020-06-22","   0","  106","   4","  0","  106","   4"
"4804","santa clara","2020-06-22","  64"," 3438"," 229"," 25"," 3374"," 204"
"4805","del norte","2020-06-22","   0","   51","   6","  0","   51","   6"
"4806","marin","2020-06-22","  13","  390","  14","  4","  377","  10"
"4807","san mateo","2020-06-22","  23"," 1089","  60"," 10"," 1066","  50"
"4808","plumas","2020-06-22","   0","   45","   0","  0","   45","   0"
"4809","sutter","2020-06-22","   0","   14","   0","  0","   14","   0"
"4810","nevada","2020-06-22","   6","  128","   3","  3","  122","   0"
"4811","riverside","2020-06-22"," 423"," 3960"," 104","109"," 3537","  -5"
"4812","colusa","2020-06-22","   1","   88","   6","  0","   87","   6"
"4813","inyo","2020-06-22","   0","   42","   3","  0","   42","   3"
"4814","yuba","2020-06-22","   4","  445","   6","  3","  441","   3"
"4815","siskiyou","2020-06-22","   1","   65","   4","  1","   64","   3"
"4816","glenn","2020-06-22","   0","   47","   0","  0","   47","   0"
"4817","fresno","2020-06-22"," 122"," 2125","  82"," 19"," 2003","  63"
"4818","lassen","2020-06-22","   0","   25","   0","  0","   25","   0"
"4819","trinity","2020-06-22","   2","   54","   0","  0","   52","   0"
"4820","kings","2020-06-22","  47","  199","   1","  8","  152","  -7"
"4821","placer","2020-06-23","  13","  753","  62","  2","  740","  60"
"4822","tuolumne","2020-06-23","   1","  151","   5","  0","  150","   5"
"4823","monterey","2020-06-23","  23","  824","  88","  7","  801","  81"
"4824","fresno","2020-06-23"," 139"," 2133","  83"," 22"," 1994","  61"
"4825","napa","2020-06-23","  14","  397","   3","  1","  383","   2"
"4826","alameda","2020-06-23"," 128"," 2968"," 196"," 44"," 2840"," 152"
"4827","lake","2020-06-23","   1","  110","   0","  1","  109","  -1"
"4828","san francisco","2020-06-23","  53"," 2647"," 145"," 18"," 2594"," 127"
"4829","riverside","2020-06-23"," 434"," 4010","  98","115"," 3576"," -17"
"4830","san bernardino","2020-06-23"," 441"," 4821"," 130","133"," 4380","  -3"
"4831","plumas","2020-06-23","   0","   45","   0","  0","   45","   0"
"4832","santa clara","2020-06-23","  72"," 3438"," 225"," 31"," 3366"," 194"
"4833","butte","2020-06-23","   7","  448","  12","  4","  441","   8"
"4834","tehama","2020-06-23","   0","  106","   5","  0","  106","   5"
"4835","yuba","2020-06-23","   7","  445","  10","  1","  438","   9"
"4836","san benito","2020-06-23","   0","   25","   1","  0","   25","   1"
"4837","mono","2020-06-23","   0","   40","   2","  0","   40","   2"
"4838","orange","2020-06-23"," 485"," 6976"," 395","174"," 6491"," 221"
"4839","sutter","2020-06-23","   0","   14","   0","  0","   14","   0"
"4840","merced","2020-06-23","  12","  242","   4","  3","  230","   1"
"4841","yolo","2020-06-23","   1","  186","   2","  1","  185","   1"
"4842","santa barbara","2020-06-23","  61","  717","  33"," 24","  656","   9"
"4843","siskiyou","2020-06-23","   1","   65","   2","  1","   64","   1"
"4844","imperial","2020-06-23","  93","  237","   2"," 18","  144"," -16"
"4845","contra costa","2020-06-23","  52"," 1579"," 159"," 10"," 1527"," 149"
"4846","solano","2020-06-23","  26","  707","  46","  7","  681","  39"
"4847","mendocino","2020-06-23","   0","  180","   7","  0","  180","   7"
"4848","humboldt","2020-06-23","   2","  352","   1","  1","  350","   0"
"4849","san joaquin","2020-06-23"," 109"," 1376","  61"," 26"," 1267","  35"
"4850","kern","2020-06-23"," 133"," 1742","  87"," 44"," 1609","  43"
"4851","kings","2020-06-23","  51","  199","   1","  9","  148","  -8"
"4852","colusa","2020-06-23","   1","   88","   6","  0","   87","   6"
"4853","calaveras","2020-06-23","   1","   50","  12","  0","   49","  12"
"4854","trinity","2020-06-23","   1","   54","   0","  0","   53","   0"
"4855","shasta","2020-06-23","   3","  667","   5","  1","  664","   4"
"4856","los angeles","2020-06-23","2259","23601","1301","516","21342"," 785"
"4857","modoc","2020-06-23","   0","   41","   0","  0","   41","   0"
"4858","madera","2020-06-23","   7","  528","  15","  1","  521","  14"
"4859","del norte","2020-06-23","   1","   51","   4","  1","   50","   3"
"4860","amador","2020-06-23","   0","   51","   0","  0","   51","   0"
"4861","nevada","2020-06-23","   5","  126","   4","  2","  121","   2"
"4862","santa cruz","2020-06-23","   9","  397","  12","  1","  388","  11"
"4863","ventura","2020-06-23","  94"," 1350","  40"," 23"," 1256","  17"
"4864","san luis obispo","2020-06-23","   7","  461","  19","  3","  454","  16"
"4865","tulare","2020-06-23","  61","  780","  16"," 11","  719","   5"
"4866","inyo","2020-06-23","   0","   42","   3","  0","   42","   3"
"4867","san diego","2020-06-23"," 370"," 6183"," 338","157"," 5813"," 181"
"4868","el dorado","2020-06-23","   3","  235","   6","  3","  232","   3"
"4869","mariposa","2020-06-23","   0","   30","   0","  0","   30","   0"
"4870","lassen","2020-06-23","   0","   25","   0","  0","   25","   0"
"4871","stanislaus","2020-06-23","  98"," 1374","  84"," 29"," 1276","  55"
"4872","san mateo","2020-06-23","  27"," 1089","  62"," 10"," 1062","  52"
"4873","marin","2020-06-23","  14","  390","  15","  4","  376","  11"
"4874","glenn","2020-06-23","   0","   47","   0","  0","   47","   0"
"4875","sacramento","2020-06-23","  65"," 2477"," 171"," 18"," 2412"," 153"
"4876","sonoma","2020-06-23","  14","  871","  56"," 10","  857","  46"
"4877","placer","2020-06-24","  16","  753","  54","  3","  737","  51"
"4878","los angeles","2020-06-24","2283","23580","1259","523","21297"," 736"
"4879","san diego","2020-06-24"," 383"," 6195"," 335","167"," 5812"," 168"
"4880","san joaquin","2020-06-24"," 122"," 1376","  52"," 28"," 1254","  24"
"4881","riverside","2020-06-24"," 437"," 4010"," 100","122"," 3573"," -22"
"4882","sacramento","2020-06-24","  77"," 2491","  97"," 18"," 2414","  79"
"4883","alameda","2020-06-24"," 130"," 2968"," 147"," 40"," 2838"," 107"
"4884","contra costa","2020-06-24","  58"," 1579"," 165"," 13"," 1521"," 152"
"4885","mariposa","2020-06-24","   0","   30","   0","  0","   30","   0"
"4886","plumas","2020-06-24","   0","   45","   0","  0","   45","   0"
"4887","ventura","2020-06-24","  86"," 1360","  53"," 23"," 1274","  30"
"4888","butte","2020-06-24","   7","  448","   8","  5","  441","   3"
"4889","san bernardino","2020-06-24"," 432"," 4821"," 131","125"," 4389","   6"
"4890","mendocino","2020-06-24","   0","  180","   6","  0","  180","   6"
"4891","kern","2020-06-24"," 132"," 1742","  80"," 46"," 1610","  34"
"4892","san mateo","2020-06-24","  29"," 1089","  50"," 11"," 1060","  39"
"4893","calaveras","2020-06-24","   0","   50","  11","  0","   50","  11"
"4894","san luis obispo","2020-06-24","  11","  484","  37","  3","  473","  34"
"4895","imperial","2020-06-24","  82","  237","   2"," 14","  155"," -12"
"4896","fresno","2020-06-24"," 139"," 2113","  86"," 24"," 1974","  62"
"4897","glenn","2020-06-24","   0","   47","   0","  0","   47","   0"
"4898","santa clara","2020-06-24","  78"," 3438"," 215"," 31"," 3360"," 184"
"4899","sonoma","2020-06-24","   8","  871","  55","  5","  863","  50"
"4900","santa cruz","2020-06-24","   9","  397","  12","  1","  388","  11"
"4901","modoc","2020-06-24","   0","   41","   0","  0","   41","   0"
"4902","nevada","2020-06-24","   3","  139","   4","  3","  136","   1"
"4903","el dorado","2020-06-24","   1","  235","   7","  1","  234","   6"
"4904","yolo","2020-06-24","   5","  186","   0","  4","  181","  -4"
"4905","merced","2020-06-24","  17","  242","   2","  4","  225","  -2"
"4906","monterey","2020-06-24","  25","  824","  81","  9","  799","  72"
"4907","tehama","2020-06-24","   0","  106","   5","  0","  106","   5"
"4908","inyo","2020-06-24","   1","   42","   4","  0","   41","   4"
"4909","orange","2020-06-24"," 543"," 6976"," 385","186"," 6433"," 199"
"4910","solano","2020-06-24","  28","  707","  44","  6","  679","  38"
"4911","napa","2020-06-24","   7","  397","   0","  5","  390","  -5"
"4912","del norte","2020-06-24","   1","   51","   0","  1","   50","  -1"
"4913","kings","2020-06-24","  54","  199","   0","  9","  145","  -9"
"4914","tuolumne","2020-06-24","   0","  151","   5","  0","  151","   5"
"4915","colusa","2020-06-24","   1","   88","   6","  0","   87","   6"
"4916","stanislaus","2020-06-24"," 102"," 1374","  81"," 31"," 1272","  50"
"4917","lassen","2020-06-24","   0","   25","   0","  0","   25","   0"
"4918","madera","2020-06-24","  13","  528","  15","  2","  515","  13"
"4919","shasta","2020-06-24","   3","  667","   7","  1","  664","   6"
"4920","tulare","2020-06-24","  59","  780","   6","  9","  721","  -3"
"4921","humboldt","2020-06-24","   3","  352","   2","  2","  349","   0"
"4922","marin","2020-06-24","  16","  390","   9","  5","  374","   4"
"4923","san francisco","2020-06-24","  55"," 2647"," 105"," 20"," 2592","  85"
"4924","siskiyou","2020-06-24","   1","   65","   3","  1","   64","   2"
"4925","mono","2020-06-24","   0","   40","   2","  0","   40","   2"
"4926","amador","2020-06-24","   0","   51","   1","  0","   51","   1"
"4927","sutter","2020-06-24","   0","   14","   0","  0","   14","   0"
"4928","trinity","2020-06-24","   2","   54","   0","  0","   52","   0"
"4929","san benito","2020-06-24","   0","   25","   1","  0","   25","   1"
"4930","santa barbara","2020-06-24","  57","  717","  53"," 21","  660","  32"
"4931","yuba","2020-06-24","   5","  445","   7","  1","  440","   6"
"4932","lake","2020-06-24","   1","  110","   0","  0","  109","   0"
"4933","mariposa","2020-06-25","   0","   30","   0","  0","   30","   0"
"4934","yuba","2020-06-25","   6","  445","   8","  2","  439","   6"
"4935","siskiyou","2020-06-25","   1","   65","   5","  1","   64","   4"
"4936","san luis obispo","2020-06-25","   8","  477","  35","  4","  469","  31"
"4937","monterey","2020-06-25","  24","  824","  78"," 11","  800","  67"
"4938","contra costa","2020-06-25","  60"," 1579"," 147"," 15"," 1519"," 132"
"4939","placer","2020-06-25","  16","  753","  50","  3","  737","  47"
"4940","solano","2020-06-25","  29","  707","  45","  8","  678","  37"
"4941","san benito","2020-06-25","   0","   25","   1","  0","   25","   1"
"4942","kings","2020-06-25","  57","  199","   4","  8","  142","  -4"
"4943","el dorado","2020-06-25","   1","  235","  11","  1","  234","  10"
"4944","san diego","2020-06-25"," 425"," 6148"," 294","168"," 5723"," 126"
"4945","alameda","2020-06-25"," 140"," 2968"," 147"," 44"," 2828"," 103"
"4946","shasta","2020-06-25","   5","  667","   1","  2","  662","  -1"
"4947","inyo","2020-06-25","   0","   42","   4","  0","   42","   4"
"4948","san francisco","2020-06-25","  54"," 2647"," 104"," 17"," 2593","  87"
"4949","sonoma","2020-06-25","  11","  871","  54","  6","  860","  48"
"4950","yolo","2020-06-25","   6","  186","   1","  4","  180","  -3"
"4951","colusa","2020-06-25","   1","   88","   6","  0","   87","   6"
"4952","madera","2020-06-25","  13","  528","  10","  3","  515","   7"
"4953","nevada","2020-06-25","   4","  121","   3","  4","  117","  -1"
"4954","humboldt","2020-06-25","   3","  352","   1","  3","  349","  -2"
"4955","santa clara","2020-06-25","  82"," 3438"," 186"," 26"," 3356"," 160"
"4956","sacramento","2020-06-25","  97"," 2491","  93"," 24"," 2394","  69"
"4957","riverside","2020-06-25"," 460"," 4010","  86","128"," 3550"," -42"
"4958","san joaquin","2020-06-25"," 137"," 1384","  50"," 32"," 1247","  18"
"4959","mendocino","2020-06-25","   0","  180","   4","  0","  180","   4"
"4960","butte","2020-06-25","   6","  448","   5","  2","  442","   3"
"4961","mono","2020-06-25","   0","   40","   2","  0","   40","   2"
"4962","marin","2020-06-25","  16","  390","  13","  6","  374","   7"
"4963","napa","2020-06-25","   5","  397","   5","  4","  392","   1"
"4964","modoc","2020-06-25","   0","   41","   0","  0","   41","   0"
"4965","merced","2020-06-25","  14","  242","   1","  6","  228","  -5"
"4966","san mateo","2020-06-25","  27"," 1089","  49"," 11"," 1062","  38"
"4967","tehama","2020-06-25","   0","  106","   5","  0","  106","   5"
"4968","tulare","2020-06-25","  59","  835","   7"," 11","  776","  -4"
"4969","ventura","2020-06-25","  98"," 1357","  57"," 22"," 1259","  35"
"4970","kern","2020-06-25"," 137"," 1742","  78"," 51"," 1605","  27"
"4971","plumas","2020-06-25","   0","   45","   0","  0","   45","   0"
"4972","glenn","2020-06-25","   0","   47","   0","  0","   47","   0"
"4973","santa barbara","2020-06-25","  59","  717","  50"," 26","  658","  24"
"4974","imperial","2020-06-25","  77","  237","   6"," 16","  160"," -10"
"4975","stanislaus","2020-06-25"," 114"," 1374","  94"," 35"," 1260","  59"
"4976","fresno","2020-06-25"," 147"," 2022","  74"," 26"," 1875","  48"
"4977","trinity","2020-06-25","   2","   54","   0","  0","   52","   0"
"4978","santa cruz","2020-06-25","  13","  397","   9","  2","  384","   7"
"4979","lassen","2020-06-25","   0","   25","   0","  0","   25","   0"
"4980","lake","2020-06-25","   2","  110","   1","  2","  108","  -1"
"4981","tuolumne","2020-06-25","   1","  151","   1","  0","  150","   1"
"4982","amador","2020-06-25","   0","   51","   1","  0","   51","   1"
"4983","del norte","2020-06-25","   1","   51","   1","  1","   50","   0"
"4984","orange","2020-06-25"," 546"," 6976"," 383","189"," 6430"," 194"
"4985","calaveras","2020-06-25","   2","   50","   9","  1","   48","   8"
"4986","sutter","2020-06-25","   0","   14","   0","  0","   14","   0"
"4987","los angeles","2020-06-25","2237","23520","1234","518","21283"," 716"
"4988","san bernardino","2020-06-25"," 436"," 4821"," 119","127"," 4385","  -8"
"4989","glenn","2020-06-26","   1","   47","   0","  0","   46","   0"
"4990","kern","2020-06-26"," 147"," 1742","  73"," 48"," 1595","  25"
"4991","sacramento","2020-06-26","  83"," 2510","  78"," 21"," 2427","  57"
"4992","humboldt","2020-06-26","   5","  352","   2","  0","  347","   2"
"4993","plumas","2020-06-26","   0","   45","   0","  0","   45","   0"
"4994","madera","2020-06-26","  13","  528","  15","  0","  515","  15"
"4995","sutter","2020-06-26","   0","   14","   0","  0","   14","   0"
"4996","santa barbara","2020-06-26","  59","  717","  74"," 21","  658","  53"
"4997","siskiyou","2020-06-26","   0","   65","   3","  0","   65","   3"
"4998","napa","2020-06-26","   7","  397","   6","  5","  390","   1"
"4999","yuba","2020-06-26","   6","  445","  15","  1","  439","  14"
"5000","santa clara","2020-06-26","  82"," 3438"," 188"," 26"," 3356"," 162"
"5001","modoc","2020-06-26","   1","   41","   0","  0","   40","   0"
"5002","trinity","2020-06-26","   1","   54","   0","  0","   53","   0"
"5003","contra costa","2020-06-26","  65"," 1579"," 132"," 12"," 1514"," 120"
"5004","riverside","2020-06-26"," 474"," 4028"," 103","117"," 3554"," -14"
"5005","orange","2020-06-26"," 560"," 6976"," 396","199"," 6416"," 197"
"5006","san diego","2020-06-26"," 427"," 6176"," 310","171"," 5749"," 139"
"5007","kings","2020-06-26","  58","  199","   6","  6","  141","   0"
"5008","tuolumne","2020-06-26","   1","  151","   2","  0","  150","   2"
"5009","san benito","2020-06-26","   0","   25","   1","  0","   25","   1"
"5010","ventura","2020-06-26"," 100"," 1355","  57"," 24"," 1255","  33"
"5011","mono","2020-06-26","   0","   40","   1","  0","   40","   1"
"5012","imperial","2020-06-26","  74","  237","  10"," 15","  163","  -5"
"5013","nevada","2020-06-26","   6","  124","   4","  2","  118","   2"
"5014","santa cruz","2020-06-26","  14","  397","   9","  1","  383","   8"
"5015","tulare","2020-06-26","  66","  835","  11"," 12","  769","  -1"
"5016","alameda","2020-06-26"," 133"," 2968"," 123"," 44"," 2835","  79"
"5017","fresno","2020-06-26"," 157"," 2018","  73"," 28"," 1861","  45"
"5018","placer","2020-06-26","  13","  753","  33","  3","  740","  30"
"5019","san joaquin","2020-06-26"," 152"," 1430","  44"," 35"," 1278","   9"
"5020","shasta","2020-06-26","   6","  667","   3","  2","  661","   1"
"5021","mendocino","2020-06-26","   0","  180","   6","  0","  180","   6"
"5022","lake","2020-06-26","   1","  110","   1","  1","  109","   0"
"5023","amador","2020-06-26","   0","   51","   0","  0","   51","   0"
"5024","tehama","2020-06-26","   0","  106","   5","  0","  106","   5"
"5025","yolo","2020-06-26","   6","  186","   3","  4","  180","  -1"
"5026","merced","2020-06-26","  15","  242","   4","  5","  227","  -1"
"5027","san francisco","2020-06-26","  68"," 2647","  89"," 22"," 2579","  67"
"5028","inyo","2020-06-26","   0","   42","   4","  0","   42","   4"
"5029","butte","2020-06-26","   6","  448","  11","  1","  442","  10"
"5030","calaveras","2020-06-26","   2","   50","  10","  1","   48","   9"
"5031","sonoma","2020-06-26","  12","  871","  50","  5","  859","  45"
"5032","los angeles","2020-06-26","2296","23565","1289","525","21269"," 764"
"5033","san bernardino","2020-06-26"," 446"," 4821"," 115","133"," 4375"," -18"
"5034","marin","2020-06-26","  21","  390","  13","  5","  369","   8"
"5035","san luis obispo","2020-06-26","   8","  471","  36","  2","  463","  34"
"5036","solano","2020-06-26","  33","  707","  39","  8","  674","  31"
"5037","stanislaus","2020-06-26"," 122"," 1369","  84"," 37"," 1247","  47"
"5038","del norte","2020-06-26","   1","   51","   2","  1","   50","   1"
"5039","colusa","2020-06-26","   1","   88","   6","  0","   87","   6"
"5040","el dorado","2020-06-26","   1","  235","   9","  1","  234","   8"
"5041","mariposa","2020-06-26","   0","   30","   0","  0","   30","   0"
"5042","lassen","2020-06-26","   0","   25","   0","  0","   25","   0"
"5043","monterey","2020-06-26","  19","  824","  81"," 10","  805","  71"
"5044","san mateo","2020-06-26","  21"," 1089","  55","  8"," 1068","  47"
"5045","modoc","2020-06-27","   0","   41","   0","  0","   41","   0"
"5046","placer","2020-06-27","  14","  753","  36","  3","  739","  33"
"5047","trinity","2020-06-27","   1","   54","   0","  0","   53","   0"
"5048","siskiyou","2020-06-27","   0","   65","   5","  0","   65","   5"
"5049","mariposa","2020-06-27","   0","   30","   0","  0","   30","   0"
"5050","sutter","2020-06-27","   0","   14","   0","  0","   14","   0"
"5051","san joaquin","2020-06-27"," 154"," 1430","  47"," 37"," 1276","  10"
"5052","yolo","2020-06-27","   6","  186","   4","  2","  180","   2"
"5053","san francisco","2020-06-27","  72"," 2647"," 103"," 25"," 2575","  78"
"5054","lake","2020-06-27","   3","  110","   0","  2","  107","  -2"
"5055","san bernardino","2020-06-27"," 432"," 4821"," 124","139"," 4389"," -15"
"5056","glenn","2020-06-27","   1","   47","   0","  0","   46","   0"
"5057","tehama","2020-06-27","   0","  106","   3","  0","  106","   3"
"5058","solano","2020-06-27","  36","  707","  39","  9","  671","  30"
"5059","colusa","2020-06-27","   2","   88","   6","  0","   86","   6"
"5060","marin","2020-06-27","  14","  390","  16","  5","  376","  11"
"5061","el dorado","2020-06-27","   2","  235","   9","  2","  233","   7"
"5062","tuolumne","2020-06-27","   2","  151","   3","  1","  149","   2"
"5063","madera","2020-06-27","  22","  528","  15","  0","  506","  15"
"5064","nevada","2020-06-27","   4","  126","   7","  2","  122","   5"
"5065","amador","2020-06-27","   0","   51","   0","  0","   51","   0"
"5066","contra costa","2020-06-27","  63"," 1579"," 130"," 13"," 1516"," 117"
"5067","san mateo","2020-06-27","  27"," 1089","  54","  9"," 1062","  45"
"5068","yuba","2020-06-27","   6","  445","   8","  1","  439","   7"
"5069","del norte","2020-06-27","   1","   51","   0","  0","   50","   0"
"5070","san benito","2020-06-27","   0","   25","   2","  0","   25","   2"
"5071","imperial","2020-06-27","  79","  237","   8"," 17","  158","  -9"
"5072","butte","2020-06-27","   5","  448","   5","  2","  443","   3"
"5073","calaveras","2020-06-27","   1","   50","   9","  1","   49","   8"
"5074","tulare","2020-06-27","  61","  835","  13"," 10","  774","   3"
"5075","monterey","2020-06-27","  21","  824","  84"," 11","  803","  73"
"5076","los angeles","2020-06-27","2316","23683","1244","523","21367"," 721"
"5077","santa cruz","2020-06-27","  15","  397","   4","  1","  382","   3"
"5078","san diego","2020-06-27"," 437"," 5950"," 320","168"," 5513"," 152"
"5079","mono","2020-06-27","   0","   40","   2","  0","   40","   2"
"5080","stanislaus","2020-06-27"," 129"," 1364","  86"," 35"," 1235","  51"
"5081","riverside","2020-06-27"," 485"," 3980","  88","131"," 3495"," -43"
"5082","mendocino","2020-06-27","   0","  180","   5","  0","  180","   5"
"5083","santa barbara","2020-06-27","  65","  717","  70"," 22","  652","  48"
"5084","humboldt","2020-06-27","   4","  352","   1","  1","  348","   0"
"5085","sacramento","2020-06-27","  94"," 2438","  79"," 28"," 2344","  51"
"5086","lassen","2020-06-27","   0","   25","   0","  0","   25","   0"
"5087","sonoma","2020-06-27","  13","  871","  49","  8","  858","  41"
"5088","shasta","2020-06-27","   5","  667","   3","  1","  662","   2"
"5089","kings","2020-06-27","  55","  199","   5","  6","  144","  -1"
"5090","ventura","2020-06-27"," 106"," 1348","  46"," 25"," 1242","  21"
"5091","merced","2020-06-27","  15","  242","   3","  6","  227","  -3"
"5092","fresno","2020-06-27"," 164"," 2016","  73"," 29"," 1852","  44"
"5093","inyo","2020-06-27","   0","   42","   3","  0","   42","   3"
"5094","alameda","2020-06-27"," 139"," 2968"," 115"," 47"," 2829","  68"
"5095","napa","2020-06-27","   8","  397","   1","  5","  389","  -4"
"5096","orange","2020-06-27"," 595"," 6976"," 401","192"," 6381"," 209"
"5097","plumas","2020-06-27","   0","   45","   0","  0","   45","   0"
"5098","kern","2020-06-27"," 176"," 1742","  70"," 52"," 1566","  18"
"5099","san luis obispo","2020-06-27","  11","  470","  38","  2","  459","  36"
"5100","santa clara","2020-06-27","  95"," 3438"," 185"," 29"," 3343"," 156"
"5101","glenn","2020-06-28","   1","   47","   0","  0","   46","   0"
"5102","santa cruz","2020-06-28","  19","  397","   7","  0","  378","   7"
"5103","mendocino","2020-06-28","   0","  180","   5","  0","  180","   5"
"5104","humboldt","2020-06-28","   4","  352","   1","  1","  348","   0"
"5105","stanislaus","2020-06-28"," 136"," 1365","  83"," 38"," 1229","  45"
"5106","colusa","2020-06-28","   0","   88","   6","  0","   88","   6"
"5107","madera","2020-06-28","  16","  528","  15","  1","  512","  14"
"5108","lassen","2020-06-28","   0","   25","   0","  0","   25","   0"
"5109","siskiyou","2020-06-28","   0","   65","   4","  0","   65","   4"
"5110","tuolumne","2020-06-28","   1","  151","   1","  0","  150","   1"
"5111","inyo","2020-06-28","   0","   42","   3","  0","   42","   3"
"5112","yolo","2020-06-28","   4","  186","   1","  2","  182","  -1"
"5113","merced","2020-06-28","  19","  242","   2","  6","  223","  -4"
"5114","alameda","2020-06-28"," 141"," 2968"," 124"," 45"," 2827","  79"
"5115","modoc","2020-06-28","   0","   41","   0","  0","   41","   0"
"5116","marin","2020-06-28","  19","  390","  16","  5","  371","  11"
"5117","san diego","2020-06-28"," 458"," 5865"," 314","178"," 5407"," 136"
"5118","butte","2020-06-28","   5","  448","   4","  2","  443","   2"
"5119","san luis obispo","2020-06-28","  10","  458","  38","  2","  448","  36"
"5120","contra costa","2020-06-28","  50"," 1579"," 130"," 18"," 1529"," 112"
"5121","san mateo","2020-06-28","  32"," 1089","  54"," 11"," 1057","  43"
"5122","amador","2020-06-28","   0","   51","   0","  0","   51","   0"
"5123","del norte","2020-06-28","   2","   51","   0","  2","   49","  -2"
"5124","calaveras","2020-06-28","   2","   50","  10","  1","   48","   9"
"5125","los angeles","2020-06-28","2465","23562","1320","566","21097"," 754"
"5126","shasta","2020-06-28","  10","  667","   7","  1","  657","   6"
"5127","san bernardino","2020-06-28"," 459"," 4821"," 124","147"," 4362"," -23"
"5128","mono","2020-06-28","   0","   40","   2","  0","   40","   2"
"5129","san joaquin","2020-06-28"," 160"," 1430","  52"," 40"," 1270","  12"
"5130","kern","2020-06-28"," 155"," 1742","  75"," 54"," 1587","  21"
"5131","ventura","2020-06-28","  98"," 1348","  62"," 29"," 1250","  33"
"5132","kings","2020-06-28","  54","  199","   1","  6","  145","  -5"
"5133","mariposa","2020-06-28","   0","   30","   0","  0","   30","   0"
"5134","tulare","2020-06-28","  71","  835","   5"," 12","  764","  -7"
"5135","nevada","2020-06-28","   4","  125","   2","  3","  121","  -1"
"5136","sonoma","2020-06-28","  12","  871","  48","  7","  859","  41"
"5137","tehama","2020-06-28","   0","  106","   2","  0","  106","   2"
"5138","sutter","2020-06-28","   0","   14","   0","  0","   14","   0"
"5139","monterey","2020-06-28","  26","  824","  79"," 10","  798","  69"
"5140","santa barbara","2020-06-28","  69","  717","  73"," 21","  648","  52"
"5141","fresno","2020-06-28"," 166"," 2012","  68"," 31"," 1846","  37"
"5142","san benito","2020-06-28","   0","   25","   3","  0","   25","   3"
"5143","san francisco","2020-06-28","  69"," 2647"," 103"," 25"," 2578","  78"
"5144","el dorado","2020-06-28","   4","  235","   6","  4","  231","   2"
"5145","riverside","2020-06-28"," 482"," 3976","  96","124"," 3494"," -28"
"5146","santa clara","2020-06-28"," 105"," 3438"," 187"," 33"," 3333"," 154"
"5147","orange","2020-06-28"," 595"," 6976"," 417","193"," 6381"," 224"
"5148","sacramento","2020-06-28"," 106"," 2435","  70"," 30"," 2329","  40"
"5149","imperial","2020-06-28","  74","  237","   1"," 17","  163"," -16"
"5150","napa","2020-06-28","  10","  397","   6","  7","  387","  -1"
"5151","lake","2020-06-28","   2","  110","   1","  2","  108","  -1"
"5152","plumas","2020-06-28","   0","   45","   0","  0","   45","   0"
"5153","placer","2020-06-28","  18","  753","  33","  4","  735","  29"
"5154","solano","2020-06-28","  35","  707","  39","  7","  672","  32"
"5155","yuba","2020-06-28","   7","  445","  17","  1","  438","  16"
"5156","trinity","2020-06-28","   4","   54","   0","  0","   50","   0"
"5157","calaveras","2020-06-29","   2","   50","  10","  1","   48","   9"
"5158","santa barbara","2020-06-29","  70","  717","  79"," 21","  647","  58"
"5159","los angeles","2020-06-29","2511","23622","1239","595","21111"," 644"
"5160","san benito","2020-06-29","   0","   25","   1","  0","   25","   1"
"5161","fresno","2020-06-29"," 170"," 2005","  76"," 32"," 1835","  44"
"5162","merced","2020-06-29","  18","  242","   3","  6","  224","  -3"
"5163","stanislaus","2020-06-29"," 142"," 1363","  74"," 38"," 1221","  36"
"5164","tehama","2020-06-29","   0","  106","   1","  0","  106","   1"
"5165","contra costa","2020-06-29","  61"," 1579"," 142"," 19"," 1518"," 123"
"5166","tulare","2020-06-29","  80","  835","  12"," 13","  755","  -1"
"5167","lake","2020-06-29","   2","  110","   1","  2","  108","  -1"
"5168","solano","2020-06-29","  44","  707","  42","  8","  663","  34"
"5169","santa cruz","2020-06-29","  16","  397","  12","  1","  381","  11"
"5170","monterey","2020-06-29","  35","  824","  84","  8","  789","  76"
"5171","trinity","2020-06-29","   5","   54","   0","  0","   49","   0"
"5172","san diego","2020-06-29"," 493"," 5848"," 324","182"," 5355"," 142"
"5173","imperial","2020-06-29","  72","  237","   5"," 16","  165"," -11"
"5174","sonoma","2020-06-29","  12","  871","  50","  8","  859","  42"
"5175","humboldt","2020-06-29","   3","  352","   2","  1","  349","   1"
"5176","san mateo","2020-06-29","  41"," 1089","  55"," 16"," 1048","  39"
"5177","glenn","2020-06-29","   0","   47","   0","  0","   47","   0"
"5178","siskiyou","2020-06-29","   0","   65","   4","  0","   65","   4"
"5179","ventura","2020-06-29"," 111"," 1346","  45"," 30"," 1235","  15"
"5180","mendocino","2020-06-29","   0","  180","   3","  0","  180","   3"
"5181","kern","2020-06-29"," 160"," 1742","  74"," 55"," 1582","  19"
"5182","el dorado","2020-06-29","   2","  235","   9","  2","  233","   7"
"5183","santa clara","2020-06-29"," 105"," 3438"," 190"," 33"," 3333"," 157"
"5184","madera","2020-06-29","  15","  528","  16","  0","  513","  16"
"5185","placer","2020-06-29","  22","  753","  33","  5","  731","  28"
"5186","amador","2020-06-29","   1","   51","   1","  1","   50","   0"
"5187","sacramento","2020-06-29"," 130"," 2430","  80"," 34"," 2300","  46"
"5188","san joaquin","2020-06-29"," 159"," 1430","  53"," 38"," 1271","  15"
"5189","yuba","2020-06-29","   8","  445","  11","  3","  437","   8"
"5190","nevada","2020-06-29","   7","  127","   1","  3","  120","  -2"
"5191","inyo","2020-06-29","   0","   42","   2","  0","   42","   2"
"5192","riverside","2020-06-29"," 507"," 4001"," 111","130"," 3494"," -19"
"5193","sutter","2020-06-29","   0","   14","   0","  0","   14","   0"
"5194","butte","2020-06-29","   7","  448","   9","  3","  441","   6"
"5195","alameda","2020-06-29"," 146"," 2968"," 138"," 44"," 2822","  94"
"5196","plumas","2020-06-29","   0","   45","   0","  0","   45","   0"
"5197","orange","2020-06-29"," 624"," 6976"," 410","200"," 6352"," 210"
"5198","napa","2020-06-29","  10","  397","   0","  8","  387","  -8"
"5199","tuolumne","2020-06-29","   1","  151","   0","  0","  150","   0"
"5200","mariposa","2020-06-29","   0","   30","   0","  0","   30","   0"
"5201","san luis obispo","2020-06-29","  15","  455","  42","  3","  440","  39"
"5202","del norte","2020-06-29","   1","   51","   0","  1","   50","  -1"
"5203","marin","2020-06-29","  29","  390","   8","  9","  361","  -1"
"5204","colusa","2020-06-29","   0","   88","   6","  0","   88","   6"
"5205","yolo","2020-06-29","   4","  186","   1","  1","  182","   0"
"5206","kings","2020-06-29","  56","  199","   2","  6","  143","  -4"
"5207","san francisco","2020-06-29","  79"," 2647"," 120"," 26"," 2568","  94"
"5208","lassen","2020-06-29","   0","   25","   0","  0","   25","   0"
"5209","shasta","2020-06-29","  12","  667","   7","  1","  655","   6"
"5210","modoc","2020-06-29","   0","   41","   0","  0","   41","   0"
"5211","san bernardino","2020-06-29"," 478"," 4821"," 140","148"," 4343","  -8"
"5212","mono","2020-06-29","   0","   40","   2","  0","   40","   2"
"5213","monterey","2020-06-30","  41","  824","  89","  7","  783","  82"
"5214","amador","2020-06-30","   2","   51","   0","  1","   49","  -1"
"5215","placer","2020-06-30","  24","  753","  35","  5","  729","  30"
"5216","fresno","2020-06-30"," 171"," 2016","  74"," 37"," 1845","  37"
"5217","santa cruz","2020-06-30","  16","  397","  15","  1","  381","  14"
"5218","marin","2020-06-30","  29","  390","   5"," 11","  361","  -6"
"5219","madera","2020-06-30","  10","  528","  17","  0","  518","  17"
"5220","kern","2020-06-30"," 175"," 1742","  69"," 61"," 1567","   8"
"5221","tulare","2020-06-30","  79","  835","  11"," 14","  756","  -3"
"5222","los angeles","2020-06-30","2538","23639","1170","628","21101"," 542"
"5223","stanislaus","2020-06-30"," 170"," 1363","  78"," 39"," 1193","  39"
"5224","san benito","2020-06-30","   1","   25","   0","  0","   24","   0"
"5225","calaveras","2020-06-30","   3","   50","  10","  2","   47","   8"
"5226","humboldt","2020-06-30","   4","  352","   1","  1","  348","   0"
"5227","orange","2020-06-30"," 662"," 6976"," 386","212"," 6314"," 174"
"5228","contra costa","2020-06-30","  61"," 1579"," 140"," 23"," 1518"," 117"
"5229","san diego","2020-06-30"," 453"," 6164"," 335","173"," 5711"," 162"
"5230","napa","2020-06-30","   9","  397","   1","  8","  388","  -7"
"5231","plumas","2020-06-30","   0","   45","   0","  0","   45","   0"
"5232","glenn","2020-06-30","   0","   47","   0","  0","   47","   0"
"5233","trinity","2020-06-30","   0","   54","   0","  0","   54","   0"
"5234","nevada","2020-06-30","   7","  121","   4","  2","  114","   2"
"5235","sutter","2020-06-30","   0","   14","   0","  0","   14","   0"
"5236","kings","2020-06-30","  41","  199","   2","  4","  158","  -2"
"5237","san luis obispo","2020-06-30","  12","  456","  42","  4","  444","  38"
"5238","san joaquin","2020-06-30"," 196"," 1430","  42"," 45"," 1234","  -3"
"5239","san mateo","2020-06-30","  47"," 1089","  49"," 19"," 1042","  30"
"5240","del norte","2020-06-30","   1","   51","   0","  1","   50","  -1"
"5241","tuolumne","2020-06-30","   1","  151","   1","  0","  150","   1"
"5242","sonoma","2020-06-30","  15","  871","  50","  8","  856","  42"
"5243","merced","2020-06-30","  16","  242","   3","  5","  226","  -2"
"5244","mendocino","2020-06-30","   0","  180","   4","  0","  180","   4"
"5245","imperial","2020-06-30","  74","  237","   3"," 18","  163"," -15"
"5246","santa clara","2020-06-30","  93"," 3438"," 177"," 34"," 3345"," 143"
"5247","santa barbara","2020-06-30","  70","  717","  73"," 21","  647","  52"
"5248","ventura","2020-06-30"," 119"," 1346","  43"," 34"," 1227","   9"
"5249","mariposa","2020-06-30","   0","   30","   0","  0","   30","   0"
"5250","yolo","2020-06-30","   5","  186","   0","  2","  181","  -2"
"5251","el dorado","2020-06-30","   4","  235","   3","  2","  231","   1"
"5252","riverside","2020-06-30"," 531"," 4001"," 105","138"," 3470"," -33"
"5253","inyo","2020-06-30","   0","   42","   3","  0","   42","   3"
"5254","solano","2020-06-30","  46","  707","  36"," 13","  661","  23"
"5255","colusa","2020-06-30","   3","   88","   6","  0","   85","   6"
"5256","sacramento","2020-06-30"," 127"," 2451","  86"," 31"," 2324","  55"
"5257","lassen","2020-06-30","   0","   25","   0","  0","   25","   0"
"5258","mono","2020-06-30","   0","   40","   2","  0","   40","   2"
"5259","san bernardino","2020-06-30"," 491"," 4821"," 120","163"," 4330"," -43"
"5260","lake","2020-06-30","   5","  110","   1","  3","  105","  -2"
"5261","alameda","2020-06-30"," 157"," 2968"," 143"," 49"," 2811","  94"
"5262","san francisco","2020-06-30","  80"," 2647"," 113"," 33"," 2567","  80"
"5263","butte","2020-06-30","   6","  448","   9","  2","  442","   7"
"5264","shasta","2020-06-30","  12","  667","   9","  2","  655","   7"
"5265","modoc","2020-06-30","   0","   41","   0","  0","   41","   0"
"5266","siskiyou","2020-06-30","   0","   65","   6","  0","   65","   6"
"5267","tehama","2020-06-30","   0","  106","   1","  0","  106","   1"
"5268","yuba","2020-06-30","   5","  445","   8","  3","  440","   5"
"5269","mendocino","2020-07-01","   0","  180","   4","  0","  180","   4"
"5270","lassen","2020-07-01","   0","   25","   0","  0","   25","   0"
"5271","san mateo","2020-07-01","  55"," 1089","  51"," 21"," 1034","  30"
"5272","siskiyou","2020-07-01","   0","   65","   3","  0","   65","   3"
"5273","san francisco","2020-07-01","  85"," 2647"," 110"," 33"," 2562","  77"
"5274","sacramento","2020-07-01"," 136"," 2491","  89"," 38"," 2355","  51"
"5275","ventura","2020-07-01"," 117"," 1328","  47"," 32"," 1211","  15"
"5276","orange","2020-07-01"," 705"," 5725"," 346","227"," 5020"," 119"
"5277","monterey","2020-07-01","  43","  824","  81"," 10","  781","  71"
"5278","butte","2020-07-01","   9","  428","   3","  3","  419","   0"
"5279","kern","2020-07-01"," 178"," 1742","  70"," 58"," 1564","  12"
"5280","sutter","2020-07-01","   0","   14","   0","  0","   14","   0"
"5281","plumas","2020-07-01","   0","   45","   0","  0","   45","   0"
"5282","napa","2020-07-01","   8","  397","  41","  8","  389","  33"
"5283","madera","2020-07-01","  22","  528","  17","  6","  506","  11"
"5284","merced","2020-07-01","  26","  242","   5","  6","  216","  -1"
"5285","san joaquin","2020-07-01"," 163"," 1430","  47"," 44"," 1267","   3"
"5286","shasta","2020-07-01","   8","  667","   6","  2","  659","   4"
"5287","kings","2020-07-01","  41","  199","   3","  7","  158","  -4"
"5288","los angeles","2020-07-01","2580","21731","1092","632","19151"," 460"
"5289","yolo","2020-07-01","   5","  186","   1","  2","  181","  -1"
"5290","amador","2020-07-01","   2","   51","   0","  1","   49","  -1"
"5291","placer","2020-07-01","  33","  753","  28","  5","  720","  23"
"5292","el dorado","2020-07-01","   6","  235","   4","  5","  229","  -1"
"5293","mariposa","2020-07-01","   0","   30","   0","  0","   30","   0"
"5294","imperial","2020-07-01","  81","  237","   6"," 19","  156"," -13"
"5295","riverside","2020-07-01"," 547"," 4014"," 106","143"," 3467"," -37"
"5296","inyo","2020-07-01","   0","   42","   4","  0","   42","   4"
"5297","mono","2020-07-01","   0","   40","   2","  0","   40","   2"
"5298","san bernardino","2020-07-01"," 516"," 4564","  95","170"," 4048"," -75"
"5299","tehama","2020-07-01","   0","  106","   4","  0","  106","   4"
"5300","modoc","2020-07-01","   2","   41","   0","  0","   39","   0"
"5301","alameda","2020-07-01"," 170"," 2968"," 141"," 55"," 2798","  86"
"5302","stanislaus","2020-07-01"," 182"," 1372","  82"," 44"," 1190","  38"
"5303","lake","2020-07-01","   3","  110","   1","  1","  107","   0"
"5304","humboldt","2020-07-01","   4","  352","   2","  2","  348","   0"
"5305","del norte","2020-07-01","   1","   51","   0","  0","   50","   0"
"5306","tulare","2020-07-01","  83","  835","   9"," 15","  752","  -6"
"5307","trinity","2020-07-01","   0","   54","   0","  0","   54","   0"
"5308","colusa","2020-07-01","   2","   88","   6","  0","   86","   6"
"5309","yuba","2020-07-01","   9","  445","   7","  3","  436","   4"
"5310","calaveras","2020-07-01","   2","   50","   8","  2","   48","   6"
"5311","san diego","2020-07-01"," 462"," 6183"," 319","175"," 5721"," 144"
"5312","contra costa","2020-07-01","  71"," 1579"," 143"," 26"," 1508"," 117"
"5313","tuolumne","2020-07-01","   3","  151","   0","  1","  148","  -1"
"5314","santa cruz","2020-07-01","  10","  397","  21","  1","  387","  20"
"5315","glenn","2020-07-01","   0","   47","   0","  0","   47","   0"
"5316","san benito","2020-07-01","   1","   25","   1","  0","   24","   1"
"5317","nevada","2020-07-01","   6","  122","   4","  2","  116","   2"
"5318","sonoma","2020-07-01","  17","  871","  51","  5","  854","  46"
"5319","santa clara","2020-07-01"," 100"," 3438"," 168"," 40"," 3338"," 128"
"5320","marin","2020-07-01","  32","  390","   5"," 12","  358","  -7"
"5321","solano","2020-07-01","  57","  707","  36"," 13","  650","  23"
"5322","santa barbara","2020-07-01","  66","  717","  62"," 24","  651","  38"
"5323","san luis obispo","2020-07-01","  14","  472","  40","  4","  458","  36"
"5324","fresno","2020-07-01"," 149"," 2028","  80"," 37"," 1879","  43"
"5325","merced","2020-07-02","  23","  242","   2","  5","  219","  -3"
"5326","san mateo","2020-07-02","  56"," 1089","  49"," 15"," 1033","  34"
"5327","san benito","2020-07-02","   1","   25","   1","  0","   24","   1"
"5328","solano","2020-07-02","  48","  707","  38"," 14","  659","  24"
"5329","napa","2020-07-02","   9","  397","  43","  3","  388","  40"
"5330","marin","2020-07-02","  30","  390","  12","  8","  360","   4"
"5331","kern","2020-07-02"," 206"," 1742","  67"," 57"," 1536","  10"
"5332","san francisco","2020-07-02","  82"," 2647"," 102"," 31"," 2565","  71"
"5333","siskiyou","2020-07-02","   0","   65","   0","  0","   65","   0"
"5334","kings","2020-07-02","  39","  199","   1","  8","  160","  -7"
"5335","amador","2020-07-02","   1","   51","   0","  1","   50","  -1"
"5336","inyo","2020-07-02","   0","   42","   3","  0","   42","   3"
"5337","sutter","2020-07-02","   0","   14","   0","  0","   14","   0"
"5338","tuolumne","2020-07-02","   4","  151","   1","  1","  147","   0"
"5339","fresno","2020-07-02"," 145"," 2029","  68"," 35"," 1884","  33"
"5340","santa barbara","2020-07-02","  70","  717","  61"," 25","  647","  36"
"5341","santa clara","2020-07-02"," 107"," 3438"," 172"," 35"," 3331"," 137"
"5342","imperial","2020-07-02","  89","  237","   6"," 18","  148"," -12"
"5343","del norte","2020-07-02","   1","   51","   1","  0","   50","   1"
"5344","plumas","2020-07-02","   0","   45","   0","  0","   45","   0"
"5345","shasta","2020-07-02","   8","  667","   8","  2","  659","   6"
"5346","modoc","2020-07-02","   0","   41","   0","  0","   41","   0"
"5347","stanislaus","2020-07-02"," 209"," 1372","  83"," 48"," 1163","  35"
"5348","sonoma","2020-07-02","  15","  871","  50","  4","  856","  46"
"5349","lake","2020-07-02","   4","  110","   1","  1","  106","   0"
"5350","trinity","2020-07-02","   0","   54","   0","  0","   54","   0"
"5351","madera","2020-07-02","  18","  528","  21","  2","  510","  19"
"5352","calaveras","2020-07-02","   3","   50","   9","  2","   47","   7"
"5353","san joaquin","2020-07-02"," 193"," 1430","  54"," 43"," 1237","  11"
"5354","humboldt","2020-07-02","   1","  352","   2","  1","  351","   1"
"5355","el dorado","2020-07-02","   5","  235","   7","  3","  230","   4"
"5356","ventura","2020-07-02"," 122"," 1363","  54"," 40"," 1241","  14"
"5357","glenn","2020-07-02","   1","   47","   0","  0","   46","   0"
"5358","yuba","2020-07-02","  11","  445","  16","  3","  434","  13"
"5359","lassen","2020-07-02","   1","   25","   0","  0","   24","   0"
"5360","butte","2020-07-02","  12","  428","   3","  6","  416","  -3"
"5361","contra costa","2020-07-02","  76"," 1579"," 140"," 24"," 1503"," 116"
"5362","tehama","2020-07-02","   0","  106","   1","  0","  106","   1"
"5363","tulare","2020-07-02","  79","  835","  23"," 12","  756","  11"
"5364","san diego","2020-07-02"," 459"," 6182"," 337","159"," 5723"," 178"
"5365","santa cruz","2020-07-02","  13","  397","  28","  3","  384","  25"
"5366","orange","2020-07-02"," 716"," 6694"," 326","208"," 5978"," 118"
"5367","san luis obispo","2020-07-02","  15","  475","  40","  4","  460","  36"
"5368","mariposa","2020-07-02","   0","   30","   0","  0","   30","   0"
"5369","yolo","2020-07-02","   9","  186","   4","  0","  177","   4"
"5370","los angeles","2020-07-02","2612","23057","1153","632","20445"," 521"
"5371","mendocino","2020-07-02","   0","  180","   2","  0","  180","   2"
"5372","alameda","2020-07-02"," 193"," 2968"," 129"," 55"," 2775","  74"
"5373","riverside","2020-07-02"," 576"," 4014","  92","137"," 3438"," -45"
"5374","mono","2020-07-02","   0","   40","   2","  0","   40","   2"
"5375","colusa","2020-07-02","   2","   88","   6","  0","   86","   6"
"5376","sacramento","2020-07-02"," 149"," 2492","  82"," 40"," 2343","  42"
"5377","monterey","2020-07-02","  37","  824","  84"," 10","  787","  74"
"5378","san bernardino","2020-07-02"," 529"," 4793","  85","169"," 4264"," -84"
"5379","nevada","2020-07-02","   6","  114","   4","  3","  108","   1"
"5380","placer","2020-07-02","  39","  753","  24","  4","  714","  20"
"5381","merced","2020-07-03","  26","  242","   3","  5","  216","  -2"
"5382","colusa","2020-07-03","   0","   88","   6","  0","   88","   6"
"5383","trinity","2020-07-03","   0","   54","   0","  0","   54","   0"
"5384","napa","2020-07-03","   8","  397","  43","  4","  389","  39"
"5385","imperial","2020-07-03","  85","  298","  17"," 18","  213","  -1"
"5386","santa barbara","2020-07-03","  75","  763","  68"," 22","  688","  46"
"5387","madera","2020-07-03","  19","  528","   8","  6","  509","   2"
"5388","mariposa","2020-07-03","   0","   30","   0","  0","   30","   0"
"5389","amador","2020-07-03","   1","   51","   1","  1","   50","   0"
"5390","sacramento","2020-07-03"," 144"," 2486","  80"," 39"," 2342","  41"
"5391","tuolumne","2020-07-03","   1","  151","   0","  1","  150","  -1"
"5392","mono","2020-07-03","   0","   40","   2","  0","   40","   2"
"5393","siskiyou","2020-07-03","   0","   65","   2","  0","   65","   2"
"5394","lassen","2020-07-03","   1","   65","   0","  0","   64","   0"
"5395","butte","2020-07-03","   9","  428","   6","  4","  419","   2"
"5396","san mateo","2020-07-03","  60"," 1119","  57"," 17"," 1059","  40"
"5397","kings","2020-07-03","  40","  199","   0","  8","  159","  -8"
"5398","fresno","2020-07-03"," 154"," 2092","  77"," 37"," 1938","  40"
"5399","orange","2020-07-03"," 744"," 7401"," 320","217"," 6657"," 103"
"5400","san luis obispo","2020-07-03","  11","  476","  39","  4","  465","  35"
"5401","shasta","2020-07-03","   9","  667","   7","  2","  658","   5"
"5402","ventura","2020-07-03"," 123"," 1549","  56"," 31"," 1426","  25"
"5403","monterey","2020-07-03","  36","  845","  85","  8","  809","  77"
"5404","stanislaus","2020-07-03"," 210"," 1367","  78"," 42"," 1157","  36"
"5405","yuba","2020-07-03","  10","  445","  17","  3","  435","  14"
"5406","san diego","2020-07-03"," 435"," 6316"," 318","157"," 5881"," 161"
"5407","inyo","2020-07-03","   0","   42","   4","  0","   42","   4"
"5408","san bernardino","2020-07-03"," 539"," 4834","  87","169"," 4295"," -82"
"5409","nevada","2020-07-03","   5","   96","   7","  3","   91","   4"
"5410","humboldt","2020-07-03","   1","  352","   2","  1","  351","   1"
"5411","kern","2020-07-03"," 203"," 1832","  80"," 67"," 1629","  13"
"5412","tulare","2020-07-03","  78","  835","  25"," 12","  757","  13"
"5413","yolo","2020-07-03","   9","  186","   1","  2","  177","  -1"
"5414","glenn","2020-07-03","   1","   47","   0","  0","   46","   0"
"5415","contra costa","2020-07-03","  75"," 1579"," 141"," 23"," 1504"," 118"
"5416","alameda","2020-07-03"," 208"," 2968"," 126"," 55"," 2760","  71"
"5417","marin","2020-07-03","  31","  392","  11","  8","  361","   3"
"5418","calaveras","2020-07-03","   0","   50","  12","  0","   50","  12"
"5419","san francisco","2020-07-03","  85"," 2647"," 107"," 29"," 2562","  78"
"5420","solano","2020-07-03","  47","  707","  35"," 15","  660","  20"
"5421","san joaquin","2020-07-03"," 206"," 1430","  45"," 44"," 1224","   1"
"5422","los angeles","2020-07-03","2643","23965","1189","650","21322"," 539"
"5423","el dorado","2020-07-03","   4","  235","   8","  3","  231","   5"
"5424","mendocino","2020-07-03","   0","  180","   1","  0","  180","   1"
"5425","sutter","2020-07-03","   0","   14","   0","  0","   14","   0"
"5426","riverside","2020-07-03"," 571"," 4103"," 107","132"," 3532"," -25"
"5427","modoc","2020-07-03","   0","   41","   0","  0","   41","   0"
"5428","plumas","2020-07-03","   0","   45","   0","  0","   45","   0"
"5429","del norte","2020-07-03","   1","   51","   0","  0","   50","   0"
"5430","lake","2020-07-03","   3","  110","   2","  1","  107","   1"
"5431","sonoma","2020-07-03","  18","  862","  48","  4","  844","  44"
"5432","san benito","2020-07-03","   1","   25","   0","  0","   24","   0"
"5433","santa cruz","2020-07-03","  17","  397","  26","  3","  380","  23"
"5434","placer","2020-07-03","  45","  753","  29","  3","  708","  26"
"5435","santa clara","2020-07-03"," 100"," 3438"," 171"," 38"," 3338"," 133"
"5436","tehama","2020-07-03","   0","  106","   1","  0","  106","   1"
"5437","imperial","2020-07-04","  91","  298","  16"," 19","  207","  -3"
"5438","yuba","2020-07-04","  12","  445","  13","  6","  433","   7"
"5439","inyo","2020-07-04","   0","   42","   4","  0","   42","   4"
"5440","sutter","2020-07-04","   0","   14","   0","  0","   14","   0"
"5441","san luis obispo","2020-07-04","  12","  476","  38","  5","  464","  33"
"5442","modoc","2020-07-04","   0","   41","   0","  0","   41","   0"
"5443","tehama","2020-07-04","   0","  106","   0","  0","  106","   0"
"5444","santa cruz","2020-07-04","  15","  397","  25","  2","  382","  23"
"5445","trinity","2020-07-04","   0","   54","   0","  0","   54","   0"
"5446","kern","2020-07-04"," 220"," 1832","  80"," 67"," 1612","  13"
"5447","kings","2020-07-04","  48","  199","   2","  8","  151","  -6"
"5448","mono","2020-07-04","   0","   40","   2","  0","   40","   2"
"5449","siskiyou","2020-07-04","   0","   65","   3","  0","   65","   3"
"5450","contra costa","2020-07-04","  81"," 1562"," 135"," 29"," 1481"," 106"
"5451","fresno","2020-07-04"," 162"," 2094","  78"," 38"," 1932","  40"
"5452","merced","2020-07-04","  24","  242","   4","  3","  218","   1"
"5453","napa","2020-07-04","   7","  397","   0","  4","  390","  -4"
"5454","sonoma","2020-07-04","  26","  862","  51","  6","  836","  45"
"5455","san diego","2020-07-04"," 445"," 6267"," 344","167"," 5822"," 177"
"5456","monterey","2020-07-04","  39","  845","  88","  8","  806","  80"
"5457","santa clara","2020-07-04"," 101"," 3438"," 186"," 38"," 3337"," 148"
"5458","orange","2020-07-04"," 772"," 7401"," 403","215"," 6629"," 188"
"5459","mendocino","2020-07-04","   1","  180","   2","  0","  179","   2"
"5460","san mateo","2020-07-04","  50"," 1057","  63"," 16"," 1007","  47"
"5461","sacramento","2020-07-04"," 167"," 2465","  87"," 50"," 2298","  37"
"5462","mariposa","2020-07-04","   0","   30","   0","  0","   30","   0"
"5463","ventura","2020-07-04"," 104"," 1549","  50"," 35"," 1445","  15"
"5464","lake","2020-07-04","   4","  110","   2","  1","  106","   1"
"5465","alameda","2020-07-04"," 190"," 2968"," 137"," 52"," 2778","  85"
"5466","san joaquin","2020-07-04"," 194"," 1430","  50"," 51"," 1236","  -1"
"5467","glenn","2020-07-04","   1","   47","   0","  0","   46","   0"
"5468","colusa","2020-07-04","   0","   88","   6","  0","   88","   6"
"5469","tulare","2020-07-04","  80","  835","  17"," 11","  755","   6"
"5470","marin","2020-07-04","  30","  392","   9","  8","  362","   1"
"5471","humboldt","2020-07-04","   1","  352","   2","  1","  351","   1"
"5472","san benito","2020-07-04","   1","   25","   0","  0","   24","   0"
"5473","stanislaus","2020-07-04"," 222"," 1367","  85"," 44"," 1145","  41"
"5474","lassen","2020-07-04","   1","   65","   0","  0","   64","   0"
"5475","solano","2020-07-04","  45","  707","  44"," 11","  662","  33"
"5476","san bernardino","2020-07-04"," 557"," 4834"," 117","174"," 4277"," -57"
"5477","santa barbara","2020-07-04","  76","  763","  73"," 24","  687","  49"
"5478","shasta","2020-07-04","   9","  667","   7","  3","  658","   4"
"5479","madera","2020-07-04","  27","  528","  21","  2","  501","  19"
"5480","nevada","2020-07-04","   7","   93","   3","  2","   86","   1"
"5481","riverside","2020-07-04"," 600"," 4070"," 120","140"," 3470"," -20"
"5482","del norte","2020-07-04","   1","   51","   0","  0","   50","   0"
"5483","yolo","2020-07-04","   9","  186","   1","  2","  177","  -1"
"5484","calaveras","2020-07-04","   1","   50","  11","  0","   49","  11"
"5485","el dorado","2020-07-04","   4","  235","   7","  4","  231","   3"
"5486","tuolumne","2020-07-04","   1","  151","   6","  0","  150","   6"
"5487","placer","2020-07-04","  46","  753","  37","  4","  707","  33"
"5488","amador","2020-07-04","   1","   51","   0","  1","   50","  -1"
"5489","los angeles","2020-07-04","2574","23943","1336","624","21369"," 712"
"5490","butte","2020-07-04","   8","  408","   4","  5","  400","  -1"
"5491","plumas","2020-07-04","   0","   45","   0","  0","   45","   0"
"5492","san francisco","2020-07-04","  82"," 2647"," 102"," 27"," 2565","  75"
"5493","trinity","2020-07-05","   0","   54","   0","  0","   54","   0"
"5494","san bernardino","2020-07-05"," 565"," 4834"," 112","175"," 4269"," -63"
"5495","placer","2020-07-05","  41","  753","  35","  8","  712","  27"
"5496","sutter","2020-07-05","   0","   14","   0","  0","   14","   0"
"5497","tehama","2020-07-05","   0","  106","   1","  0","  106","   1"
"5498","modoc","2020-07-05","   0","   41","   0","  0","   41","   0"
"5499","san francisco","2020-07-05","  84"," 2647"," 122"," 26"," 2563","  96"
"5500","napa","2020-07-05","   7","  397","   5","  4","  390","   1"
"5501","lake","2020-07-05","   4","  110","   2","  0","  106","   2"
"5502","san mateo","2020-07-05","  53"," 1050","  67"," 15","  997","  52"
"5503","san benito","2020-07-05","   0","   25","   0","  0","   25","   0"
"5504","santa clara","2020-07-05"," 110"," 3438"," 198"," 35"," 3328"," 163"
"5505","tuolumne","2020-07-05","   0","  151","   2","  0","  151","   2"
"5506","tulare","2020-07-05","  80","  835","  17","  9","  755","   8"
"5507","el dorado","2020-07-05","   2","  235","   7","  2","  233","   5"
"5508","sacramento","2020-07-05"," 169"," 2428","  89"," 46"," 2259","  43"
"5509","yolo","2020-07-05","   8","  186","   0","  2","  178","  -2"
"5510","yuba","2020-07-05","  16","  445","   6","  7","  429","  -1"
"5511","los angeles","2020-07-05","2645","23936","1295","629","21291"," 666"
"5512","san diego","2020-07-05"," 441"," 6250"," 350","174"," 5809"," 176"
"5513","imperial","2020-07-05","  93","  298","  15"," 20","  205","  -5"
"5514","ventura","2020-07-05"," 103"," 1549","  39"," 33"," 1446","   6"
"5515","glenn","2020-07-05","   1","   47","   0","  0","   46","   0"
"5516","lassen","2020-07-05","   1","   65","   0","  0","   64","   0"
"5517","shasta","2020-07-05","   7","  667","   5","  3","  660","   2"
"5518","siskiyou","2020-07-05","   1","   65","   5","  0","   64","   5"
"5519","orange","2020-07-05"," 792"," 7401"," 418","226"," 6609"," 192"
"5520","contra costa","2020-07-05","  88"," 1579"," 150"," 28"," 1491"," 122"
"5521","merced","2020-07-05","  24","  242","   3","  4","  218","  -1"
"5522","fresno","2020-07-05"," 163"," 2090","  81"," 40"," 1927","  41"
"5523","san luis obispo","2020-07-05","  17","  451","  41","  5","  434","  36"
"5524","nevada","2020-07-05","   9","   89","   3","  2","   80","   1"
"5525","riverside","2020-07-05"," 614"," 4065"," 130","148"," 3451"," -18"
"5526","kings","2020-07-05","  47","  199","   5","  8","  152","  -3"
"5527","madera","2020-07-05","  21","  528","  18","  4","  507","  14"
"5528","del norte","2020-07-05","   1","   51","   2","  0","   50","   2"
"5529","santa barbara","2020-07-05","  73","  763","  72"," 21","  690","  51"
"5530","amador","2020-07-05","   1","   51","   0","  1","   50","  -1"
"5531","calaveras","2020-07-05","   2","   50","  10","  1","   48","   9"
"5532","plumas","2020-07-05","   0","   45","   0","  0","   45","   0"
"5533","alameda","2020-07-05"," 183"," 2968"," 134"," 58"," 2785","  76"
"5534","mendocino","2020-07-05","   0","  180","   2","  0","  180","   2"
"5535","santa cruz","2020-07-05","  19","  397","  30","  2","  378","  28"
"5536","inyo","2020-07-05","   1","   42","   3","  1","   41","   2"
"5537","mono","2020-07-05","   0","   40","   2","  0","   40","   2"
"5538","butte","2020-07-05","  10","  408","   1","  6","  398","  -5"
"5539","kern","2020-07-05"," 222"," 1832","  74"," 64"," 1610","  10"
"5540","marin","2020-07-05","  40","  392","   7"," 11","  352","  -4"
"5541","humboldt","2020-07-05","   2","  352","   2","  1","  350","   1"
"5542","san joaquin","2020-07-05"," 188"," 1430","  45"," 41"," 1242","   4"
"5543","mariposa","2020-07-05","   0","   30","   0","  0","   30","   0"
"5544","sonoma","2020-07-05","  30","  862","  52","  9","  832","  43"
"5545","solano","2020-07-05","  47","  707","  40"," 12","  660","  28"
"5546","stanislaus","2020-07-05"," 213"," 1367","  88"," 50"," 1154","  38"
"5547","colusa","2020-07-05","   0","   88","   6","  0","   88","   6"
"5548","monterey","2020-07-05","  40","  845","  91","  6","  805","  85"
"5549","lake","2020-07-06","   6","  110","   2","  1","  104","   1"
"5550","mendocino","2020-07-06","   0","  180","   6","  0","  180","   6"
"5551","el dorado","2020-07-06","   2","  235","   5","  2","  233","   3"
"5552","tuolumne","2020-07-06","   1","  151","   3","  0","  150","   3"
"5553","san bernardino","2020-07-06"," 574"," 4834"," 129","170"," 4260"," -41"
"5554","calaveras","2020-07-06","   3","   50","   8","  2","   47","   6"
"5555","amador","2020-07-06","   1","   51","   2","  1","   50","   1"
"5556","inyo","2020-07-06","   1","   42","   3","  1","   41","   2"
"5557","mono","2020-07-06","   0","   40","   2","  0","   40","   2"
"5558","yuba","2020-07-06","  21","  445","  14","  8","  424","   6"
"5559","butte","2020-07-06","  13","  466","   1","  8","  453","  -7"
"5560","solano","2020-07-06","  43","  707","  35"," 16","  664","  19"
"5561","del norte","2020-07-06","   1","   51","   2","  0","   50","   2"
"5562","marin","2020-07-06","  39","  392","   9","  8","  353","   1"
"5563","santa clara","2020-07-06"," 104"," 3438"," 195"," 35"," 3334"," 160"
"5564","stanislaus","2020-07-06"," 206"," 1372","  99"," 46"," 1166","  53"
"5565","sutter","2020-07-06","   0","   14","   0","  0","   14","   0"
"5566","siskiyou","2020-07-06","   0","   65","   4","  0","   65","   4"
"5567","modoc","2020-07-06","   0","   41","   0","  0","   41","   0"
"5568","tulare","2020-07-06","  86","  835","   8"," 13","  749","  -5"
"5569","mariposa","2020-07-06","   0","   30","   0","  0","   30","   0"
"5570","sacramento","2020-07-06"," 172"," 2589","  87"," 46"," 2417","  41"
"5571","san mateo","2020-07-06","  55"," 1052","  72"," 15","  997","  57"
"5572","placer","2020-07-06","  41","  753","  30"," 10","  712","  20"
"5573","santa barbara","2020-07-06","  80","  763","  68"," 23","  683","  45"
"5574","shasta","2020-07-06","   6","  671","   9","  3","  665","   6"
"5575","lassen","2020-07-06","   1","   65","   0","  0","   64","   0"
"5576","san francisco","2020-07-06","  80"," 2647"," 120"," 28"," 2567","  92"
"5577","kern","2020-07-06"," 223"," 1832","  85"," 61"," 1609","  24"
"5578","napa","2020-07-06","   7","  397","   5","  6","  390","  -1"
"5579","madera","2020-07-06","  32","  528","  22","  4","  496","  18"
"5580","glenn","2020-07-06","   1","   47","   0","  0","   46","   0"
"5581","imperial","2020-07-06","  91","  298","  18"," 20","  207","  -2"
"5582","san benito","2020-07-06","   0","   25","   0","  0","   25","   0"
"5583","santa cruz","2020-07-06","  13","  397","  29","  2","  384","  27"
"5584","monterey","2020-07-06","  37","  845","  84","  9","  808","  75"
"5585","orange","2020-07-06"," 839"," 7416"," 406","250"," 6577"," 156"
"5586","ventura","2020-07-06"," 120"," 1549","  47"," 38"," 1429","   9"
"5587","san luis obispo","2020-07-06","  13","  453","  40","  5","  440","  35"
"5588","contra costa","2020-07-06","  84"," 1579"," 143"," 30"," 1495"," 113"
"5589","alameda","2020-07-06"," 187"," 2968"," 132"," 60"," 2781","  72"
"5590","san diego","2020-07-06"," 456"," 6614"," 339","175"," 6158"," 164"
"5591","san joaquin","2020-07-06"," 242"," 1430","  46"," 47"," 1188","  -1"
"5592","sonoma","2020-07-06","  33","  862","  48"," 13","  829","  35"
"5593","los angeles","2020-07-06","2670","23927","1334","632","21257"," 702"
"5594","fresno","2020-07-06"," 162"," 2094","  89"," 32"," 1932","  57"
"5595","merced","2020-07-06","  24","  242","   4","  6","  218","  -2"
"5596","kings","2020-07-06","  52","  199","   0","  8","  147","  -8"
"5597","humboldt","2020-07-06","   3","  352","   4","  1","  349","   3"
"5598","plumas","2020-07-06","   1","   45","   0","  0","   44","   0"
"5599","tehama","2020-07-06","   0","  106","   1","  0","  106","   1"
"5600","trinity","2020-07-06","   0","   54","   0","  0","   54","   0"
"5601","colusa","2020-07-06","   0","   88","   6","  0","   88","   6"
"5602","nevada","2020-07-06","   6","  114","   6","  1","  108","   5"
"5603","yolo","2020-07-06","   9","  186","   0","  2","  177","  -2"
"5604","riverside","2020-07-06"," 658"," 4110"," 124","146"," 3452"," -22"
"5605","madera","2020-07-07","  28","  340","  17","  6","  312","  11"
"5606","sutter","2020-07-07","   0","   14","   0","  0","   14","   0"
"5607","san bernardino","2020-07-07"," 579"," 4832"," 160","175"," 4253"," -15"
"5608","santa cruz","2020-07-07","  16","  397","  26","  3","  381","  23"
"5609","napa","2020-07-07","   8","  397","   1","  7","  389","  -6"
"5610","humboldt","2020-07-07","   3","  352","   3","  0","  349","   3"
"5611","riverside","2020-07-07"," 651"," 4110"," 124","136"," 3459"," -12"
"5612","ventura","2020-07-07"," 116"," 1549","  48"," 38"," 1433","  10"
"5613","santa barbara","2020-07-07","  89","  763","  66"," 25","  674","  41"
"5614","kings","2020-07-07","  54","  199","   7","  7","  145","   0"
"5615","stanislaus","2020-07-07"," 215"," 1372","  89"," 51"," 1157","  38"
"5616","glenn","2020-07-07","   1","   47","   0","  0","   46","   0"
"5617","tuolumne","2020-07-07","   2","  151","   5","  0","  149","   5"
"5618","imperial","2020-07-07","  93","  298","  16"," 20","  205","  -4"
"5619","sonoma","2020-07-07","  33","  862","  43"," 11","  829","  32"
"5620","nevada","2020-07-07","   2","   82","   6","  1","   80","   5"
"5621","trinity","2020-07-07","   0","   54","   0","  0","   54","   0"
"5622","contra costa","2020-07-07","  86"," 1579"," 142"," 26"," 1493"," 116"
"5623","sacramento","2020-07-07"," 173"," 2875","  79"," 49"," 2702","  30"
"5624","tehama","2020-07-07","   0","  106","   2","  0","  106","   2"
"5625","siskiyou","2020-07-07","   0","   65","   6","  0","   65","   6"
"5626","san luis obispo","2020-07-07","  19","  457","  41","  3","  438","  38"
"5627","el dorado","2020-07-07","   3","  235","   9","  3","  232","   6"
"5628","monterey","2020-07-07","  39","  845","  90"," 10","  806","  80"
"5629","santa clara","2020-07-07"," 114"," 3438"," 172"," 44"," 3324"," 128"
"5630","los angeles","2020-07-07","2829","23880","1368","630","21051"," 738"
"5631","orange","2020-07-07"," 817"," 7416"," 401","251"," 6599"," 150"
"5632","placer","2020-07-07","  55","  753","  27","  5","  698","  22"
"5633","amador","2020-07-07","   2","   51","   3","  1","   49","   2"
"5634","san joaquin","2020-07-07"," 209"," 1430","  52"," 48"," 1221","   4"
"5635","calaveras","2020-07-07","   0","   50","   9","  0","   50","   9"
"5636","merced","2020-07-07","  23","  242","   4","  5","  219","  -1"
"5637","san benito","2020-07-07","   1","   25","   0","  0","   24","   0"
"5638","tulare","2020-07-07","  85","  835","  17"," 11","  750","   6"
"5639","butte","2020-07-07","  15","  466","   3","  7","  451","  -4"
"5640","lassen","2020-07-07","   0","   65","   0","  0","   65","   0"
"5641","yuba","2020-07-07","  22","  445","  17","  6","  423","  11"
"5642","mendocino","2020-07-07","   0","  180","   3","  0","  180","   3"
"5643","colusa","2020-07-07","   1","   88","   6","  0","   87","   6"
"5644","shasta","2020-07-07","   5","  671","   8","  3","  666","   5"
"5645","san francisco","2020-07-07","  88"," 2647"," 107"," 26"," 2559","  81"
"5646","kern","2020-07-07"," 223"," 1832","  86"," 58"," 1609","  28"
"5647","marin","2020-07-07","  44","  392","  16","  8","  348","   8"
"5648","del norte","2020-07-07","   1","   51","   2","  0","   50","   2"
"5649","yolo","2020-07-07","   8","  186","   0","  3","  178","  -3"
"5650","fresno","2020-07-07"," 177"," 2090","  71"," 38"," 1913","  33"
"5651","mariposa","2020-07-07","   0","   30","   0","  0","   30","   0"
"5652","san diego","2020-07-07"," 479"," 6649"," 311","166"," 6170"," 145"
"5653","solano","2020-07-07","  44","  707","  39"," 17","  663","  22"
"5654","lake","2020-07-07","   1","  110","   2","  0","  109","   2"
"5655","alameda","2020-07-07"," 190"," 2968"," 133"," 64"," 2778","  69"
"5656","san mateo","2020-07-07","  60"," 1052","  66"," 13","  992","  53"
"5657","modoc","2020-07-07","   0","   41","   0","  0","   41","   0"
"5658","mono","2020-07-07","   0","   40","   2","  0","   40","   2"
"5659","inyo","2020-07-07","   1","   42","   3","  1","   41","   2"
"5660","plumas","2020-07-07","   1","   45","   0","  0","   44","   0"
"5661","kings","2020-07-08","  52","  199","   0","  6","  147","  -6"
"5662","ventura","2020-07-08"," 111"," 1549","  44"," 37"," 1438","   7"
"5663","butte","2020-07-08","  14","  492","   5","  7","  478","  -2"
"5664","imperial","2020-07-08","  85","  298","   4"," 18","  213"," -14"
"5665","mono","2020-07-08","   0","   40","   2","  0","   40","   2"
"5666","shasta","2020-07-08","   7","  671","  10","  3","  664","   7"
"5667","santa clara","2020-07-08"," 125"," 3438"," 192"," 51"," 3313"," 141"
"5668","san mateo","2020-07-08","  60"," 1050","  64"," 15","  990","  49"
"5669","humboldt","2020-07-08","   0","  352","   6","  0","  352","   6"
"5670","san luis obispo","2020-07-08","  18","  460","  39","  3","  442","  36"
"5671","napa","2020-07-08","   8","  397","   2","  5","  389","  -3"
"5672","sonoma","2020-07-08","  35","  862","  50","  7","  827","  43"
"5673","placer","2020-07-08","  56","  753","  26","  7","  697","  19"
"5674","san benito","2020-07-08","   2","   25","   0","  0","   23","   0"
"5675","los angeles","2020-07-08","2817","23875","1311","625","21058"," 686"
"5676","sacramento","2020-07-08"," 177"," 2913","  79"," 46"," 2736","  33"
"5677","san joaquin","2020-07-08"," 244"," 1430","  49"," 54"," 1186","  -5"
"5678","colusa","2020-07-08","   1","   88","   6","  0","   87","   6"
"5679","contra costa","2020-07-08"," 107"," 1579"," 136"," 27"," 1472"," 109"
"5680","riverside","2020-07-08"," 664"," 4104"," 121","127"," 3440","  -6"
"5681","orange","2020-07-08"," 815"," 7416"," 373","253"," 6601"," 120"
"5682","plumas","2020-07-08","   0","   45","   0","  0","   45","   0"
"5683","mendocino","2020-07-08","   0","  180","   3","  0","  180","   3"
"5684","san diego","2020-07-08"," 483"," 6682"," 305","171"," 6199"," 134"
"5685","nevada","2020-07-08","   2","  101","   6","  1","   99","   5"
"5686","tulare","2020-07-08","  80","  835","  22"," 10","  755","  12"
"5687","santa barbara","2020-07-08","  86","  763","  52"," 24","  677","  28"
"5688","siskiyou","2020-07-08","   0","   65","   6","  0","   65","   6"
"5689","santa cruz","2020-07-08","  18","  397","  30","  3","  379","  27"
"5690","marin","2020-07-08","  43","  392","  15","  9","  349","   6"
"5691","modoc","2020-07-08","   0","   41","   0","  0","   41","   0"
"5692","alameda","2020-07-08"," 188"," 2968"," 127"," 63"," 2780","  64"
"5693","amador","2020-07-08","   1","   51","   3","  1","   50","   2"
"5694","merced","2020-07-08","  22","  242","   2","  3","  220","  -1"
"5695","inyo","2020-07-08","   1","   42","   2","  1","   41","   1"
"5696","lassen","2020-07-08","   1","   65","   0","  0","   64","   0"
"5697","tehama","2020-07-08","   0","  106","   4","  0","  106","   4"
"5698","mariposa","2020-07-08","   0","   30","   0","  0","   30","   0"
"5699","madera","2020-07-08","  33","  340","  20","  5","  307","  15"
"5700","yolo","2020-07-08","  11","  186","   4","  6","  175","  -2"
"5701","del norte","2020-07-08","   0","   51","   1","  0","   51","   1"
"5702","sutter","2020-07-08","   0","   14","   0","  0","   14","   0"
"5703","lake","2020-07-08","   3","  110","   0","  1","  107","  -1"
"5704","tuolumne","2020-07-08","   3","  151","   4","  0","  148","   4"
"5705","fresno","2020-07-08"," 206"," 2098","  74"," 43"," 1892","  31"
"5706","stanislaus","2020-07-08"," 215"," 1372","  81"," 55"," 1157","  26"
"5707","yuba","2020-07-08","  20","  445","  16","  5","  425","  11"
"5708","solano","2020-07-08","  45","  707","  42"," 14","  662","  28"
"5709","el dorado","2020-07-08","   3","  235","   6","  3","  232","   3"
"5710","calaveras","2020-07-08","   0","   50","   9","  0","   50","   9"
"5711","glenn","2020-07-08","   1","   47","   0","  0","   46","   0"
"5712","kern","2020-07-08"," 227"," 1832","  81"," 58"," 1605","  23"
"5713","san francisco","2020-07-08","  88"," 2647"," 110"," 28"," 2559","  82"
"5714","monterey","2020-07-08","  44","  845","  89","  9","  801","  80"
"5715","trinity","2020-07-08","   0","   54","   0","  0","   54","   0"
"5716","san bernardino","2020-07-08"," 599"," 4838"," 162","153"," 4239","   9"
"5717","el dorado","2020-07-09","   3","  235","   9","  0","  232","   9"
"5718","trinity","2020-07-09","   0","   54","   0","  0","   54","   0"
"5719","tulare","2020-07-09","  74","  835","  31"," 10","  761","  21"
"5720","santa clara","2020-07-09"," 135"," 3438"," 193"," 49"," 3303"," 144"
"5721","riverside","2020-07-09"," 690"," 4104"," 129","131"," 3414","  -2"
"5722","lake","2020-07-09","   2","  110","   0","  1","  108","  -1"
"5723","tuolumne","2020-07-09","   0","  151","   4","  0","  151","   4"
"5724","alameda","2020-07-09"," 185"," 2968"," 128"," 66"," 2783","  62"
"5725","colusa","2020-07-09","   0","   88","   6","  0","   88","   6"
"5726","contra costa","2020-07-09"," 112"," 1579"," 140"," 28"," 1467"," 112"
"5727","ventura","2020-07-09"," 103"," 1549","  48"," 36"," 1446","  12"
"5728","san joaquin","2020-07-09"," 244"," 1430","  41"," 55"," 1186"," -14"
"5729","modoc","2020-07-09","   0","   41","   0","  0","   41","   0"
"5730","mono","2020-07-09","   0","   40","   2","  0","   40","   2"
"5731","madera","2020-07-09","  30","  340","  18","  4","  310","  14"
"5732","lassen","2020-07-09","   1","   65","   0","  0","   64","   0"
"5733","monterey","2020-07-09","  47","  845","  93","  9","  798","  84"
"5734","kern","2020-07-09"," 227"," 1822","  83"," 62"," 1595","  21"
"5735","solano","2020-07-09","  47","  707","  45"," 14","  660","  31"
"5736","los angeles","2020-07-09","2849","23906","1368","655","21057"," 713"
"5737","sonoma","2020-07-09","  30","  862","  53","  4","  832","  49"
"5738","placer","2020-07-09","  48","  753","  27","  7","  705","  20"
"5739","butte","2020-07-09","  16","  492","   5"," 10","  476","  -5"
"5740","orange","2020-07-09"," 800"," 7401"," 402","251"," 6601"," 151"
"5741","san luis obispo","2020-07-09","  15","  461","  35","  5","  446","  30"
"5742","sacramento","2020-07-09"," 181"," 2927","  87"," 48"," 2746","  39"
"5743","mariposa","2020-07-09","   0","   33","   0","  0","   33","   0"
"5744","mendocino","2020-07-09","   0","  180","   4","  0","  180","   4"
"5745","napa","2020-07-09","   9","  387","   2","  5","  378","  -3"
"5746","amador","2020-07-09","   1","   51","   0","  1","   50","  -1"
"5747","yolo","2020-07-09","  15","  186","   1","  5","  171","  -4"
"5748","siskiyou","2020-07-09","   0","   65","   5","  0","   65","   5"
"5749","san francisco","2020-07-09","  94"," 2647"," 109"," 29"," 2553","  80"
"5750","stanislaus","2020-07-09"," 228"," 1372","  74"," 56"," 1144","  18"
"5751","san benito","2020-07-09","   3","   25","   1","  1","   22","   0"
"5752","kings","2020-07-09","  57","  199","   2","  6","  142","  -4"
"5753","tehama","2020-07-09","   0","  106","   4","  0","  106","   4"
"5754","yuba","2020-07-09","  17","  445","   8","  3","  428","   5"
"5755","calaveras","2020-07-09","   0","   50","   9","  0","   50","   9"
"5756","fresno","2020-07-09"," 229"," 2216","  74"," 42"," 1987","  32"
"5757","plumas","2020-07-09","   0","   45","   0","  0","   45","   0"
"5758","san diego","2020-07-09"," 489"," 6675"," 309","167"," 6186"," 142"
"5759","humboldt","2020-07-09","   1","  352","  16","  0","  351","  16"
"5760","nevada","2020-07-09","   3","   91","   3","  1","   88","   2"
"5761","imperial","2020-07-09","  77","  298","   9"," 16","  221","  -7"
"5762","merced","2020-07-09","  33","  242","   4","  4","  209","   0"
"5763","del norte","2020-07-09","   0","   51","   2","  0","   51","   2"
"5764","sutter","2020-07-09","   0","   14","   0","  0","   14","   0"
"5765","san bernardino","2020-07-09"," 600"," 4838"," 165","166"," 4238","  -1"
"5766","shasta","2020-07-09","   6","  671","  10","  3","  665","   7"
"5767","glenn","2020-07-09","   0","   47","   0","  0","   47","   0"
"5768","inyo","2020-07-09","   1","   42","   2","  1","   41","   1"
"5769","santa barbara","2020-07-09","  82","  763","  53"," 27","  681","  26"
"5770","san mateo","2020-07-09","  58"," 1053","  65"," 15","  995","  50"
"5771","santa cruz","2020-07-09","  16","  397","  18","  3","  381","  15"
"5772","marin","2020-07-09","  38","  392","  20","  9","  354","  11"
"5773","calaveras","2020-07-10","   0","   50","  10","  0","   50","  10"
"5774","tuolumne","2020-07-10","   2","  151","   4","  0","  149","   4"
"5775","nevada","2020-07-10","   2","   93","   6","  1","   91","   5"
"5776","placer","2020-07-10","  49","  753","  25","  8","  704","  17"
"5777","tulare","2020-07-10","  71","  835","  33","  9","  764","  24"
"5778","inyo","2020-07-10","   0","   42","   2","  0","   42","   2"
"5779","sonoma","2020-07-10","  36","  862","  53","  7","  826","  46"
"5780","mono","2020-07-10","   0","   40","   2","  0","   40","   2"
"5781","trinity","2020-07-10","   0","   54","   0","  0","   54","   0"
"5782","modoc","2020-07-10","   0","   41","   0","  0","   41","   0"
"5783","yolo","2020-07-10","  15","  186","   4","  6","  171","  -2"
"5784","del norte","2020-07-10","   0","   51","   2","  0","   51","   2"
"5785","fresno","2020-07-10"," 235"," 2222","  71"," 46"," 1987","  25"
"5786","lassen","2020-07-10","   1","   65","   0","  0","   64","   0"
"5787","mendocino","2020-07-10","   2","  180","   7","  0","  178","   7"
"5788","san benito","2020-07-10","   4","   25","   2","  1","   21","   1"
"5789","madera","2020-07-10","  41","  340","  14"," 11","  299","   3"
"5790","merced","2020-07-10","  38","  242","   4","  6","  204","  -2"
"5791","plumas","2020-07-10","   0","   45","   0","  0","   45","   0"
"5792","monterey","2020-07-10","  48","  845","  95"," 10","  797","  85"
"5793","alameda","2020-07-10"," 183"," 2968"," 122"," 62"," 2785","  60"
"5794","san diego","2020-07-10"," 490"," 6687"," 313","173"," 6197"," 140"
"5795","glenn","2020-07-10","   0","   47","   0","  0","   47","   0"
"5796","san joaquin","2020-07-10"," 244"," 1430","  36"," 62"," 1186"," -26"
"5797","butte","2020-07-10","  16","  492","   1"," 10","  476","  -9"
"5798","riverside","2020-07-10"," 681"," 4123"," 146","130"," 3442","  16"
"5799","los angeles","2020-07-10","2777","23901","1327","631","21124"," 696"
"5800","humboldt","2020-07-10","   1","  352","   5","  0","  351","   5"
"5801","imperial","2020-07-10","  74","  298","   9"," 16","  224","  -7"
"5802","kings","2020-07-10","  58","  199","   2","  6","  141","  -4"
"5803","el dorado","2020-07-10","   2","  235","   7","  2","  233","   5"
"5804","santa barbara","2020-07-10","  81","  763","  73"," 26","  682","  47"
"5805","ventura","2020-07-10"," 105"," 1549","  52"," 32"," 1444","  20"
"5806","san mateo","2020-07-10","  62"," 1056","  56"," 18","  994","  38"
"5807","mariposa","2020-07-10","   0","   33","   0","  0","   33","   0"
"5808","contra costa","2020-07-10"," 107"," 1579"," 136"," 29"," 1472"," 107"
"5809","shasta","2020-07-10","   6","  671","  18","  3","  665","  15"
"5810","tehama","2020-07-10","   0","  106","   3","  0","  106","   3"
"5811","sutter","2020-07-10","   0","   14","   0","  0","   14","   0"
"5812","amador","2020-07-10","   2","   51","   1","  1","   49","   0"
"5813","sacramento","2020-07-10"," 176"," 2908","  93"," 56"," 2732","  37"
"5814","solano","2020-07-10","  46","  707","  38"," 11","  661","  27"
"5815","marin","2020-07-10","  36","  392","  20"," 10","  356","  10"
"5816","santa cruz","2020-07-10","  17","  397","  18","  3","  380","  15"
"5817","colusa","2020-07-10","   0","   88","   6","  0","   88","   6"
"5818","napa","2020-07-10","   7","  387","   2","  5","  380","  -3"
"5819","lake","2020-07-10","   3","  110","   1","  1","  107","   0"
"5820","stanislaus","2020-07-10"," 231"," 1393","  87"," 52"," 1162","  35"
"5821","yuba","2020-07-10","  20","  445","   8","  4","  425","   4"
"5822","orange","2020-07-10"," 785"," 7401"," 390","254"," 6616"," 136"
"5823","san luis obispo","2020-07-10","  17","  468","  40","  4","  451","  36"
"5824","san francisco","2020-07-10","  97"," 2647"," 104"," 34"," 2550","  70"
"5825","kern","2020-07-10"," 250"," 1822"," 112"," 64"," 1572","  48"
"5826","santa clara","2020-07-10"," 142"," 3438"," 181"," 50"," 3296"," 131"
"5827","san bernardino","2020-07-10"," 642"," 4838"," 197","167"," 4196","  30"
"5828","siskiyou","2020-07-10","   2","   65","   6","  0","   63","   6"
"5829","santa barbara","2020-07-11","  81","  763","  56"," 25","  682","  31"
"5830","san joaquin","2020-07-11"," 232"," 1430","  33"," 61"," 1198"," -28"
"5831","imperial","2020-07-11","  76","  298","  10"," 17","  222","  -7"
"5832","placer","2020-07-11","  61","  776","  27"," 10","  715","  17"
"5833","marin","2020-07-11","  35","  392","  21"," 10","  357","  11"
"5834","modoc","2020-07-11","   0","   41","   0","  0","   41","   0"
"5835","amador","2020-07-11","   0","   51","   3","  0","   51","   3"
"5836","lake","2020-07-11","   4","  110","   1","  1","  106","   0"
"5837","trinity","2020-07-11","   0","   54","   0","  0","   54","   0"
"5838","madera","2020-07-11","  36","  340","  14","  6","  304","   8"
"5839","plumas","2020-07-11","   0","   45","   0","  0","   45","   0"
"5840","merced","2020-07-11","  34","  242","   3","  5","  208","  -2"
"5841","tehama","2020-07-11","   1","  106","   0","  1","  105","  -1"
"5842","contra costa","2020-07-11"," 103"," 1579"," 124"," 26"," 1476","  98"
"5843","sacramento","2020-07-11"," 180"," 2874","  82"," 58"," 2694","  24"
"5844","stanislaus","2020-07-11"," 218"," 1393","  75"," 49"," 1175","  26"
"5845","nevada","2020-07-11","   2","  100","   6","  1","   98","   5"
"5846","ventura","2020-07-11"," 100"," 1549","  48"," 34"," 1449","  14"
"5847","inyo","2020-07-11","   0","   42","   2","  0","   42","   2"
"5848","sutter","2020-07-11","   0","   14","   0","  0","   14","   0"
"5849","tulare","2020-07-11","  77","  835","  23"," 10","  758","  13"
"5850","mono","2020-07-11","   0","   40","   2","  0","   40","   2"
"5851","tuolumne","2020-07-11","   1","  151","   1","  1","  150","   0"
"5852","san francisco","2020-07-11","  97"," 2647"," 112"," 35"," 2550","  77"
"5853","san bernardino","2020-07-11"," 652"," 4838"," 145","176"," 4186"," -31"
"5854","santa clara","2020-07-11"," 141"," 3432"," 173"," 53"," 3291"," 120"
"5855","sonoma","2020-07-11","  33","  862","  55","  5","  829","  50"
"5856","kern","2020-07-11"," 273"," 1822","  82"," 60"," 1549","  22"
"5857","humboldt","2020-07-11","   1","  352","   5","  0","  351","   5"
"5858","santa cruz","2020-07-11","  17","  397","  18","  3","  380","  15"
"5859","monterey","2020-07-11","  42","  845","  94"," 10","  803","  84"
"5860","mendocino","2020-07-11","   2","  180","   7","  0","  178","   7"
"5861","siskiyou","2020-07-11","   1","   65","   6","  0","   64","   6"
"5862","lassen","2020-07-11","   3","   65","   0","  0","   62","   0"
"5863","el dorado","2020-07-11","   2","  235","   9","  2","  233","   7"
"5864","napa","2020-07-11","   8","  387","   4","  4","  379","   0"
"5865","kings","2020-07-11","  65","  199","   2","  6","  134","  -4"
"5866","riverside","2020-07-11"," 647"," 4068"," 148","133"," 3421","  15"
"5867","yuba","2020-07-11","  21","  445","  14","  4","  424","  10"
"5868","del norte","2020-07-11","   0","   51","   0","  0","   51","   0"
"5869","solano","2020-07-11","  52","  707","  38"," 13","  655","  25"
"5870","fresno","2020-07-11"," 239"," 2223","  78"," 42"," 1984","  36"
"5871","colusa","2020-07-11","   2","   88","   6","  0","   86","   6"
"5872","shasta","2020-07-11","   5","  671","   4","  3","  666","   1"
"5873","alameda","2020-07-11"," 188"," 2968"," 121"," 60"," 2780","  61"
"5874","san diego","2020-07-11"," 466"," 6441"," 300","158"," 5975"," 142"
"5875","yolo","2020-07-11","  11","  186","   0","  6","  175","  -6"
"5876","san mateo","2020-07-11","  59"," 1054","  54"," 17","  995","  37"
"5877","san benito","2020-07-11","   3","   25","   2","  0","   22","   2"
"5878","calaveras","2020-07-11","   0","   50","   9","  0","   50","   9"
"5879","orange","2020-07-11"," 786"," 7401"," 378","251"," 6615"," 127"
"5880","los angeles","2020-07-11","2769","23980","1352","650","21211"," 702"
"5881","mariposa","2020-07-11","   0","   33","   0","  0","   33","   0"
"5882","glenn","2020-07-11","   1","   47","   0","  0","   46","   0"
"5883","butte","2020-07-11","  16","  492","   0"," 10","  476"," -10"
"5884","san luis obispo","2020-07-11","  11","  463","  40","  4","  452","  36"
"5885","kern","2020-07-12"," 255"," 1822","  86"," 57"," 1567","  29"
"5886","plumas","2020-07-12","   0","   45","   0","  0","   45","   0"
"5887","alameda","2020-07-12"," 187"," 2968"," 139"," 59"," 2781","  80"
"5888","mono","2020-07-12","   0","   40","   2","  0","   40","   2"
"5889","san mateo","2020-07-12","  65"," 1057","  55"," 17","  992","  38"
"5890","tulare","2020-07-12","  89","  835","  13"," 11","  746","   2"
"5891","trinity","2020-07-12","   0","   54","   0","  0","   54","   0"
"5892","inyo","2020-07-12","   0","   42","   2","  0","   42","   2"
"5893","sonoma","2020-07-12","  34","  862","  50","  7","  828","  43"
"5894","fresno","2020-07-12"," 241"," 2208","  65"," 42"," 1967","  23"
"5895","ventura","2020-07-12"," 109"," 1549","  45"," 36"," 1440","   9"
"5896","glenn","2020-07-12","   1","   47","   0","  0","   46","   0"
"5897","san bernardino","2020-07-12"," 669"," 4838"," 177","178"," 4169","  -1"
"5898","san benito","2020-07-12","   2","   25","   3","  0","   23","   3"
"5899","yuba","2020-07-12","  19","  445","  10","  5","  426","   5"
"5900","napa","2020-07-12","   8","  387","   0","  5","  379","  -5"
"5901","tehama","2020-07-12","   2","  106","   1","  1","  104","   0"
"5902","amador","2020-07-12","   0","   51","   3","  0","   51","   3"
"5903","merced","2020-07-12","  38","  242","   3","  5","  204","  -2"
"5904","del norte","2020-07-12","   0","   51","   4","  0","   51","   4"
"5905","lassen","2020-07-12","   2","   65","   0","  0","   63","   0"
"5906","mendocino","2020-07-12","   2","  180","   7","  0","  178","   7"
"5907","stanislaus","2020-07-12"," 230"," 1397","  69"," 44"," 1167","  25"
"5908","kings","2020-07-12","  64","  199","   2","  6","  135","  -4"
"5909","san luis obispo","2020-07-12","  13","  459","  42","  4","  446","  38"
"5910","tuolumne","2020-07-12","   2","  151","   5","  0","  149","   5"
"5911","nevada","2020-07-12","   1","   96","   5","  0","   95","   5"
"5912","siskiyou","2020-07-12","   2","   65","   6","  0","   63","   6"
"5913","imperial","2020-07-12","  73","  298","   9"," 17","  225","  -8"
"5914","san joaquin","2020-07-12"," 237"," 1430","  38"," 61"," 1193"," -23"
"5915","sutter","2020-07-12","   0","   14","   0","  0","   14","   0"
"5916","lake","2020-07-12","   4","  110","   0","  1","  106","  -1"
"5917","san diego","2020-07-12"," 467"," 6398"," 370","159"," 5931"," 211"
"5918","orange","2020-07-12"," 758"," 7401"," 443","245"," 6643"," 198"
"5919","humboldt","2020-07-12","   2","  352","   5","  0","  350","   5"
"5920","shasta","2020-07-12","   3","  671","   3","  2","  668","   1"
"5921","riverside","2020-07-12"," 635"," 4062"," 186","148"," 3427","  38"
"5922","contra costa","2020-07-12"," 105"," 1579"," 125"," 27"," 1474","  98"
"5923","butte","2020-07-12","  17","  492","   2","  9","  475","  -7"
"5924","monterey","2020-07-12","  43","  845","  93"," 10","  802","  83"
"5925","placer","2020-07-12","  63","  776","  20"," 11","  713","   9"
"5926","solano","2020-07-12","  51","  707","  37"," 10","  656","  27"
"5927","el dorado","2020-07-12","   3","  235","   5","  3","  232","   2"
"5928","santa barbara","2020-07-12","  84","  763","  57"," 23","  679","  34"
"5929","yolo","2020-07-12","  11","  186","   2","  4","  175","  -2"
"5930","santa cruz","2020-07-12","  17","  397","  23","  2","  380","  21"
"5931","calaveras","2020-07-12","   2","   50","  10","  0","   48","  10"
"5932","marin","2020-07-12","  30","  392","  23"," 10","  362","  13"
"5933","madera","2020-07-12","  35","  340","  27","  3","  305","  24"
"5934","santa clara","2020-07-12"," 149"," 3432"," 189"," 53"," 3283"," 136"
"5935","los angeles","2020-07-12","2773","23868","1502","643","21095"," 859"
"5936","modoc","2020-07-12","   0","   41","   0","  0","   41","   0"
"5937","sacramento","2020-07-12"," 200"," 2860","  87"," 67"," 2660","  20"
"5938","san francisco","2020-07-12","  94"," 2647"," 122"," 36"," 2553","  86"
"5939","colusa","2020-07-12","   4","   88","   6","  0","   84","   6"
"5940","mariposa","2020-07-12","   0","   33","   0","  0","   33","   0"
